year,province,cp,cities,nacidos,defunciones,saldo
2017,Teruel,44001,Ababuj,0,1,-1
2017,Teruel,44004,Aguaviva,3,8,-5
2017,Teruel,44005,Aguilar del Alfambra,1,3,-2
2017,Teruel,44006,Alacón,2,8,-6
2017,Teruel,44007,Alba,0,4,-4
2017,Teruel,44008,Albalate del Arzobispo,17,35,-18
2017,Teruel,44009,Albarracín,6,17,-11
2017,Teruel,44010,Albentosa,3,3,0
2017,Teruel,44012,Alcalá de la Selva,1,3,-2
2017,Teruel,44013,Alcañiz,147,125,22
2017,Teruel,44014,Alcorisa,25,44,-19
2017,Teruel,44016,Alfambra,0,12,-12
2017,Teruel,44017,Aliaga,2,4,-2
2017,Teruel,44021,Allepuz,1,3,-2
2017,Teruel,44022,Alloza,4,9,-5
2017,Teruel,44023,Allueva,1,1,0
2017,Teruel,44024,Anadón,0,1,-1
2017,Teruel,44025,Andorra,53,79,-26
2017,Teruel,44026,Arcos de las Salinas,0,2,-2
2017,Teruel,44027,Arens de Lledó,2,2,0
2017,Teruel,44028,Argente,1,8,-7
2017,Teruel,44029,Ariño,5,12,-7
2017,Teruel,44031,Azaila,2,7,-5
2017,Teruel,44035,Barrachina,0,3,-3
2017,Teruel,44034,Bañón,0,3,-3
2017,Teruel,44037,Beceite,0,8,-8
2017,Teruel,44039,Bello,1,10,-9
2017,Teruel,44038,Belmonte de San José,1,1,0
2017,Teruel,44042,Blancas,0,2,-2
2017,Teruel,44043,Blesa,1,2,-1
2017,Teruel,44045,Bronchales,3,5,-2
2017,Teruel,44046,Bueña,0,1,-1
2017,Teruel,44047,Burbáguena,1,4,-3
2017,Teruel,44033,Báguena,1,5,-4
2017,Teruel,44048,Cabra de Mora,0,2,-2
2017,Teruel,44049,Calaceite,5,21,-16
2017,Teruel,44050,Calamocha,30,53,-23
2017,Teruel,44051,Calanda,23,55,-32
2017,Teruel,44052,Calomarde,0,2,-2
2017,Teruel,44054,Camarena de la Sierra,1,1,0
2017,Teruel,44055,Camarillas,2,1,1
2017,Teruel,44053,Camañas,0,4,-4
2017,Teruel,44056,Caminreal,3,14,-11
2017,Teruel,44059,Cantavieja,5,4,1
2017,Teruel,44064,Cascante del Río,0,1,-1
2017,Teruel,44065,Castejón de Tornos,0,3,-3
2017,Teruel,44066,Castel de Cabra,0,3,-3
2017,Teruel,44071,Castellote,0,12,-12
2017,Teruel,44067,Castelnou,1,1,0
2017,Teruel,44068,Castelserás,11,14,-3
2017,Teruel,44060,Cañada de Benatanduz,0,1,-1
2017,Teruel,44074,Cedrillas,6,7,-1
2017,Teruel,44075,Celadas,0,10,-10
2017,Teruel,44076,Cella,18,41,-23
2017,Teruel,44080,Codoñera (La),1,8,-7
2017,Teruel,44084,Cortes de Aragón,0,1,-1
2017,Teruel,44085,Cosa,0,1,-1
2017,Teruel,44086,Cretas,3,4,-1
2017,Teruel,44087,Crivillén,0,1,-1
2017,Teruel,44089,Cubla,0,1,-1
2017,Teruel,44090,Cucalón,0,3,-3
2017,Teruel,44092,Cuervo (El),0,3,-3
2017,Teruel,44093,Cuevas de Almudén,2,0,2
2017,Teruel,44094,Cuevas Labradas,0,2,-2
2017,Teruel,44096,Ejulve,1,5,-4
2017,Teruel,44097,Escorihuela,0,4,-4
2017,Teruel,44099,Escucha,9,9,0
2017,Teruel,44100,Estercuel,0,3,-3
2017,Teruel,44101,Ferreruela de Huerva,0,1,-1
2017,Teruel,44102,Fonfría,0,2,-2
2017,Teruel,44103,Formiche Alto,0,4,-4
2017,Teruel,44106,Fortanete,2,2,0
2017,Teruel,44107,Foz-Calanda,1,4,-3
2017,Teruel,44108,Fresneda (La),1,9,-8
2017,Teruel,44109,Frías de Albarracín,0,5,-5
2017,Teruel,44110,Fuenferrada,0,1,-1
2017,Teruel,44111,Fuentes Calientes,0,2,-2
2017,Teruel,44112,Fuentes Claras,2,10,-8
2017,Teruel,44113,Fuentes de Rubielos,1,2,-1
2017,Teruel,44114,Fuentespalda,1,4,-3
2017,Teruel,44105,Fórnoles,1,0,1
2017,Teruel,44115,Galve,1,1,0
2017,Teruel,44116,Gargallo,0,1,-1
2017,Teruel,44117,Gea de Albarracín,1,0,1
2017,Teruel,44118,Ginebrosa (La),0,2,-2
2017,Teruel,44119,Griegos,0,2,-2
2017,Teruel,44120,Guadalaviar,0,5,-5
2017,Teruel,44121,Gúdar,0,1,-1
2017,Teruel,44123,Hinojosa de Jarque,1,1,0
2017,Teruel,44124,Hoz de la Vieja (La),0,1,-1
2017,Teruel,44125,Huesa del Común,0,1,-1
2017,Teruel,44122,Híjar,17,23,-6
2017,Teruel,44126,Iglesuela del Cid (La),1,12,-11
2017,Teruel,44127,Jabaloyas,0,3,-3
2017,Teruel,44128,Jarque de la Val,0,2,-2
2017,Teruel,44131,Josa,0,1,-1
2017,Teruel,44132,Lagueruela,0,1,-1
2017,Teruel,44133,Lanzuela,1,0,1
2017,Teruel,44135,Libros,0,3,-3
2017,Teruel,44137,Linares de Mora,2,3,-1
2017,Teruel,44141,Lledó,0,1,-1
2017,Teruel,44138,Loscos,0,5,-5
2017,Teruel,44143,Manzanera,1,7,-6
2017,Teruel,44144,Martín del Río,2,13,-11
2017,Teruel,44145,Mas de las Matas,6,24,-18
2017,Teruel,44146,Mata de los Olmos (La),1,6,-5
2017,Teruel,44147,Mazaleón,7,8,-1
2017,Teruel,44148,Mezquita de Jarque,3,2,1
2017,Teruel,44149,Mirambel,2,0,2
2017,Teruel,44151,Molinos,2,3,-1
2017,Teruel,44152,Monforte de Moyuela,0,1,-1
2017,Teruel,44153,Monreal del Campo,25,33,-8
2017,Teruel,44154,Monroyo,5,7,-2
2017,Teruel,44155,Montalbán,7,18,-11
2017,Teruel,44158,Mora de Rubielos,5,19,-14
2017,Teruel,44159,Moscardón,0,3,-3
2017,Teruel,44160,Mosqueruela,3,11,-8
2017,Teruel,44161,Muniesa,7,18,-11
2017,Teruel,44164,Nogueras,0,1,-1
2017,Teruel,44165,Nogueruelas,0,2,-2
2017,Teruel,44167,Obón,0,1,-1
2017,Teruel,44168,Odón,0,4,-4
2017,Teruel,44169,Ojos Negros,1,9,-8
2017,Teruel,44171,Olba,1,0,1
2017,Teruel,44172,Oliete,4,4,0
2017,Teruel,44173,Olmos (Los),1,2,-1
2017,Teruel,44174,Orihuela del Tremedal,3,5,-2
2017,Teruel,44175,Orrios,0,1,-1
2017,Teruel,44176,Palomar de Arroyos,2,2,0
2017,Teruel,44177,Pancrudo,0,1,-1
2017,Teruel,44178,Parras de Castellote (Las),1,2,-1
2017,Teruel,44180,Peracense,0,2,-2
2017,Teruel,44181,Peralejos,0,1,-1
2017,Teruel,44182,Perales del Alfambra,0,7,-7
2017,Teruel,44179,Peñarroya de Tastavins,2,9,-7
2017,Teruel,44183,Pitarque,0,1,-1
2017,Teruel,44184,Plou,0,1,-1
2017,Teruel,44185,Pobo (El),0,3,-3
2017,Teruel,44187,Portellada (La),1,1,0
2017,Teruel,44189,Pozondón,0,4,-4
2017,Teruel,44190,Pozuel del Campo,0,1,-1
2017,Teruel,44191,Puebla de Híjar (La),1,15,-14
2017,Teruel,44192,Puebla de Valverde (La),1,8,-7
2017,Teruel,44193,Puertomingalvo,2,1,1
2017,Teruel,44195,Rillo,0,5,-5
2017,Teruel,44196,Riodeva,2,3,-1
2017,Teruel,44198,Royuela,0,3,-3
2017,Teruel,44199,Rubiales,1,0,1
2017,Teruel,44201,Rubielos de Mora,7,10,-3
2017,Teruel,44194,Ráfales,0,3,-3
2017,Teruel,44197,Ródenas,0,4,-4
2017,Teruel,44203,Salcedillo,0,1,-1
2017,Teruel,44205,Samper de Calanda,6,17,-11
2017,Teruel,44206,San Agustín,0,2,-2
2017,Teruel,44207,San Martín del Río,0,5,-5
2017,Teruel,44208,Santa Cruz de Nogueras,1,2,-1
2017,Teruel,44209,Santa Eulalia,4,21,-17
2017,Teruel,44210,Sarrión,12,12,0
2017,Teruel,44211,Segura de los Baños,0,2,-2
2017,Teruel,44212,Seno,0,1,-1
2017,Teruel,44213,Singra,0,2,-2
2017,Teruel,44215,Terriente,0,3,-3
2017,Teruel,44216,Teruel,291,329,-38
2017,Teruel,44219,Tornos,0,2,-2
2017,Teruel,44220,Torralba de los Sisones,0,1,-1
2017,Teruel,44223,Torre de Arcas,0,2,-2
2017,Teruel,44225,Torre del Compte,1,3,-2
2017,Teruel,44221,Torrecilla de Alcañiz,1,4,-3
2017,Teruel,44226,Torrelacárcel,0,7,-7
2017,Teruel,44228,Torremocha de Jiloca,1,2,-1
2017,Teruel,44229,Torres de Albarracín,2,1,1
2017,Teruel,44230,Torrevelilla,1,1,0
2017,Teruel,44231,Torrijas,1,1,0
2017,Teruel,44232,Torrijo del Campo,5,9,-4
2017,Teruel,44234,Tramacastiel,0,2,-2
2017,Teruel,44235,Tramacastilla,0,2,-2
2017,Teruel,44236,Tronchón,0,3,-3
2017,Teruel,44237,Urrea de Gaén,2,11,-9
2017,Teruel,44238,Utrillas,25,33,-8
2017,Teruel,44240,Valbona,0,4,-4
2017,Teruel,44241,Valdealgorfa,3,9,-6
2017,Teruel,44243,Valdecuenca,1,0,1
2017,Teruel,44244,Valdelinares,1,0,1
2017,Teruel,44245,Valdeltormo,2,2,0
2017,Teruel,44246,Valderrobres,22,28,-6
2017,Teruel,44247,Valjunquera,1,5,-4
2017,Teruel,44249,Vallecillo (El),0,1,-1
2017,Teruel,44250,Veguillas de la Sierra,0,1,-1
2017,Teruel,44251,Villafranca del Campo,1,5,-4
2017,Teruel,44252,Villahermosa del Campo,0,1,-1
2017,Teruel,44256,Villanueva del Rebollar de la Sierra,1,0,1
2017,Teruel,44257,Villar del Cobo,0,3,-3
2017,Teruel,44258,Villar del Salz,0,2,-2
2017,Teruel,44260,Villarluengo,2,1,1
2017,Teruel,44261,Villarquemado,7,9,-2
2017,Teruel,44262,Villarroya de los Pinares,0,1,-1
2017,Teruel,44263,Villastar,5,8,-3
2017,Teruel,44264,Villel,1,9,-8
2017,Teruel,44265,Vinaceite,0,5,-5
2017,Teruel,44266,Visiedo,2,4,-2
2016,Teruel,44004,Aguaviva,2,12,-10
2016,Teruel,44005,Aguilar del Alfambra,0,2,-2
2016,Teruel,44006,Alacón,0,8,-8
2016,Teruel,44007,Alba,1,6,-5
2016,Teruel,44008,Albalate del Arzobispo,10,19,-9
2016,Teruel,44009,Albarracín,7,14,-7
2016,Teruel,44010,Albentosa,0,3,-3
2016,Teruel,44011,Alcaine,0,1,-1
2016,Teruel,44012,Alcalá de la Selva,0,4,-4
2016,Teruel,44013,Alcañiz,148,141,7
2016,Teruel,44014,Alcorisa,29,34,-5
2016,Teruel,44016,Alfambra,3,6,-3
2016,Teruel,44017,Aliaga,4,5,-1
2016,Teruel,44021,Allepuz,2,2,0
2016,Teruel,44022,Alloza,4,5,-1
2016,Teruel,44018,Almohaja,0,1,-1
2016,Teruel,44019,Alobras,0,1,-1
2016,Teruel,44020,Alpeñés,0,1,-1
2016,Teruel,44025,Andorra,81,81,0
2016,Teruel,44026,Arcos de las Salinas,3,1,2
2016,Teruel,44027,Arens de Lledó,1,5,-4
2016,Teruel,44028,Argente,1,5,-4
2016,Teruel,44029,Ariño,3,7,-4
2016,Teruel,44031,Azaila,1,2,-1
2016,Teruel,44035,Barrachina,0,4,-4
2016,Teruel,44034,Bañón,1,5,-4
2016,Teruel,44037,Beceite,2,5,-3
2016,Teruel,44039,Bello,0,4,-4
2016,Teruel,44038,Belmonte de San José,2,3,-1
2016,Teruel,44040,Berge,2,5,-3
2016,Teruel,44041,Bezas,0,1,-1
2016,Teruel,44042,Blancas,0,6,-6
2016,Teruel,44043,Blesa,0,4,-4
2016,Teruel,44044,Bordón,0,4,-4
2016,Teruel,44045,Bronchales,2,2,0
2016,Teruel,44046,Bueña,0,3,-3
2016,Teruel,44032,Bádenas,0,1,-1
2016,Teruel,44033,Báguena,1,7,-6
2016,Teruel,44048,Cabra de Mora,0,2,-2
2016,Teruel,44049,Calaceite,9,12,-3
2016,Teruel,44050,Calamocha,41,56,-15
2016,Teruel,44051,Calanda,20,56,-36
2016,Teruel,44052,Calomarde,0,1,-1
2016,Teruel,44054,Camarena de la Sierra,0,2,-2
2016,Teruel,44055,Camarillas,2,3,-1
2016,Teruel,44053,Camañas,1,2,-1
2016,Teruel,44056,Caminreal,3,12,-9
2016,Teruel,44059,Cantavieja,3,9,-6
2016,Teruel,44064,Cascante del Río,0,1,-1
2016,Teruel,44065,Castejón de Tornos,0,1,-1
2016,Teruel,44066,Castel de Cabra,1,5,-4
2016,Teruel,44070,Castellar (El),0,2,-2
2016,Teruel,44071,Castellote,2,9,-7
2016,Teruel,44067,Castelnou,5,2,3
2016,Teruel,44068,Castelserás,6,11,-5
2016,Teruel,44060,Cañada de Benatanduz,0,0,0
2016,Teruel,44061,Cañada de Verich (La),0,2,-2
2016,Teruel,44062,Cañada Vellida,0,2,-2
2016,Teruel,44063,Cañizar del Olivar,3,1,2
2016,Teruel,44074,Cedrillas,5,6,-1
2016,Teruel,44075,Celadas,4,4,0
2016,Teruel,44076,Cella,21,26,-5
2016,Teruel,44077,Cerollera (La),2,1,1
2016,Teruel,44080,Codoñera (La),2,4,-2
2016,Teruel,44082,Corbalán,1,2,-1
2016,Teruel,44084,Cortes de Aragón,1,2,-1
2016,Teruel,44086,Cretas,1,11,-10
2016,Teruel,44087,Crivillén,0,1,-1
2016,Teruel,44088,Cuba (La),0,1,-1
2016,Teruel,44089,Cubla,0,1,-1
2016,Teruel,44090,Cucalón,0,1,-1
2016,Teruel,44092,Cuervo (El),0,2,-2
2016,Teruel,44093,Cuevas de Almudén,2,2,0
2016,Teruel,44094,Cuevas Labradas,0,2,-2
2016,Teruel,44096,Ejulve,0,4,-4
2016,Teruel,44097,Escorihuela,0,8,-8
2016,Teruel,44099,Escucha,7,8,-1
2016,Teruel,44100,Estercuel,0,3,-3
2016,Teruel,44103,Formiche Alto,1,4,-3
2016,Teruel,44106,Fortanete,1,3,-2
2016,Teruel,44107,Foz-Calanda,1,2,-1
2016,Teruel,44108,Fresneda (La),2,8,-6
2016,Teruel,44109,Frías de Albarracín,1,1,0
2016,Teruel,44110,Fuenferrada,0,1,-1
2016,Teruel,44112,Fuentes Claras,0,9,-9
2016,Teruel,44113,Fuentes de Rubielos,2,1,1
2016,Teruel,44114,Fuentespalda,2,5,-3
2016,Teruel,44105,Fórnoles,1,2,-1
2016,Teruel,44116,Gargallo,1,3,-2
2016,Teruel,44117,Gea de Albarracín,2,10,-8
2016,Teruel,44118,Ginebrosa (La),3,2,1
2016,Teruel,44119,Griegos,0,2,-2
2016,Teruel,44120,Guadalaviar,2,3,-1
2016,Teruel,44121,Gúdar,1,0,1
2016,Teruel,44123,Hinojosa de Jarque,2,1,1
2016,Teruel,44124,Hoz de la Vieja (La),0,2,-2
2016,Teruel,44125,Huesa del Común,0,3,-3
2016,Teruel,44122,Híjar,8,25,-17
2016,Teruel,44126,Iglesuela del Cid (La),1,3,-2
2016,Teruel,44127,Jabaloyas,0,2,-2
2016,Teruel,44128,Jarque de la Val,0,2,-2
2016,Teruel,44129,Jatiel,1,1,0
2016,Teruel,44130,Jorcas,1,0,1
2016,Teruel,44131,Josa,1,0,1
2016,Teruel,44132,Lagueruela,4,2,2
2016,Teruel,44135,Libros,0,5,-5
2016,Teruel,44136,Lidón,0,1,-1
2016,Teruel,44137,Linares de Mora,3,4,-1
2016,Teruel,44141,Lledó,3,3,0
2016,Teruel,44138,Loscos,0,2,-2
2016,Teruel,44143,Manzanera,7,5,2
2016,Teruel,44144,Martín del Río,5,2,3
2016,Teruel,44145,Mas de las Matas,5,22,-17
2016,Teruel,44146,Mata de los Olmos (La),3,1,2
2016,Teruel,44147,Mazaleón,4,7,-3
2016,Teruel,44148,Mezquita de Jarque,1,3,-2
2016,Teruel,44149,Mirambel,0,2,-2
2016,Teruel,44151,Molinos,2,7,-5
2016,Teruel,44152,Monforte de Moyuela,0,1,-1
2016,Teruel,44153,Monreal del Campo,13,34,-21
2016,Teruel,44154,Monroyo,3,6,-3
2016,Teruel,44155,Montalbán,6,15,-9
2016,Teruel,44156,Monteagudo del Castillo,1,0,1
2016,Teruel,44157,Monterde de Albarracín,0,4,-4
2016,Teruel,44158,Mora de Rubielos,16,19,-3
2016,Teruel,44160,Mosqueruela,4,10,-6
2016,Teruel,44161,Muniesa,3,11,-8
2016,Teruel,44163,Noguera de Albarracín,0,3,-3
2016,Teruel,44165,Nogueruelas,1,3,-2
2016,Teruel,44168,Odón,1,4,-3
2016,Teruel,44169,Ojos Negros,1,7,-6
2016,Teruel,44171,Olba,0,7,-7
2016,Teruel,44172,Oliete,0,5,-5
2016,Teruel,44173,Olmos (Los),1,2,-1
2016,Teruel,44174,Orihuela del Tremedal,2,4,-2
2016,Teruel,44175,Orrios,1,3,-2
2016,Teruel,44176,Palomar de Arroyos,0,4,-4
2016,Teruel,44177,Pancrudo,2,4,-2
2016,Teruel,44178,Parras de Castellote (Las),0,2,-2
2016,Teruel,44181,Peralejos,1,6,-5
2016,Teruel,44182,Perales del Alfambra,0,4,-4
2016,Teruel,44179,Peñarroya de Tastavins,3,6,-3
2016,Teruel,44184,Plou,1,0,1
2016,Teruel,44185,Pobo (El),1,4,-3
2016,Teruel,44187,Portellada (La),1,4,-3
2016,Teruel,44189,Pozondón,0,2,-2
2016,Teruel,44190,Pozuel del Campo,0,1,-1
2016,Teruel,44191,Puebla de Híjar (La),12,13,-1
2016,Teruel,44192,Puebla de Valverde (La),6,9,-3
2016,Teruel,44193,Puertomingalvo,1,5,-4
2016,Teruel,44195,Rillo,0,2,-2
2016,Teruel,44196,Riodeva,0,2,-2
2016,Teruel,44198,Royuela,0,2,-2
2016,Teruel,44200,Rubielos de la Cérida,0,1,-1
2016,Teruel,44201,Rubielos de Mora,4,7,-3
2016,Teruel,44194,Ráfales,2,2,0
2016,Teruel,44197,Ródenas,0,2,-2
2016,Teruel,44203,Salcedillo,0,1,-1
2016,Teruel,44204,Saldón,0,1,-1
2016,Teruel,44205,Samper de Calanda,1,14,-13
2016,Teruel,44206,San Agustín,1,1,0
2016,Teruel,44207,San Martín del Río,0,3,-3
2016,Teruel,44208,Santa Cruz de Nogueras,0,0,0
2016,Teruel,44209,Santa Eulalia,8,19,-11
2016,Teruel,44210,Sarrión,16,15,1
2016,Teruel,44212,Seno,0,3,-3
2016,Teruel,44213,Singra,0,1,-1
2016,Teruel,44215,Terriente,1,0,1
2016,Teruel,44216,Teruel,330,316,14
2016,Teruel,44218,Tormón,0,1,-1
2016,Teruel,44219,Tornos,1,6,-5
2016,Teruel,44220,Torralba de los Sisones,0,2,-2
2016,Teruel,44225,Torre del Compte,0,1,-1
2016,Teruel,44227,Torre los Negros,0,2,-2
2016,Teruel,44221,Torrecilla de Alcañiz,2,4,-2
2016,Teruel,44222,Torrecilla del Rebollar,0,1,-1
2016,Teruel,44226,Torrelacárcel,1,5,-4
2016,Teruel,44228,Torremocha de Jiloca,0,3,-3
2016,Teruel,44229,Torres de Albarracín,1,3,-2
2016,Teruel,44230,Torrevelilla,3,4,-1
2016,Teruel,44231,Torrijas,0,1,-1
2016,Teruel,44232,Torrijo del Campo,1,5,-4
2016,Teruel,44235,Tramacastilla,0,1,-1
2016,Teruel,44236,Tronchón,0,1,-1
2016,Teruel,44237,Urrea de Gaén,2,5,-3
2016,Teruel,44238,Utrillas,17,28,-11
2016,Teruel,44240,Valbona,2,4,-2
2016,Teruel,44241,Valdealgorfa,3,9,-6
2016,Teruel,44244,Valdelinares,0,1,-1
2016,Teruel,44245,Valdeltormo,4,6,-2
2016,Teruel,44246,Valderrobres,25,30,-5
2016,Teruel,44247,Valjunquera,3,10,-7
2016,Teruel,44251,Villafranca del Campo,2,6,-4
2016,Teruel,44257,Villar del Cobo,1,0,1
2016,Teruel,44258,Villar del Salz,0,1,-1
2016,Teruel,44260,Villarluengo,0,2,-2
2016,Teruel,44261,Villarquemado,8,11,-3
2016,Teruel,44262,Villarroya de los Pinares,1,3,-2
2016,Teruel,44263,Villastar,7,8,-1
2016,Teruel,44264,Villel,1,4,-3
2016,Teruel,44265,Vinaceite,3,4,-1
2016,Teruel,44266,Visiedo,3,6,-3
2016,Teruel,44267,Vivel del Río Martín,1,1,0
2015,Teruel,44004,Aguaviva,4,7,-3
2015,Teruel,44005,Aguilar del Alfambra,2,2,0
2015,Teruel,44006,Alacón,0,6,-6
2015,Teruel,44007,Alba,1,7,-6
2015,Teruel,44008,Albalate del Arzobispo,15,28,-13
2015,Teruel,44009,Albarracín,8,17,-9
2015,Teruel,44010,Albentosa,1,3,-2
2015,Teruel,44011,Alcaine,1,3,-2
2015,Teruel,44012,Alcalá de la Selva,0,0,0
2015,Teruel,44013,Alcañiz,156,148,8
2015,Teruel,44014,Alcorisa,29,37,-8
2015,Teruel,44016,Alfambra,2,5,-3
2015,Teruel,44017,Aliaga,1,2,-1
2015,Teruel,44021,Allepuz,0,0,0
2015,Teruel,44022,Alloza,4,8,-4
2015,Teruel,44019,Alobras,0,4,-4
2015,Teruel,44025,Andorra,43,77,-34
2015,Teruel,44026,Arcos de las Salinas,0,1,-1
2015,Teruel,44027,Arens de Lledó,1,4,-3
2015,Teruel,44028,Argente,0,4,-4
2015,Teruel,44029,Ariño,7,15,-8
2015,Teruel,44031,Azaila,0,2,-2
2015,Teruel,44035,Barrachina,0,1,-1
2015,Teruel,44037,Beceite,7,4,3
2015,Teruel,44039,Bello,0,1,-1
2015,Teruel,44038,Belmonte de San José,0,5,-5
2015,Teruel,44040,Berge,6,0,6
2015,Teruel,44041,Bezas,0,3,-3
2015,Teruel,44042,Blancas,0,1,-1
2015,Teruel,44043,Blesa,0,2,-2
2015,Teruel,44044,Bordón,1,1,0
2015,Teruel,44045,Bronchales,1,4,-3
2015,Teruel,44046,Bueña,0,1,-1
2015,Teruel,44047,Burbáguena,0,12,-12
2015,Teruel,44032,Bádenas,0,1,-1
2015,Teruel,44033,Báguena,0,9,-9
2015,Teruel,44048,Cabra de Mora,0,2,-2
2015,Teruel,44049,Calaceite,7,10,-3
2015,Teruel,44050,Calamocha,30,69,-39
2015,Teruel,44051,Calanda,23,45,-22
2015,Teruel,44052,Calomarde,0,1,-1
2015,Teruel,44054,Camarena de la Sierra,2,3,-1
2015,Teruel,44055,Camarillas,0,2,-2
2015,Teruel,44053,Camañas,1,3,-2
2015,Teruel,44056,Caminreal,0,17,-17
2015,Teruel,44059,Cantavieja,4,8,-4
2015,Teruel,44064,Cascante del Río,0,2,-2
2015,Teruel,44065,Castejón de Tornos,0,1,-1
2015,Teruel,44066,Castel de Cabra,1,2,-1
2015,Teruel,44070,Castellar (El),0,2,-2
2015,Teruel,44071,Castellote,2,11,-9
2015,Teruel,44067,Castelnou,2,5,-3
2015,Teruel,44068,Castelserás,2,14,-12
2015,Teruel,44061,Cañada de Verich (La),0,2,-2
2015,Teruel,44062,Cañada Vellida,0,1,-1
2015,Teruel,44063,Cañizar del Olivar,2,0,2
2015,Teruel,44074,Cedrillas,5,6,-1
2015,Teruel,44075,Celadas,2,8,-6
2015,Teruel,44076,Cella,18,45,-27
2015,Teruel,44077,Cerollera (La),0,6,-6
2015,Teruel,44080,Codoñera (La),0,3,-3
2015,Teruel,44084,Cortes de Aragón,1,3,-2
2015,Teruel,44085,Cosa,0,1,-1
2015,Teruel,44086,Cretas,5,8,-3
2015,Teruel,44087,Crivillén,0,1,-1
2015,Teruel,44088,Cuba (La),1,1,0
2015,Teruel,44089,Cubla,0,2,-2
2015,Teruel,44092,Cuervo (El),0,1,-1
2015,Teruel,44093,Cuevas de Almudén,0,3,-3
2015,Teruel,44094,Cuevas Labradas,1,5,-4
2015,Teruel,44096,Ejulve,0,2,-2
2015,Teruel,44097,Escorihuela,0,3,-3
2015,Teruel,44099,Escucha,12,7,5
2015,Teruel,44100,Estercuel,1,6,-5
2015,Teruel,44103,Formiche Alto,0,0,0
2015,Teruel,44106,Fortanete,2,3,-1
2015,Teruel,44107,Foz-Calanda,1,4,-3
2015,Teruel,44108,Fresneda (La),3,7,-4
2015,Teruel,44110,Fuenferrada,0,2,-2
2015,Teruel,44111,Fuentes Calientes,2,2,0
2015,Teruel,44112,Fuentes Claras,5,14,-9
2015,Teruel,44113,Fuentes de Rubielos,0,2,-2
2015,Teruel,44114,Fuentespalda,2,3,-1
2015,Teruel,44105,Fórnoles,0,2,-2
2015,Teruel,44115,Galve,0,4,-4
2015,Teruel,44116,Gargallo,0,1,-1
2015,Teruel,44117,Gea de Albarracín,1,6,-5
2015,Teruel,44118,Ginebrosa (La),1,4,-3
2015,Teruel,44119,Griegos,0,3,-3
2015,Teruel,44120,Guadalaviar,1,4,-3
2015,Teruel,44121,Gúdar,1,1,0
2015,Teruel,44123,Hinojosa de Jarque,0,1,-1
2015,Teruel,44124,Hoz de la Vieja (La),1,2,-1
2015,Teruel,44125,Huesa del Común,0,4,-4
2015,Teruel,44122,Híjar,6,28,-22
2015,Teruel,44126,Iglesuela del Cid (La),2,11,-9
2015,Teruel,44128,Jarque de la Val,0,3,-3
2015,Teruel,44130,Jorcas,1,2,-1
2015,Teruel,44131,Josa,0,1,-1
2015,Teruel,44132,Lagueruela,2,0,2
2015,Teruel,44135,Libros,0,4,-4
2015,Teruel,44136,Lidón,0,1,-1
2015,Teruel,44137,Linares de Mora,0,4,-4
2015,Teruel,44141,Lledó,0,0,0
2015,Teruel,44138,Loscos,0,4,-4
2015,Teruel,44143,Manzanera,4,5,-1
2015,Teruel,44144,Martín del Río,2,5,-3
2015,Teruel,44145,Mas de las Matas,8,17,-9
2015,Teruel,44146,Mata de los Olmos (La),1,2,-1
2015,Teruel,44147,Mazaleón,1,8,-7
2015,Teruel,44148,Mezquita de Jarque,0,2,-2
2015,Teruel,44149,Mirambel,0,3,-3
2015,Teruel,44151,Molinos,0,4,-4
2015,Teruel,44152,Monforte de Moyuela,0,1,-1
2015,Teruel,44153,Monreal del Campo,31,53,-22
2015,Teruel,44154,Monroyo,2,3,-1
2015,Teruel,44155,Montalbán,9,21,-12
2015,Teruel,44157,Monterde de Albarracín,0,3,-3
2015,Teruel,44158,Mora de Rubielos,11,23,-12
2015,Teruel,44160,Mosqueruela,6,7,-1
2015,Teruel,44161,Muniesa,4,12,-8
2015,Teruel,44163,Noguera de Albarracín,0,1,-1
2015,Teruel,44165,Nogueruelas,1,2,-1
2015,Teruel,44167,Obón,0,3,-3
2015,Teruel,44169,Ojos Negros,3,6,-3
2015,Teruel,44171,Olba,1,3,-2
2015,Teruel,44172,Oliete,2,7,-5
2015,Teruel,44173,Olmos (Los),1,1,0
2015,Teruel,44174,Orihuela del Tremedal,1,5,-4
2015,Teruel,44175,Orrios,0,3,-3
2015,Teruel,44176,Palomar de Arroyos,3,3,0
2015,Teruel,44177,Pancrudo,0,4,-4
2015,Teruel,44181,Peralejos,1,6,-5
2015,Teruel,44182,Perales del Alfambra,1,5,-4
2015,Teruel,44179,Peñarroya de Tastavins,2,8,-6
2015,Teruel,44183,Pitarque,0,2,-2
2015,Teruel,44185,Pobo (El),1,0,1
2015,Teruel,44187,Portellada (La),1,3,-2
2015,Teruel,44189,Pozondón,0,3,-3
2015,Teruel,44190,Pozuel del Campo,0,4,-4
2015,Teruel,44191,Puebla de Híjar (La),5,6,-1
2015,Teruel,44192,Puebla de Valverde (La),3,7,-4
2015,Teruel,44193,Puertomingalvo,0,5,-5
2015,Teruel,44195,Rillo,0,5,-5
2015,Teruel,44196,Riodeva,0,5,-5
2015,Teruel,44198,Royuela,0,6,-6
2015,Teruel,44201,Rubielos de Mora,3,6,-3
2015,Teruel,44194,Ráfales,3,2,1
2015,Teruel,44197,Ródenas,1,3,-2
2015,Teruel,44205,Samper de Calanda,5,13,-8
2015,Teruel,44206,San Agustín,0,3,-3
2015,Teruel,44207,San Martín del Río,0,4,-4
2015,Teruel,44208,Santa Cruz de Nogueras,0,1,-1
2015,Teruel,44209,Santa Eulalia,3,16,-13
2015,Teruel,44210,Sarrión,17,14,3
2015,Teruel,44211,Segura de los Baños,0,1,-1
2015,Teruel,44212,Seno,0,3,-3
2015,Teruel,44213,Singra,0,3,-3
2015,Teruel,44215,Terriente,0,4,-4
2015,Teruel,44216,Teruel,325,338,-13
2015,Teruel,44218,Tormón,0,1,-1
2015,Teruel,44219,Tornos,0,6,-6
2015,Teruel,44220,Torralba de los Sisones,1,2,-1
2015,Teruel,44224,Torre de las Arcas,0,1,-1
2015,Teruel,44225,Torre del Compte,1,7,-6
2015,Teruel,44221,Torrecilla de Alcañiz,1,3,-2
2015,Teruel,44222,Torrecilla del Rebollar,0,1,-1
2015,Teruel,44226,Torrelacárcel,1,5,-4
2015,Teruel,44228,Torremocha de Jiloca,0,2,-2
2015,Teruel,44229,Torres de Albarracín,0,5,-5
2015,Teruel,44230,Torrevelilla,1,1,0
2015,Teruel,44232,Torrijo del Campo,1,6,-5
2015,Teruel,44234,Tramacastiel,0,1,-1
2015,Teruel,44235,Tramacastilla,0,3,-3
2015,Teruel,44236,Tronchón,0,3,-3
2015,Teruel,44237,Urrea de Gaén,0,9,-9
2015,Teruel,44238,Utrillas,20,38,-18
2015,Teruel,44239,Valacloche,0,1,-1
2015,Teruel,44240,Valbona,1,5,-4
2015,Teruel,44241,Valdealgorfa,2,11,-9
2015,Teruel,44243,Valdecuenca,0,1,-1
2015,Teruel,44244,Valdelinares,1,1,0
2015,Teruel,44245,Valdeltormo,1,10,-9
2015,Teruel,44246,Valderrobres,22,27,-5
2015,Teruel,44247,Valjunquera,2,5,-3
2015,Teruel,44250,Veguillas de la Sierra,0,1,-1
2015,Teruel,44251,Villafranca del Campo,2,4,-2
2015,Teruel,44252,Villahermosa del Campo,0,2,-2
2015,Teruel,44257,Villar del Cobo,2,4,-2
2015,Teruel,44258,Villar del Salz,1,1,0
2015,Teruel,44260,Villarluengo,2,3,-1
2015,Teruel,44261,Villarquemado,6,16,-10
2015,Teruel,44262,Villarroya de los Pinares,0,3,-3
2015,Teruel,44263,Villastar,6,4,2
2015,Teruel,44264,Villel,5,5,0
2015,Teruel,44265,Vinaceite,2,3,-1
2015,Teruel,44267,Vivel del Río Martín,0,4,-4
2014,Teruel,44001,Ababuj,1,0,1
2014,Teruel,44002,Abejuela,1,0,1
2014,Teruel,44004,Aguaviva,4,8,-4
2014,Teruel,44006,Alacón,0,8,-8
2014,Teruel,44007,Alba,0,1,-1
2014,Teruel,44008,Albalate del Arzobispo,12,23,-11
2014,Teruel,44009,Albarracín,8,13,-5
2014,Teruel,44010,Albentosa,4,4,0
2014,Teruel,44011,Alcaine,2,0,2
2014,Teruel,44012,Alcalá de la Selva,0,3,-3
2014,Teruel,44013,Alcañiz,163,158,5
2014,Teruel,44014,Alcorisa,27,47,-20
2014,Teruel,44016,Alfambra,3,4,-1
2014,Teruel,44017,Aliaga,1,6,-5
2014,Teruel,44021,Allepuz,0,3,-3
2014,Teruel,44022,Alloza,3,5,-2
2014,Teruel,44018,Almohaja,0,1,-1
2014,Teruel,44019,Alobras,0,2,-2
2014,Teruel,44020,Alpeñés,0,1,-1
2014,Teruel,44025,Andorra,64,73,-9
2014,Teruel,44026,Arcos de las Salinas,1,0,1
2014,Teruel,44027,Arens de Lledó,0,2,-2
2014,Teruel,44028,Argente,2,4,-2
2014,Teruel,44029,Ariño,6,14,-8
2014,Teruel,44031,Azaila,0,5,-5
2014,Teruel,44035,Barrachina,0,2,-2
2014,Teruel,44034,Bañón,0,6,-6
2014,Teruel,44036,Bea,0,1,-1
2014,Teruel,44037,Beceite,3,12,-9
2014,Teruel,44039,Bello,0,6,-6
2014,Teruel,44038,Belmonte de San José,0,2,-2
2014,Teruel,44040,Berge,0,3,-3
2014,Teruel,44042,Blancas,1,3,-2
2014,Teruel,44043,Blesa,0,1,-1
2014,Teruel,44044,Bordón,2,1,1
2014,Teruel,44045,Bronchales,0,4,-4
2014,Teruel,44046,Bueña,0,3,-3
2014,Teruel,44047,Burbáguena,1,20,-19
2014,Teruel,44033,Báguena,0,2,-2
2014,Teruel,44049,Calaceite,7,19,-12
2014,Teruel,44050,Calamocha,42,57,-15
2014,Teruel,44051,Calanda,33,56,-23
2014,Teruel,44052,Calomarde,0,3,-3
2014,Teruel,44054,Camarena de la Sierra,0,1,-1
2014,Teruel,44055,Camarillas,0,3,-3
2014,Teruel,44053,Camañas,0,1,-1
2014,Teruel,44056,Caminreal,2,11,-9
2014,Teruel,44059,Cantavieja,11,9,2
2014,Teruel,44064,Cascante del Río,0,1,-1
2014,Teruel,44066,Castel de Cabra,1,4,-3
2014,Teruel,44070,Castellar (El),0,0,0
2014,Teruel,44071,Castellote,2,9,-7
2014,Teruel,44067,Castelnou,1,1,0
2014,Teruel,44068,Castelserás,13,6,7
2014,Teruel,44061,Cañada de Verich (La),0,5,-5
2014,Teruel,44062,Cañada Vellida,0,3,-3
2014,Teruel,44063,Cañizar del Olivar,1,2,-1
2014,Teruel,44074,Cedrillas,2,9,-7
2014,Teruel,44075,Celadas,1,4,-3
2014,Teruel,44076,Cella,14,40,-26
2014,Teruel,44077,Cerollera (La),1,1,0
2014,Teruel,44080,Codoñera (La),3,11,-8
2014,Teruel,44082,Corbalán,0,3,-3
2014,Teruel,44084,Cortes de Aragón,0,4,-4
2014,Teruel,44085,Cosa,0,3,-3
2014,Teruel,44086,Cretas,2,7,-5
2014,Teruel,44087,Crivillén,0,1,-1
2014,Teruel,44088,Cuba (La),1,2,-1
2014,Teruel,44089,Cubla,0,2,-2
2014,Teruel,44090,Cucalón,0,1,-1
2014,Teruel,44092,Cuervo (El),0,3,-3
2014,Teruel,44093,Cuevas de Almudén,1,1,0
2014,Teruel,44094,Cuevas Labradas,0,2,-2
2014,Teruel,44096,Ejulve,2,2,0
2014,Teruel,44097,Escorihuela,0,4,-4
2014,Teruel,44099,Escucha,6,10,-4
2014,Teruel,44100,Estercuel,0,3,-3
2014,Teruel,44101,Ferreruela de Huerva,0,2,-2
2014,Teruel,44103,Formiche Alto,0,1,-1
2014,Teruel,44106,Fortanete,2,5,-3
2014,Teruel,44107,Foz-Calanda,1,3,-2
2014,Teruel,44108,Fresneda (La),5,5,0
2014,Teruel,44109,Frías de Albarracín,2,4,-2
2014,Teruel,44111,Fuentes Calientes,0,4,-4
2014,Teruel,44112,Fuentes Claras,0,10,-10
2014,Teruel,44113,Fuentes de Rubielos,0,2,-2
2014,Teruel,44114,Fuentespalda,0,6,-6
2014,Teruel,44115,Galve,1,1,0
2014,Teruel,44116,Gargallo,1,2,-1
2014,Teruel,44117,Gea de Albarracín,0,7,-7
2014,Teruel,44118,Ginebrosa (La),1,3,-2
2014,Teruel,44119,Griegos,1,0,1
2014,Teruel,44120,Guadalaviar,2,2,0
2014,Teruel,44123,Hinojosa de Jarque,0,3,-3
2014,Teruel,44124,Hoz de la Vieja (La),1,0,1
2014,Teruel,44125,Huesa del Común,0,2,-2
2014,Teruel,44122,Híjar,12,27,-15
2014,Teruel,44126,Iglesuela del Cid (La),2,8,-6
2014,Teruel,44127,Jabaloyas,0,1,-1
2014,Teruel,44128,Jarque de la Val,1,2,-1
2014,Teruel,44129,Jatiel,0,2,-2
2014,Teruel,44130,Jorcas,0,1,-1
2014,Teruel,44135,Libros,0,4,-4
2014,Teruel,44137,Linares de Mora,2,3,-1
2014,Teruel,44141,Lledó,2,3,-1
2014,Teruel,44138,Loscos,1,1,0
2014,Teruel,44143,Manzanera,3,7,-4
2014,Teruel,44144,Martín del Río,3,3,0
2014,Teruel,44145,Mas de las Matas,15,16,-1
2014,Teruel,44146,Mata de los Olmos (La),4,2,2
2014,Teruel,44147,Mazaleón,3,4,-1
2014,Teruel,44148,Mezquita de Jarque,1,6,-5
2014,Teruel,44149,Mirambel,1,2,-1
2014,Teruel,44150,Miravete de la Sierra,0,2,-2
2014,Teruel,44151,Molinos,1,0,1
2014,Teruel,44153,Monreal del Campo,30,33,-3
2014,Teruel,44154,Monroyo,1,0,1
2014,Teruel,44155,Montalbán,13,17,-4
2014,Teruel,44156,Monteagudo del Castillo,0,2,-2
2014,Teruel,44157,Monterde de Albarracín,0,1,-1
2014,Teruel,44158,Mora de Rubielos,18,15,3
2014,Teruel,44159,Moscardón,0,1,-1
2014,Teruel,44160,Mosqueruela,3,4,-1
2014,Teruel,44161,Muniesa,7,12,-5
2014,Teruel,44165,Nogueruelas,0,1,-1
2014,Teruel,44168,Odón,2,7,-5
2014,Teruel,44169,Ojos Negros,2,13,-11
2014,Teruel,44171,Olba,1,1,0
2014,Teruel,44172,Oliete,1,9,-8
2014,Teruel,44173,Olmos (Los),2,4,-2
2014,Teruel,44174,Orihuela del Tremedal,4,8,-4
2014,Teruel,44175,Orrios,0,2,-2
2014,Teruel,44176,Palomar de Arroyos,1,0,1
2014,Teruel,44177,Pancrudo,1,3,-2
2014,Teruel,44180,Peracense,0,1,-1
2014,Teruel,44182,Perales del Alfambra,0,3,-3
2014,Teruel,44179,Peñarroya de Tastavins,4,4,0
2014,Teruel,44183,Pitarque,0,2,-2
2014,Teruel,44185,Pobo (El),0,1,-1
2014,Teruel,44187,Portellada (La),3,3,0
2014,Teruel,44189,Pozondón,0,3,-3
2014,Teruel,44190,Pozuel del Campo,0,1,-1
2014,Teruel,44191,Puebla de Híjar (La),2,14,-12
2014,Teruel,44192,Puebla de Valverde (La),1,5,-4
2014,Teruel,44193,Puertomingalvo,0,3,-3
2014,Teruel,44195,Rillo,0,6,-6
2014,Teruel,44196,Riodeva,3,3,0
2014,Teruel,44198,Royuela,1,5,-4
2014,Teruel,44201,Rubielos de Mora,7,4,3
2014,Teruel,44194,Ráfales,0,3,-3
2014,Teruel,44197,Ródenas,0,2,-2
2014,Teruel,44204,Saldón,0,1,-1
2014,Teruel,44205,Samper de Calanda,3,17,-14
2014,Teruel,44206,San Agustín,1,2,-1
2014,Teruel,44207,San Martín del Río,0,6,-6
2014,Teruel,44208,Santa Cruz de Nogueras,0,2,-2
2014,Teruel,44209,Santa Eulalia,8,20,-12
2014,Teruel,44210,Sarrión,14,12,2
2014,Teruel,44211,Segura de los Baños,1,0,1
2014,Teruel,44212,Seno,0,1,-1
2014,Teruel,44213,Singra,0,2,-2
2014,Teruel,44215,Terriente,0,2,-2
2014,Teruel,44216,Teruel,356,308,48
2014,Teruel,44218,Tormón,0,1,-1
2014,Teruel,44219,Tornos,0,2,-2
2014,Teruel,44220,Torralba de los Sisones,0,3,-3
2014,Teruel,44223,Torre de Arcas,0,1,-1
2014,Teruel,44224,Torre de las Arcas,0,1,-1
2014,Teruel,44225,Torre del Compte,0,1,-1
2014,Teruel,44227,Torre los Negros,0,1,-1
2014,Teruel,44221,Torrecilla de Alcañiz,0,5,-5
2014,Teruel,44222,Torrecilla del Rebollar,0,1,-1
2014,Teruel,44226,Torrelacárcel,2,7,-5
2014,Teruel,44228,Torremocha de Jiloca,1,4,-3
2014,Teruel,44229,Torres de Albarracín,0,3,-3
2014,Teruel,44230,Torrevelilla,2,3,-1
2014,Teruel,44231,Torrijas,0,4,-4
2014,Teruel,44232,Torrijo del Campo,2,7,-5
2014,Teruel,44234,Tramacastiel,0,5,-5
2014,Teruel,44235,Tramacastilla,0,1,-1
2014,Teruel,44236,Tronchón,0,1,-1
2014,Teruel,44237,Urrea de Gaén,0,9,-9
2014,Teruel,44238,Utrillas,30,28,2
2014,Teruel,44239,Valacloche,0,1,-1
2014,Teruel,44240,Valbona,1,0,1
2014,Teruel,44241,Valdealgorfa,5,6,-1
2014,Teruel,44243,Valdecuenca,0,1,-1
2014,Teruel,44244,Valdelinares,0,5,-5
2014,Teruel,44245,Valdeltormo,4,7,-3
2014,Teruel,44246,Valderrobres,28,28,0
2014,Teruel,44247,Valjunquera,1,11,-10
2014,Teruel,44251,Villafranca del Campo,1,3,-2
2014,Teruel,44252,Villahermosa del Campo,1,1,0
2014,Teruel,44256,Villanueva del Rebollar de la Sierra,0,1,-1
2014,Teruel,44257,Villar del Cobo,0,2,-2
2014,Teruel,44258,Villar del Salz,1,2,-1
2014,Teruel,44260,Villarluengo,0,3,-3
2014,Teruel,44261,Villarquemado,5,16,-11
2014,Teruel,44262,Villarroya de los Pinares,0,3,-3
2014,Teruel,44263,Villastar,10,7,3
2014,Teruel,44264,Villel,3,4,-1
2014,Teruel,44265,Vinaceite,1,1,0
2014,Teruel,44266,Visiedo,0,1,-1
2014,Teruel,44267,Vivel del Río Martín,0,2,-2
2013,Teruel,44001,Ababuj,1,0,1
2013,Teruel,44002,Abejuela,0,1,-1
2013,Teruel,44003,Aguatón,0,1,-1
2013,Teruel,44004,Aguaviva,4,8,-4
2013,Teruel,44005,Aguilar del Alfambra,0,1,-1
2013,Teruel,44006,Alacón,0,3,-3
2013,Teruel,44007,Alba,0,5,-5
2013,Teruel,44008,Albalate del Arzobispo,13,37,-24
2013,Teruel,44009,Albarracín,7,20,-13
2013,Teruel,44010,Albentosa,2,4,-2
2013,Teruel,44011,Alcaine,2,0,2
2013,Teruel,44012,Alcalá de la Selva,2,9,-7
2013,Teruel,44013,Alcañiz,168,148,20
2013,Teruel,44014,Alcorisa,27,38,-11
2013,Teruel,44016,Alfambra,1,7,-6
2013,Teruel,44017,Aliaga,5,2,3
2013,Teruel,44021,Allepuz,0,4,-4
2013,Teruel,44022,Alloza,1,15,-14
2013,Teruel,44018,Almohaja,0,1,-1
2013,Teruel,44019,Alobras,0,1,-1
2013,Teruel,44025,Andorra,76,72,4
2013,Teruel,44026,Arcos de las Salinas,0,2,-2
2013,Teruel,44027,Arens de Lledó,0,3,-3
2013,Teruel,44028,Argente,0,5,-5
2013,Teruel,44029,Ariño,2,9,-7
2013,Teruel,44031,Azaila,0,2,-2
2013,Teruel,44035,Barrachina,0,4,-4
2013,Teruel,44034,Bañón,0,5,-5
2013,Teruel,44037,Beceite,7,10,-3
2013,Teruel,44039,Bello,0,7,-7
2013,Teruel,44038,Belmonte de San José,0,2,-2
2013,Teruel,44040,Berge,0,2,-2
2013,Teruel,44041,Bezas,0,1,-1
2013,Teruel,44042,Blancas,0,3,-3
2013,Teruel,44043,Blesa,0,1,-1
2013,Teruel,44044,Bordón,0,2,-2
2013,Teruel,44045,Bronchales,2,4,-2
2013,Teruel,44046,Bueña,0,1,-1
2013,Teruel,44047,Burbáguena,0,15,-15
2013,Teruel,44032,Bádenas,1,1,0
2013,Teruel,44033,Báguena,1,9,-8
2013,Teruel,44048,Cabra de Mora,1,1,0
2013,Teruel,44049,Calaceite,5,19,-14
2013,Teruel,44050,Calamocha,31,42,-11
2013,Teruel,44051,Calanda,32,50,-18
2013,Teruel,44052,Calomarde,0,2,-2
2013,Teruel,44053,Camañas,0,2,-2
2013,Teruel,44056,Caminreal,4,13,-9
2013,Teruel,44059,Cantavieja,6,13,-7
2013,Teruel,44064,Cascante del Río,0,1,-1
2013,Teruel,44066,Castel de Cabra,0,2,-2
2013,Teruel,44070,Castellar (El),0,1,-1
2013,Teruel,44071,Castellote,3,16,-13
2013,Teruel,44067,Castelnou,1,2,-1
2013,Teruel,44068,Castelserás,7,11,-4
2013,Teruel,44060,Cañada de Benatanduz,0,1,-1
2013,Teruel,44061,Cañada de Verich (La),0,2,-2
2013,Teruel,44062,Cañada Vellida,0,1,-1
2013,Teruel,44063,Cañizar del Olivar,0,2,-2
2013,Teruel,44074,Cedrillas,5,8,-3
2013,Teruel,44075,Celadas,2,6,-4
2013,Teruel,44076,Cella,16,28,-12
2013,Teruel,44077,Cerollera (La),0,2,-2
2013,Teruel,44080,Codoñera (La),3,2,1
2013,Teruel,44082,Corbalán,1,0,1
2013,Teruel,44084,Cortes de Aragón,0,4,-4
2013,Teruel,44085,Cosa,0,3,-3
2013,Teruel,44086,Cretas,4,10,-6
2013,Teruel,44088,Cuba (La),0,2,-2
2013,Teruel,44090,Cucalón,1,2,-1
2013,Teruel,44092,Cuervo (El),0,4,-4
2013,Teruel,44093,Cuevas de Almudén,3,1,2
2013,Teruel,44094,Cuevas Labradas,0,1,-1
2013,Teruel,44096,Ejulve,1,4,-3
2013,Teruel,44097,Escorihuela,1,2,-1
2013,Teruel,44099,Escucha,8,10,-2
2013,Teruel,44100,Estercuel,3,3,0
2013,Teruel,44101,Ferreruela de Huerva,0,1,-1
2013,Teruel,44103,Formiche Alto,0,3,-3
2013,Teruel,44106,Fortanete,1,1,0
2013,Teruel,44107,Foz-Calanda,2,2,0
2013,Teruel,44108,Fresneda (La),5,4,1
2013,Teruel,44109,Frías de Albarracín,2,2,0
2013,Teruel,44110,Fuenferrada,1,0,1
2013,Teruel,44111,Fuentes Calientes,1,2,-1
2013,Teruel,44112,Fuentes Claras,2,7,-5
2013,Teruel,44113,Fuentes de Rubielos,1,1,0
2013,Teruel,44114,Fuentespalda,1,5,-4
2013,Teruel,44115,Galve,2,2,0
2013,Teruel,44116,Gargallo,1,3,-2
2013,Teruel,44117,Gea de Albarracín,2,6,-4
2013,Teruel,44118,Ginebrosa (La),1,0,1
2013,Teruel,44120,Guadalaviar,2,1,1
2013,Teruel,44121,Gúdar,2,1,1
2013,Teruel,44123,Hinojosa de Jarque,1,4,-3
2013,Teruel,44124,Hoz de la Vieja (La),0,1,-1
2013,Teruel,44125,Huesa del Común,0,2,-2
2013,Teruel,44122,Híjar,15,20,-5
2013,Teruel,44126,Iglesuela del Cid (La),0,3,-3
2013,Teruel,44128,Jarque de la Val,0,2,-2
2013,Teruel,44129,Jatiel,0,1,-1
2013,Teruel,44130,Jorcas,0,1,-1
2013,Teruel,44131,Josa,0,1,-1
2013,Teruel,44135,Libros,0,4,-4
2013,Teruel,44136,Lidón,0,1,-1
2013,Teruel,44137,Linares de Mora,1,6,-5
2013,Teruel,44141,Lledó,3,5,-2
2013,Teruel,44138,Loscos,0,3,-3
2013,Teruel,44143,Manzanera,3,7,-4
2013,Teruel,44144,Martín del Río,0,4,-4
2013,Teruel,44145,Mas de las Matas,13,20,-7
2013,Teruel,44146,Mata de los Olmos (La),6,4,2
2013,Teruel,44147,Mazaleón,1,9,-8
2013,Teruel,44148,Mezquita de Jarque,2,2,0
2013,Teruel,44149,Mirambel,1,1,0
2013,Teruel,44151,Molinos,3,4,-1
2013,Teruel,44152,Monforte de Moyuela,0,1,-1
2013,Teruel,44153,Monreal del Campo,28,38,-10
2013,Teruel,44154,Monroyo,3,5,-2
2013,Teruel,44155,Montalbán,7,19,-12
2013,Teruel,44156,Monteagudo del Castillo,0,1,-1
2013,Teruel,44157,Monterde de Albarracín,0,1,-1
2013,Teruel,44158,Mora de Rubielos,16,20,-4
2013,Teruel,44160,Mosqueruela,4,3,1
2013,Teruel,44161,Muniesa,5,7,-2
2013,Teruel,44163,Noguera de Albarracín,0,1,-1
2013,Teruel,44165,Nogueruelas,1,3,-2
2013,Teruel,44167,Obón,0,4,-4
2013,Teruel,44168,Odón,1,3,-2
2013,Teruel,44169,Ojos Negros,0,6,-6
2013,Teruel,44171,Olba,3,3,0
2013,Teruel,44172,Oliete,0,9,-9
2013,Teruel,44173,Olmos (Los),0,5,-5
2013,Teruel,44174,Orihuela del Tremedal,1,6,-5
2013,Teruel,44175,Orrios,0,4,-4
2013,Teruel,44176,Palomar de Arroyos,2,0,2
2013,Teruel,44177,Pancrudo,0,2,-2
2013,Teruel,44178,Parras de Castellote (Las),0,2,-2
2013,Teruel,44182,Perales del Alfambra,0,3,-3
2013,Teruel,44179,Peñarroya de Tastavins,4,7,-3
2013,Teruel,44183,Pitarque,0,0,0
2013,Teruel,44184,Plou,1,0,1
2013,Teruel,44185,Pobo (El),1,3,-2
2013,Teruel,44187,Portellada (La),5,4,1
2013,Teruel,44189,Pozondón,1,1,0
2013,Teruel,44190,Pozuel del Campo,0,1,-1
2013,Teruel,44191,Puebla de Híjar (La),9,20,-11
2013,Teruel,44192,Puebla de Valverde (La),2,7,-5
2013,Teruel,44193,Puertomingalvo,1,0,1
2013,Teruel,44195,Rillo,0,1,-1
2013,Teruel,44196,Riodeva,1,4,-3
2013,Teruel,44198,Royuela,2,3,-1
2013,Teruel,44200,Rubielos de la Cérida,0,1,-1
2013,Teruel,44201,Rubielos de Mora,8,9,-1
2013,Teruel,44194,Ráfales,0,1,-1
2013,Teruel,44197,Ródenas,1,0,1
2013,Teruel,44205,Samper de Calanda,5,10,-5
2013,Teruel,44206,San Agustín,0,3,-3
2013,Teruel,44207,San Martín del Río,0,3,-3
2013,Teruel,44208,Santa Cruz de Nogueras,0,1,-1
2013,Teruel,44209,Santa Eulalia,8,15,-7
2013,Teruel,44210,Sarrión,16,14,2
2013,Teruel,44213,Singra,0,1,-1
2013,Teruel,44215,Terriente,2,1,1
2013,Teruel,44216,Teruel,353,339,14
2013,Teruel,44217,Toril y Masegoso,0,1,-1
2013,Teruel,44218,Tormón,0,2,-2
2013,Teruel,44220,Torralba de los Sisones,1,4,-3
2013,Teruel,44223,Torre de Arcas,0,3,-3
2013,Teruel,44225,Torre del Compte,1,2,-1
2013,Teruel,44227,Torre los Negros,1,0,1
2013,Teruel,44221,Torrecilla de Alcañiz,2,7,-5
2013,Teruel,44222,Torrecilla del Rebollar,0,2,-2
2013,Teruel,44226,Torrelacárcel,3,6,-3
2013,Teruel,44228,Torremocha de Jiloca,0,4,-4
2013,Teruel,44229,Torres de Albarracín,1,1,0
2013,Teruel,44230,Torrevelilla,1,3,-2
2013,Teruel,44232,Torrijo del Campo,2,8,-6
2013,Teruel,44234,Tramacastiel,0,2,-2
2013,Teruel,44235,Tramacastilla,0,1,-1
2013,Teruel,44236,Tronchón,0,1,-1
2013,Teruel,44237,Urrea de Gaén,2,11,-9
2013,Teruel,44238,Utrillas,19,32,-13
2013,Teruel,44240,Valbona,0,1,-1
2013,Teruel,44241,Valdealgorfa,3,11,-8
2013,Teruel,44243,Valdecuenca,0,1,-1
2013,Teruel,44244,Valdelinares,1,1,0
2013,Teruel,44245,Valdeltormo,1,7,-6
2013,Teruel,44246,Valderrobres,27,37,-10
2013,Teruel,44247,Valjunquera,0,9,-9
2013,Teruel,44250,Veguillas de la Sierra,0,2,-2
2013,Teruel,44251,Villafranca del Campo,2,6,-4
2013,Teruel,44252,Villahermosa del Campo,0,1,-1
2013,Teruel,44256,Villanueva del Rebollar de la Sierra,1,1,0
2013,Teruel,44257,Villar del Cobo,1,4,-3
2013,Teruel,44260,Villarluengo,3,1,2
2013,Teruel,44261,Villarquemado,5,12,-7
2013,Teruel,44262,Villarroya de los Pinares,2,3,-1
2013,Teruel,44263,Villastar,11,4,7
2013,Teruel,44264,Villel,4,5,-1
2013,Teruel,44265,Vinaceite,2,3,-1
2013,Teruel,44266,Visiedo,2,4,-2
2012,Teruel,44002,Abejuela,0,1,-1
2012,Teruel,44004,Aguaviva,4,7,-3
2012,Teruel,44005,Aguilar del Alfambra,0,1,-1
2012,Teruel,44006,Alacón,1,9,-8
2012,Teruel,44007,Alba,1,10,-9
2012,Teruel,44008,Albalate del Arzobispo,17,35,-18
2012,Teruel,44009,Albarracín,8,19,-11
2012,Teruel,44010,Albentosa,5,0,5
2012,Teruel,44011,Alcaine,0,1,-1
2012,Teruel,44012,Alcalá de la Selva,0,6,-6
2012,Teruel,44013,Alcañiz,188,171,17
2012,Teruel,44014,Alcorisa,27,34,-7
2012,Teruel,44016,Alfambra,4,14,-10
2012,Teruel,44017,Aliaga,1,11,-10
2012,Teruel,44021,Allepuz,1,0,1
2012,Teruel,44022,Alloza,3,8,-5
2012,Teruel,44019,Alobras,0,0,0
2012,Teruel,44025,Andorra,79,79,0
2012,Teruel,44026,Arcos de las Salinas,1,2,-1
2012,Teruel,44027,Arens de Lledó,1,2,-1
2012,Teruel,44028,Argente,1,5,-4
2012,Teruel,44029,Ariño,4,9,-5
2012,Teruel,44031,Azaila,0,6,-6
2012,Teruel,44035,Barrachina,0,1,-1
2012,Teruel,44034,Bañón,3,3,0
2012,Teruel,44037,Beceite,1,8,-7
2012,Teruel,44039,Bello,0,10,-10
2012,Teruel,44038,Belmonte de San José,0,3,-3
2012,Teruel,44040,Berge,5,6,-1
2012,Teruel,44041,Bezas,0,1,-1
2012,Teruel,44042,Blancas,0,1,-1
2012,Teruel,44043,Blesa,0,1,-1
2012,Teruel,44044,Bordón,1,2,-1
2012,Teruel,44045,Bronchales,3,3,0
2012,Teruel,44047,Burbáguena,0,22,-22
2012,Teruel,44032,Bádenas,0,1,-1
2012,Teruel,44033,Báguena,2,5,-3
2012,Teruel,44048,Cabra de Mora,1,0,1
2012,Teruel,44049,Calaceite,14,14,0
2012,Teruel,44050,Calamocha,43,50,-7
2012,Teruel,44051,Calanda,23,38,-15
2012,Teruel,44052,Calomarde,0,1,-1
2012,Teruel,44054,Camarena de la Sierra,2,3,-1
2012,Teruel,44055,Camarillas,0,2,-2
2012,Teruel,44053,Camañas,2,1,1
2012,Teruel,44056,Caminreal,3,12,-9
2012,Teruel,44059,Cantavieja,9,9,0
2012,Teruel,44064,Cascante del Río,0,2,-2
2012,Teruel,44065,Castejón de Tornos,0,1,-1
2012,Teruel,44066,Castel de Cabra,1,4,-3
2012,Teruel,44071,Castellote,2,15,-13
2012,Teruel,44067,Castelnou,2,1,1
2012,Teruel,44068,Castelserás,6,14,-8
2012,Teruel,44060,Cañada de Benatanduz,0,2,-2
2012,Teruel,44061,Cañada de Verich (La),0,4,-4
2012,Teruel,44074,Cedrillas,1,10,-9
2012,Teruel,44075,Celadas,1,4,-3
2012,Teruel,44076,Cella,20,37,-17
2012,Teruel,44077,Cerollera (La),0,2,-2
2012,Teruel,44080,Codoñera (La),4,5,-1
2012,Teruel,44082,Corbalán,1,1,0
2012,Teruel,44085,Cosa,0,1,-1
2012,Teruel,44086,Cretas,6,12,-6
2012,Teruel,44087,Crivillén,0,3,-3
2012,Teruel,44089,Cubla,0,0,0
2012,Teruel,44092,Cuervo (El),1,3,-2
2012,Teruel,44093,Cuevas de Almudén,0,0,0
2012,Teruel,44094,Cuevas Labradas,0,2,-2
2012,Teruel,44096,Ejulve,0,3,-3
2012,Teruel,44097,Escorihuela,0,3,-3
2012,Teruel,44099,Escucha,4,10,-6
2012,Teruel,44100,Estercuel,2,2,0
2012,Teruel,44101,Ferreruela de Huerva,0,1,-1
2012,Teruel,44103,Formiche Alto,0,4,-4
2012,Teruel,44106,Fortanete,1,3,-2
2012,Teruel,44107,Foz-Calanda,1,2,-1
2012,Teruel,44108,Fresneda (La),2,5,-3
2012,Teruel,44109,Frías de Albarracín,1,2,-1
2012,Teruel,44110,Fuenferrada,0,3,-3
2012,Teruel,44111,Fuentes Calientes,1,2,-1
2012,Teruel,44112,Fuentes Claras,4,8,-4
2012,Teruel,44113,Fuentes de Rubielos,1,1,0
2012,Teruel,44114,Fuentespalda,4,4,0
2012,Teruel,44105,Fórnoles,1,4,-3
2012,Teruel,44115,Galve,0,3,-3
2012,Teruel,44116,Gargallo,2,0,2
2012,Teruel,44117,Gea de Albarracín,1,6,-5
2012,Teruel,44118,Ginebrosa (La),0,3,-3
2012,Teruel,44119,Griegos,2,1,1
2012,Teruel,44120,Guadalaviar,4,3,1
2012,Teruel,44121,Gúdar,2,0,2
2012,Teruel,44123,Hinojosa de Jarque,1,0,1
2012,Teruel,44124,Hoz de la Vieja (La),0,3,-3
2012,Teruel,44125,Huesa del Común,0,1,-1
2012,Teruel,44122,Híjar,15,34,-19
2012,Teruel,44126,Iglesuela del Cid (La),3,9,-6
2012,Teruel,44130,Jorcas,0,1,-1
2012,Teruel,44131,Josa,0,1,-1
2012,Teruel,44133,Lanzuela,1,0,1
2012,Teruel,44135,Libros,0,3,-3
2012,Teruel,44136,Lidón,1,1,0
2012,Teruel,44137,Linares de Mora,2,4,-2
2012,Teruel,44141,Lledó,0,4,-4
2012,Teruel,44138,Loscos,0,3,-3
2012,Teruel,44143,Manzanera,3,8,-5
2012,Teruel,44144,Martín del Río,2,6,-4
2012,Teruel,44145,Mas de las Matas,10,31,-21
2012,Teruel,44146,Mata de los Olmos (La),4,2,2
2012,Teruel,44147,Mazaleón,4,6,-2
2012,Teruel,44148,Mezquita de Jarque,1,2,-1
2012,Teruel,44149,Mirambel,1,3,-2
2012,Teruel,44150,Miravete de la Sierra,0,2,-2
2012,Teruel,44151,Molinos,4,5,-1
2012,Teruel,44153,Monreal del Campo,26,41,-15
2012,Teruel,44154,Monroyo,1,4,-3
2012,Teruel,44155,Montalbán,5,9,-4
2012,Teruel,44156,Monteagudo del Castillo,0,1,-1
2012,Teruel,44158,Mora de Rubielos,14,17,-3
2012,Teruel,44159,Moscardón,1,1,0
2012,Teruel,44160,Mosqueruela,2,5,-3
2012,Teruel,44161,Muniesa,3,18,-15
2012,Teruel,44163,Noguera de Albarracín,0,3,-3
2012,Teruel,44165,Nogueruelas,0,2,-2
2012,Teruel,44167,Obón,0,1,-1
2012,Teruel,44168,Odón,0,2,-2
2012,Teruel,44169,Ojos Negros,2,10,-8
2012,Teruel,44171,Olba,2,1,1
2012,Teruel,44172,Oliete,0,5,-5
2012,Teruel,44173,Olmos (Los),1,1,0
2012,Teruel,44174,Orihuela del Tremedal,4,5,-1
2012,Teruel,44175,Orrios,0,4,-4
2012,Teruel,44176,Palomar de Arroyos,0,1,-1
2012,Teruel,44177,Pancrudo,0,2,-2
2012,Teruel,44178,Parras de Castellote (Las),0,3,-3
2012,Teruel,44180,Peracense,0,2,-2
2012,Teruel,44181,Peralejos,0,1,-1
2012,Teruel,44182,Perales del Alfambra,1,2,-1
2012,Teruel,44179,Peñarroya de Tastavins,6,5,1
2012,Teruel,44184,Plou,1,0,1
2012,Teruel,44185,Pobo (El),1,3,-2
2012,Teruel,44187,Portellada (La),0,6,-6
2012,Teruel,44189,Pozondón,0,3,-3
2012,Teruel,44191,Puebla de Híjar (La),6,23,-17
2012,Teruel,44192,Puebla de Valverde (La),7,5,2
2012,Teruel,44193,Puertomingalvo,0,2,-2
2012,Teruel,44195,Rillo,1,2,-1
2012,Teruel,44196,Riodeva,0,0,0
2012,Teruel,44198,Royuela,0,2,-2
2012,Teruel,44199,Rubiales,0,2,-2
2012,Teruel,44200,Rubielos de la Cérida,0,1,-1
2012,Teruel,44201,Rubielos de Mora,3,6,-3
2012,Teruel,44194,Ráfales,2,3,-1
2012,Teruel,44197,Ródenas,1,2,-1
2012,Teruel,44205,Samper de Calanda,1,8,-7
2012,Teruel,44207,San Martín del Río,1,4,-3
2012,Teruel,44209,Santa Eulalia,5,21,-16
2012,Teruel,44210,Sarrión,17,9,8
2012,Teruel,44211,Segura de los Baños,0,1,-1
2012,Teruel,44212,Seno,0,2,-2
2012,Teruel,44213,Singra,0,1,-1
2012,Teruel,44215,Terriente,1,4,-3
2012,Teruel,44216,Teruel,331,318,13
2012,Teruel,44218,Tormón,0,1,-1
2012,Teruel,44219,Tornos,0,2,-2
2012,Teruel,44220,Torralba de los Sisones,1,5,-4
2012,Teruel,44223,Torre de Arcas,0,2,-2
2012,Teruel,44224,Torre de las Arcas,1,0,1
2012,Teruel,44225,Torre del Compte,0,6,-6
2012,Teruel,44227,Torre los Negros,0,1,-1
2012,Teruel,44221,Torrecilla de Alcañiz,0,6,-6
2012,Teruel,44226,Torrelacárcel,1,4,-3
2012,Teruel,44228,Torremocha de Jiloca,0,4,-4
2012,Teruel,44229,Torres de Albarracín,2,3,-1
2012,Teruel,44230,Torrevelilla,2,3,-1
2012,Teruel,44231,Torrijas,0,3,-3
2012,Teruel,44232,Torrijo del Campo,3,5,-2
2012,Teruel,44234,Tramacastiel,0,3,-3
2012,Teruel,44235,Tramacastilla,0,3,-3
2012,Teruel,44236,Tronchón,0,1,-1
2012,Teruel,44237,Urrea de Gaén,2,8,-6
2012,Teruel,44238,Utrillas,36,25,11
2012,Teruel,44240,Valbona,1,6,-5
2012,Teruel,44241,Valdealgorfa,3,5,-2
2012,Teruel,44243,Valdecuenca,0,1,-1
2012,Teruel,44244,Valdelinares,1,0,1
2012,Teruel,44245,Valdeltormo,2,5,-3
2012,Teruel,44246,Valderrobres,22,37,-15
2012,Teruel,44247,Valjunquera,2,9,-7
2012,Teruel,44250,Veguillas de la Sierra,0,2,-2
2012,Teruel,44251,Villafranca del Campo,1,5,-4
2012,Teruel,44257,Villar del Cobo,1,0,1
2012,Teruel,44258,Villar del Salz,0,2,-2
2012,Teruel,44260,Villarluengo,3,1,2
2012,Teruel,44261,Villarquemado,4,12,-8
2012,Teruel,44262,Villarroya de los Pinares,0,1,-1
2012,Teruel,44263,Villastar,11,1,10
2012,Teruel,44264,Villel,2,7,-5
2012,Teruel,44265,Vinaceite,1,6,-5
2012,Teruel,44266,Visiedo,0,2,-2
2011,Teruel,44001,Ababuj,0,1,-1
2011,Teruel,44002,Abejuela,0,1,-1
2011,Teruel,44004,Aguaviva,7,9,-2
2011,Teruel,44005,Aguilar del Alfambra,0,2,-2
2011,Teruel,44006,Alacón,1,9,-8
2011,Teruel,44007,Alba,1,3,-2
2011,Teruel,44008,Albalate del Arzobispo,14,29,-15
2011,Teruel,44009,Albarracín,11,18,-7
2011,Teruel,44010,Albentosa,2,2,0
2011,Teruel,44011,Alcaine,0,0,0
2011,Teruel,44012,Alcalá de la Selva,2,2,0
2011,Teruel,44013,Alcañiz,187,158,29
2011,Teruel,44014,Alcorisa,33,32,1
2011,Teruel,44016,Alfambra,0,8,-8
2011,Teruel,44017,Aliaga,2,14,-12
2011,Teruel,44021,Allepuz,0,1,-1
2011,Teruel,44022,Alloza,5,11,-6
2011,Teruel,44018,Almohaja,0,1,-1
2011,Teruel,44019,Alobras,0,2,-2
2011,Teruel,44020,Alpeñés,0,1,-1
2011,Teruel,44025,Andorra,54,77,-23
2011,Teruel,44028,Argente,1,6,-5
2011,Teruel,44029,Ariño,5,14,-9
2011,Teruel,44031,Azaila,0,11,-11
2011,Teruel,44035,Barrachina,1,3,-2
2011,Teruel,44037,Beceite,4,9,-5
2011,Teruel,44039,Bello,1,4,-3
2011,Teruel,44038,Belmonte de San José,0,3,-3
2011,Teruel,44040,Berge,0,3,-3
2011,Teruel,44041,Bezas,0,1,-1
2011,Teruel,44042,Blancas,2,1,1
2011,Teruel,44043,Blesa,0,1,-1
2011,Teruel,44044,Bordón,0,1,-1
2011,Teruel,44045,Bronchales,1,2,-1
2011,Teruel,44046,Bueña,0,3,-3
2011,Teruel,44047,Burbáguena,0,14,-14
2011,Teruel,44032,Bádenas,1,0,1
2011,Teruel,44033,Báguena,1,6,-5
2011,Teruel,44048,Cabra de Mora,0,1,-1
2011,Teruel,44049,Calaceite,8,25,-17
2011,Teruel,44050,Calamocha,42,49,-7
2011,Teruel,44051,Calanda,37,50,-13
2011,Teruel,44054,Camarena de la Sierra,0,0,0
2011,Teruel,44055,Camarillas,0,4,-4
2011,Teruel,44053,Camañas,2,1,1
2011,Teruel,44056,Caminreal,5,5,0
2011,Teruel,44059,Cantavieja,5,5,0
2011,Teruel,44064,Cascante del Río,0,1,-1
2011,Teruel,44065,Castejón de Tornos,0,1,-1
2011,Teruel,44066,Castel de Cabra,1,1,0
2011,Teruel,44070,Castellar (El),0,3,-3
2011,Teruel,44071,Castellote,6,17,-11
2011,Teruel,44067,Castelnou,3,2,1
2011,Teruel,44068,Castelserás,9,9,0
2011,Teruel,44060,Cañada de Benatanduz,0,2,-2
2011,Teruel,44063,Cañizar del Olivar,1,0,1
2011,Teruel,44074,Cedrillas,7,6,1
2011,Teruel,44075,Celadas,0,9,-9
2011,Teruel,44076,Cella,29,34,-5
2011,Teruel,44077,Cerollera (La),0,2,-2
2011,Teruel,44080,Codoñera (La),2,9,-7
2011,Teruel,44082,Corbalán,1,1,0
2011,Teruel,44084,Cortes de Aragón,1,0,1
2011,Teruel,44086,Cretas,5,8,-3
2011,Teruel,44087,Crivillén,0,1,-1
2011,Teruel,44090,Cucalón,1,1,0
2011,Teruel,44092,Cuervo (El),1,2,-1
2011,Teruel,44093,Cuevas de Almudén,1,1,0
2011,Teruel,44094,Cuevas Labradas,0,5,-5
2011,Teruel,44096,Ejulve,2,0,2
2011,Teruel,44097,Escorihuela,0,1,-1
2011,Teruel,44099,Escucha,10,9,1
2011,Teruel,44100,Estercuel,0,5,-5
2011,Teruel,44101,Ferreruela de Huerva,1,0,1
2011,Teruel,44103,Formiche Alto,0,2,-2
2011,Teruel,44106,Fortanete,2,2,0
2011,Teruel,44107,Foz-Calanda,1,4,-3
2011,Teruel,44108,Fresneda (La),4,14,-10
2011,Teruel,44109,Frías de Albarracín,1,3,-2
2011,Teruel,44110,Fuenferrada,0,1,-1
2011,Teruel,44111,Fuentes Calientes,1,3,-2
2011,Teruel,44112,Fuentes Claras,0,4,-4
2011,Teruel,44113,Fuentes de Rubielos,4,0,4
2011,Teruel,44114,Fuentespalda,1,3,-2
2011,Teruel,44105,Fórnoles,0,2,-2
2011,Teruel,44115,Galve,3,1,2
2011,Teruel,44116,Gargallo,2,1,1
2011,Teruel,44117,Gea de Albarracín,0,8,-8
2011,Teruel,44118,Ginebrosa (La),2,5,-3
2011,Teruel,44119,Griegos,1,1,0
2011,Teruel,44120,Guadalaviar,1,2,-1
2011,Teruel,44121,Gúdar,0,0,0
2011,Teruel,44123,Hinojosa de Jarque,0,3,-3
2011,Teruel,44124,Hoz de la Vieja (La),0,3,-3
2011,Teruel,44125,Huesa del Común,0,2,-2
2011,Teruel,44122,Híjar,11,31,-20
2011,Teruel,44126,Iglesuela del Cid (La),3,5,-2
2011,Teruel,44127,Jabaloyas,0,2,-2
2011,Teruel,44128,Jarque de la Val,1,1,0
2011,Teruel,44130,Jorcas,0,1,-1
2011,Teruel,44135,Libros,0,4,-4
2011,Teruel,44137,Linares de Mora,2,3,-1
2011,Teruel,44141,Lledó,1,1,0
2011,Teruel,44138,Loscos,1,2,-1
2011,Teruel,44143,Manzanera,4,8,-4
2011,Teruel,44144,Martín del Río,2,4,-2
2011,Teruel,44145,Mas de las Matas,6,41,-35
2011,Teruel,44146,Mata de los Olmos (La),3,4,-1
2011,Teruel,44147,Mazaleón,2,5,-3
2011,Teruel,44148,Mezquita de Jarque,0,2,-2
2011,Teruel,44149,Mirambel,1,6,-5
2011,Teruel,44151,Molinos,0,1,-1
2011,Teruel,44153,Monreal del Campo,33,26,7
2011,Teruel,44154,Monroyo,1,3,-2
2011,Teruel,44155,Montalbán,9,17,-8
2011,Teruel,44156,Monteagudo del Castillo,0,1,-1
2011,Teruel,44157,Monterde de Albarracín,0,1,-1
2011,Teruel,44158,Mora de Rubielos,20,15,5
2011,Teruel,44160,Mosqueruela,3,6,-3
2011,Teruel,44161,Muniesa,6,14,-8
2011,Teruel,44163,Noguera de Albarracín,0,1,-1
2011,Teruel,44164,Nogueras,0,2,-2
2011,Teruel,44165,Nogueruelas,3,2,1
2011,Teruel,44167,Obón,0,1,-1
2011,Teruel,44168,Odón,0,2,-2
2011,Teruel,44169,Ojos Negros,3,10,-7
2011,Teruel,44171,Olba,2,4,-2
2011,Teruel,44172,Oliete,0,9,-9
2011,Teruel,44173,Olmos (Los),1,2,-1
2011,Teruel,44174,Orihuela del Tremedal,4,3,1
2011,Teruel,44175,Orrios,0,3,-3
2011,Teruel,44176,Palomar de Arroyos,1,1,0
2011,Teruel,44177,Pancrudo,0,1,-1
2011,Teruel,44178,Parras de Castellote (Las),0,1,-1
2011,Teruel,44180,Peracense,0,2,-2
2011,Teruel,44182,Perales del Alfambra,3,2,1
2011,Teruel,44179,Peñarroya de Tastavins,3,5,-2
2011,Teruel,44183,Pitarque,0,2,-2
2011,Teruel,44187,Portellada (La),4,4,0
2011,Teruel,44189,Pozondón,0,2,-2
2011,Teruel,44190,Pozuel del Campo,0,1,-1
2011,Teruel,44191,Puebla de Híjar (La),5,10,-5
2011,Teruel,44192,Puebla de Valverde (La),5,6,-1
2011,Teruel,44193,Puertomingalvo,1,1,0
2011,Teruel,44195,Rillo,0,1,-1
2011,Teruel,44196,Riodeva,0,2,-2
2011,Teruel,44198,Royuela,2,8,-6
2011,Teruel,44199,Rubiales,0,2,-2
2011,Teruel,44201,Rubielos de Mora,6,4,2
2011,Teruel,44194,Ráfales,1,4,-3
2011,Teruel,44197,Ródenas,0,1,-1
2011,Teruel,44204,Saldón,0,1,-1
2011,Teruel,44205,Samper de Calanda,5,20,-15
2011,Teruel,44206,San Agustín,1,2,-1
2011,Teruel,44207,San Martín del Río,0,5,-5
2011,Teruel,44209,Santa Eulalia,9,29,-20
2011,Teruel,44210,Sarrión,11,15,-4
2011,Teruel,44212,Seno,2,1,1
2011,Teruel,44213,Singra,0,3,-3
2011,Teruel,44215,Terriente,0,4,-4
2011,Teruel,44216,Teruel,374,334,40
2011,Teruel,44217,Toril y Masegoso,0,1,-1
2011,Teruel,44218,Tormón,0,1,-1
2011,Teruel,44219,Tornos,0,4,-4
2011,Teruel,44220,Torralba de los Sisones,0,2,-2
2011,Teruel,44223,Torre de Arcas,1,2,-1
2011,Teruel,44224,Torre de las Arcas,0,1,-1
2011,Teruel,44225,Torre del Compte,1,3,-2
2011,Teruel,44227,Torre los Negros,0,2,-2
2011,Teruel,44221,Torrecilla de Alcañiz,0,5,-5
2011,Teruel,44222,Torrecilla del Rebollar,0,2,-2
2011,Teruel,44226,Torrelacárcel,0,5,-5
2011,Teruel,44228,Torremocha de Jiloca,0,1,-1
2011,Teruel,44229,Torres de Albarracín,0,3,-3
2011,Teruel,44230,Torrevelilla,1,5,-4
2011,Teruel,44231,Torrijas,0,1,-1
2011,Teruel,44232,Torrijo del Campo,1,9,-8
2011,Teruel,44234,Tramacastiel,0,3,-3
2011,Teruel,44235,Tramacastilla,2,0,2
2011,Teruel,44236,Tronchón,0,1,-1
2011,Teruel,44237,Urrea de Gaén,4,6,-2
2011,Teruel,44238,Utrillas,31,31,0
2011,Teruel,44239,Valacloche,0,1,-1
2011,Teruel,44240,Valbona,0,0,0
2011,Teruel,44241,Valdealgorfa,5,14,-9
2011,Teruel,44243,Valdecuenca,0,1,-1
2011,Teruel,44244,Valdelinares,1,0,1
2011,Teruel,44245,Valdeltormo,2,8,-6
2011,Teruel,44246,Valderrobres,28,45,-17
2011,Teruel,44247,Valjunquera,0,6,-6
2011,Teruel,44251,Villafranca del Campo,2,4,-2
2011,Teruel,44252,Villahermosa del Campo,1,0,1
2011,Teruel,44256,Villanueva del Rebollar de la Sierra,0,1,-1
2011,Teruel,44257,Villar del Cobo,0,1,-1
2011,Teruel,44258,Villar del Salz,0,1,-1
2011,Teruel,44260,Villarluengo,2,4,-2
2011,Teruel,44261,Villarquemado,6,10,-4
2011,Teruel,44262,Villarroya de los Pinares,1,3,-2
2011,Teruel,44263,Villastar,7,6,1
2011,Teruel,44264,Villel,5,1,4
2011,Teruel,44265,Vinaceite,1,3,-2
2011,Teruel,44266,Visiedo,0,2,-2
2011,Teruel,44267,Vivel del Río Martín,1,1,0
2011,Teruel,44268,Zoma (La),0,2,-2
2010,Teruel,44001,Ababuj,1,2,-1
2010,Teruel,44002,Abejuela,0,1,-1
2010,Teruel,44004,Aguaviva,1,5,-4
2010,Teruel,44005,Aguilar del Alfambra,0,1,-1
2010,Teruel,44006,Alacón,1,5,-4
2010,Teruel,44007,Alba,1,2,-1
2010,Teruel,44008,Albalate del Arzobispo,17,25,-8
2010,Teruel,44009,Albarracín,11,12,-1
2010,Teruel,44010,Albentosa,5,3,2
2010,Teruel,44011,Alcaine,1,1,0
2010,Teruel,44012,Alcalá de la Selva,6,9,-3
2010,Teruel,44013,Alcañiz,230,163,67
2010,Teruel,44014,Alcorisa,37,49,-12
2010,Teruel,44016,Alfambra,2,12,-10
2010,Teruel,44017,Aliaga,3,4,-1
2010,Teruel,44021,Allepuz,0,5,-5
2010,Teruel,44022,Alloza,5,9,-4
2010,Teruel,44025,Andorra,62,75,-13
2010,Teruel,44026,Arcos de las Salinas,0,2,-2
2010,Teruel,44027,Arens de Lledó,1,5,-4
2010,Teruel,44028,Argente,1,7,-6
2010,Teruel,44029,Ariño,6,14,-8
2010,Teruel,44031,Azaila,0,2,-2
2010,Teruel,44035,Barrachina,2,2,0
2010,Teruel,44034,Bañón,0,1,-1
2010,Teruel,44037,Beceite,5,8,-3
2010,Teruel,44039,Bello,0,2,-2
2010,Teruel,44038,Belmonte de San José,0,5,-5
2010,Teruel,44040,Berge,1,6,-5
2010,Teruel,44041,Bezas,0,1,-1
2010,Teruel,44042,Blancas,0,1,-1
2010,Teruel,44044,Bordón,0,2,-2
2010,Teruel,44045,Bronchales,1,3,-2
2010,Teruel,44046,Bueña,0,1,-1
2010,Teruel,44047,Burbáguena,0,15,-15
2010,Teruel,44033,Báguena,0,6,-6
2010,Teruel,44048,Cabra de Mora,0,1,-1
2010,Teruel,44049,Calaceite,6,23,-17
2010,Teruel,44050,Calamocha,47,45,2
2010,Teruel,44051,Calanda,23,45,-22
2010,Teruel,44052,Calomarde,0,2,-2
2010,Teruel,44054,Camarena de la Sierra,1,4,-3
2010,Teruel,44055,Camarillas,0,1,-1
2010,Teruel,44053,Camañas,0,3,-3
2010,Teruel,44056,Caminreal,4,13,-9
2010,Teruel,44059,Cantavieja,8,8,0
2010,Teruel,44065,Castejón de Tornos,0,1,-1
2010,Teruel,44066,Castel de Cabra,0,2,-2
2010,Teruel,44070,Castellar (El),0,1,-1
2010,Teruel,44071,Castellote,1,5,-4
2010,Teruel,44067,Castelnou,0,3,-3
2010,Teruel,44068,Castelserás,2,15,-13
2010,Teruel,44060,Cañada de Benatanduz,0,1,-1
2010,Teruel,44061,Cañada de Verich (La),0,1,-1
2010,Teruel,44062,Cañada Vellida,0,1,-1
2010,Teruel,44063,Cañizar del Olivar,2,1,1
2010,Teruel,44074,Cedrillas,2,11,-9
2010,Teruel,44075,Celadas,0,5,-5
2010,Teruel,44076,Cella,16,26,-10
2010,Teruel,44077,Cerollera (La),0,1,-1
2010,Teruel,44080,Codoñera (La),2,4,-2
2010,Teruel,44082,Corbalán,0,2,-2
2010,Teruel,44084,Cortes de Aragón,0,2,-2
2010,Teruel,44085,Cosa,0,2,-2
2010,Teruel,44086,Cretas,2,12,-10
2010,Teruel,44089,Cubla,0,2,-2
2010,Teruel,44090,Cucalón,1,2,-1
2010,Teruel,44092,Cuervo (El),0,4,-4
2010,Teruel,44093,Cuevas de Almudén,5,0,5
2010,Teruel,44094,Cuevas Labradas,0,1,-1
2010,Teruel,44096,Ejulve,0,1,-1
2010,Teruel,44097,Escorihuela,0,1,-1
2010,Teruel,44099,Escucha,7,10,-3
2010,Teruel,44100,Estercuel,4,6,-2
2010,Teruel,44101,Ferreruela de Huerva,0,2,-2
2010,Teruel,44103,Formiche Alto,0,7,-7
2010,Teruel,44106,Fortanete,3,3,0
2010,Teruel,44107,Foz-Calanda,2,3,-1
2010,Teruel,44108,Fresneda (La),4,8,-4
2010,Teruel,44109,Frías de Albarracín,0,2,-2
2010,Teruel,44111,Fuentes Calientes,1,0,1
2010,Teruel,44112,Fuentes Claras,3,10,-7
2010,Teruel,44113,Fuentes de Rubielos,1,1,0
2010,Teruel,44114,Fuentespalda,2,14,-12
2010,Teruel,44105,Fórnoles,1,1,0
2010,Teruel,44115,Galve,1,0,1
2010,Teruel,44116,Gargallo,1,0,1
2010,Teruel,44117,Gea de Albarracín,2,7,-5
2010,Teruel,44118,Ginebrosa (La),0,1,-1
2010,Teruel,44119,Griegos,1,1,0
2010,Teruel,44120,Guadalaviar,2,1,1
2010,Teruel,44121,Gúdar,2,0,2
2010,Teruel,44123,Hinojosa de Jarque,3,4,-1
2010,Teruel,44125,Huesa del Común,0,1,-1
2010,Teruel,44122,Híjar,10,33,-23
2010,Teruel,44126,Iglesuela del Cid (La),4,4,0
2010,Teruel,44128,Jarque de la Val,1,0,1
2010,Teruel,44129,Jatiel,0,0,0
2010,Teruel,44130,Jorcas,0,1,-1
2010,Teruel,44133,Lanzuela,1,0,1
2010,Teruel,44135,Libros,0,4,-4
2010,Teruel,44137,Linares de Mora,0,2,-2
2010,Teruel,44141,Lledó,0,2,-2
2010,Teruel,44138,Loscos,0,3,-3
2010,Teruel,44143,Manzanera,5,7,-2
2010,Teruel,44144,Martín del Río,2,8,-6
2010,Teruel,44145,Mas de las Matas,9,27,-18
2010,Teruel,44146,Mata de los Olmos (La),2,2,0
2010,Teruel,44147,Mazaleón,2,9,-7
2010,Teruel,44148,Mezquita de Jarque,0,1,-1
2010,Teruel,44149,Mirambel,2,3,-1
2010,Teruel,44150,Miravete de la Sierra,0,1,-1
2010,Teruel,44151,Molinos,2,6,-4
2010,Teruel,44153,Monreal del Campo,25,23,2
2010,Teruel,44154,Monroyo,4,6,-2
2010,Teruel,44155,Montalbán,9,13,-4
2010,Teruel,44156,Monteagudo del Castillo,0,1,-1
2010,Teruel,44157,Monterde de Albarracín,0,1,-1
2010,Teruel,44158,Mora de Rubielos,15,13,2
2010,Teruel,44159,Moscardón,1,2,-1
2010,Teruel,44160,Mosqueruela,5,10,-5
2010,Teruel,44161,Muniesa,6,8,-2
2010,Teruel,44163,Noguera de Albarracín,2,2,0
2010,Teruel,44164,Nogueras,0,1,-1
2010,Teruel,44165,Nogueruelas,1,3,-2
2010,Teruel,44167,Obón,0,1,-1
2010,Teruel,44168,Odón,1,2,-1
2010,Teruel,44169,Ojos Negros,3,9,-6
2010,Teruel,44171,Olba,2,2,0
2010,Teruel,44172,Oliete,1,6,-5
2010,Teruel,44173,Olmos (Los),0,1,-1
2010,Teruel,44174,Orihuela del Tremedal,3,10,-7
2010,Teruel,44175,Orrios,0,1,-1
2010,Teruel,44176,Palomar de Arroyos,0,3,-3
2010,Teruel,44177,Pancrudo,0,1,-1
2010,Teruel,44178,Parras de Castellote (Las),0,1,-1
2010,Teruel,44180,Peracense,1,2,-1
2010,Teruel,44182,Perales del Alfambra,1,3,-2
2010,Teruel,44179,Peñarroya de Tastavins,3,8,-5
2010,Teruel,44183,Pitarque,2,2,0
2010,Teruel,44185,Pobo (El),0,2,-2
2010,Teruel,44187,Portellada (La),0,4,-4
2010,Teruel,44190,Pozuel del Campo,0,3,-3
2010,Teruel,44191,Puebla de Híjar (La),6,14,-8
2010,Teruel,44192,Puebla de Valverde (La),3,9,-6
2010,Teruel,44193,Puertomingalvo,1,0,1
2010,Teruel,44195,Rillo,0,3,-3
2010,Teruel,44196,Riodeva,1,3,-2
2010,Teruel,44198,Royuela,2,1,1
2010,Teruel,44199,Rubiales,0,1,-1
2010,Teruel,44201,Rubielos de Mora,5,4,1
2010,Teruel,44194,Ráfales,3,5,-2
2010,Teruel,44197,Ródenas,0,1,-1
2010,Teruel,44204,Saldón,1,1,0
2010,Teruel,44205,Samper de Calanda,2,15,-13
2010,Teruel,44206,San Agustín,1,2,-1
2010,Teruel,44207,San Martín del Río,0,6,-6
2010,Teruel,44209,Santa Eulalia,10,13,-3
2010,Teruel,44210,Sarrión,9,15,-6
2010,Teruel,44211,Segura de los Baños,0,1,-1
2010,Teruel,44212,Seno,0,1,-1
2010,Teruel,44213,Singra,0,2,-2
2010,Teruel,44215,Terriente,1,2,-1
2010,Teruel,44216,Teruel,360,316,44
2010,Teruel,44218,Tormón,0,3,-3
2010,Teruel,44219,Tornos,0,4,-4
2010,Teruel,44220,Torralba de los Sisones,0,1,-1
2010,Teruel,44223,Torre de Arcas,1,1,0
2010,Teruel,44224,Torre de las Arcas,0,3,-3
2010,Teruel,44225,Torre del Compte,1,2,-1
2010,Teruel,44222,Torrecilla del Rebollar,0,3,-3
2010,Teruel,44226,Torrelacárcel,0,5,-5
2010,Teruel,44229,Torres de Albarracín,0,1,-1
2010,Teruel,44230,Torrevelilla,1,3,-2
2010,Teruel,44231,Torrijas,0,2,-2
2010,Teruel,44232,Torrijo del Campo,3,11,-8
2010,Teruel,44234,Tramacastiel,1,4,-3
2010,Teruel,44235,Tramacastilla,0,2,-2
2010,Teruel,44236,Tronchón,0,1,-1
2010,Teruel,44237,Urrea de Gaén,3,9,-6
2010,Teruel,44238,Utrillas,25,27,-2
2010,Teruel,44239,Valacloche,0,1,-1
2010,Teruel,44240,Valbona,0,3,-3
2010,Teruel,44241,Valdealgorfa,5,11,-6
2010,Teruel,44244,Valdelinares,0,1,-1
2010,Teruel,44245,Valdeltormo,1,3,-2
2010,Teruel,44246,Valderrobres,23,37,-14
2010,Teruel,44247,Valjunquera,1,12,-11
2010,Teruel,44250,Veguillas de la Sierra,0,2,-2
2010,Teruel,44251,Villafranca del Campo,3,6,-3
2010,Teruel,44252,Villahermosa del Campo,0,1,-1
2010,Teruel,44256,Villanueva del Rebollar de la Sierra,0,1,-1
2010,Teruel,44257,Villar del Cobo,3,1,2
2010,Teruel,44258,Villar del Salz,0,3,-3
2010,Teruel,44260,Villarluengo,1,2,-1
2010,Teruel,44261,Villarquemado,4,19,-15
2010,Teruel,44262,Villarroya de los Pinares,1,3,-2
2010,Teruel,44263,Villastar,9,3,6
2010,Teruel,44264,Villel,2,8,-6
2010,Teruel,44265,Vinaceite,1,6,-5
2010,Teruel,44266,Visiedo,1,1,0
2010,Teruel,44267,Vivel del Río Martín,0,2,-2
2009,Teruel,44001,Ababuj,0,3,-3
2009,Teruel,44002,Abejuela,0,3,-3
2009,Teruel,44004,Aguaviva,2,6,-4
2009,Teruel,44006,Alacón,1,6,-5
2009,Teruel,44007,Alba,1,6,-5
2009,Teruel,44008,Albalate del Arzobispo,13,30,-17
2009,Teruel,44009,Albarracín,9,22,-13
2009,Teruel,44010,Albentosa,3,1,2
2009,Teruel,44011,Alcaine,0,3,-3
2009,Teruel,44012,Alcalá de la Selva,3,7,-4
2009,Teruel,44013,Alcañiz,190,171,19
2009,Teruel,44014,Alcorisa,38,43,-5
2009,Teruel,44016,Alfambra,2,13,-11
2009,Teruel,44017,Aliaga,1,9,-8
2009,Teruel,44022,Alloza,4,4,0
2009,Teruel,44024,Anadón,0,1,-1
2009,Teruel,44025,Andorra,75,63,12
2009,Teruel,44026,Arcos de las Salinas,1,4,-3
2009,Teruel,44027,Arens de Lledó,0,3,-3
2009,Teruel,44028,Argente,0,2,-2
2009,Teruel,44029,Ariño,2,6,-4
2009,Teruel,44031,Azaila,0,10,-10
2009,Teruel,44035,Barrachina,0,2,-2
2009,Teruel,44034,Bañón,2,1,1
2009,Teruel,44037,Beceite,6,7,-1
2009,Teruel,44039,Bello,1,7,-6
2009,Teruel,44038,Belmonte de San José,0,2,-2
2009,Teruel,44040,Berge,1,6,-5
2009,Teruel,44041,Bezas,0,2,-2
2009,Teruel,44042,Blancas,1,0,1
2009,Teruel,44044,Bordón,1,1,0
2009,Teruel,44045,Bronchales,2,4,-2
2009,Teruel,44046,Bueña,0,4,-4
2009,Teruel,44047,Burbáguena,0,24,-24
2009,Teruel,44033,Báguena,1,7,-6
2009,Teruel,44049,Calaceite,11,13,-2
2009,Teruel,44050,Calamocha,44,48,-4
2009,Teruel,44051,Calanda,32,38,-6
2009,Teruel,44054,Camarena de la Sierra,2,3,-1
2009,Teruel,44055,Camarillas,3,0,3
2009,Teruel,44053,Camañas,0,2,-2
2009,Teruel,44056,Caminreal,4,8,-4
2009,Teruel,44059,Cantavieja,9,5,4
2009,Teruel,44064,Cascante del Río,1,2,-1
2009,Teruel,44065,Castejón de Tornos,1,1,0
2009,Teruel,44066,Castel de Cabra,1,2,-1
2009,Teruel,44070,Castellar (El),0,3,-3
2009,Teruel,44071,Castellote,4,11,-7
2009,Teruel,44067,Castelnou,1,2,-1
2009,Teruel,44068,Castelserás,8,15,-7
2009,Teruel,44060,Cañada de Benatanduz,0,2,-2
2009,Teruel,44061,Cañada de Verich (La),0,1,-1
2009,Teruel,44063,Cañizar del Olivar,1,0,1
2009,Teruel,44074,Cedrillas,3,10,-7
2009,Teruel,44075,Celadas,1,3,-2
2009,Teruel,44076,Cella,19,42,-23
2009,Teruel,44077,Cerollera (La),0,2,-2
2009,Teruel,44080,Codoñera (La),3,3,0
2009,Teruel,44084,Cortes de Aragón,0,1,-1
2009,Teruel,44086,Cretas,5,13,-8
2009,Teruel,44088,Cuba (La),0,4,-4
2009,Teruel,44089,Cubla,1,1,0
2009,Teruel,44090,Cucalón,0,3,-3
2009,Teruel,44092,Cuervo (El),1,1,0
2009,Teruel,44093,Cuevas de Almudén,2,1,1
2009,Teruel,44094,Cuevas Labradas,0,2,-2
2009,Teruel,44096,Ejulve,0,5,-5
2009,Teruel,44097,Escorihuela,1,5,-4
2009,Teruel,44099,Escucha,5,5,0
2009,Teruel,44100,Estercuel,3,5,-2
2009,Teruel,44101,Ferreruela de Huerva,0,2,-2
2009,Teruel,44103,Formiche Alto,0,0,0
2009,Teruel,44106,Fortanete,4,5,-1
2009,Teruel,44107,Foz-Calanda,3,6,-3
2009,Teruel,44108,Fresneda (La),3,5,-2
2009,Teruel,44109,Frías de Albarracín,0,4,-4
2009,Teruel,44111,Fuentes Calientes,1,3,-2
2009,Teruel,44112,Fuentes Claras,6,8,-2
2009,Teruel,44113,Fuentes de Rubielos,1,1,0
2009,Teruel,44114,Fuentespalda,0,1,-1
2009,Teruel,44105,Fórnoles,0,2,-2
2009,Teruel,44115,Galve,2,0,2
2009,Teruel,44116,Gargallo,1,3,-2
2009,Teruel,44117,Gea de Albarracín,1,4,-3
2009,Teruel,44118,Ginebrosa (La),3,2,1
2009,Teruel,44119,Griegos,0,4,-4
2009,Teruel,44120,Guadalaviar,0,6,-6
2009,Teruel,44121,Gúdar,1,0,1
2009,Teruel,44123,Hinojosa de Jarque,0,2,-2
2009,Teruel,44124,Hoz de la Vieja (La),1,1,0
2009,Teruel,44125,Huesa del Común,0,1,-1
2009,Teruel,44122,Híjar,15,28,-13
2009,Teruel,44126,Iglesuela del Cid (La),6,1,5
2009,Teruel,44127,Jabaloyas,0,1,-1
2009,Teruel,44128,Jarque de la Val,1,1,0
2009,Teruel,44129,Jatiel,1,1,0
2009,Teruel,44132,Lagueruela,0,1,-1
2009,Teruel,44133,Lanzuela,0,2,-2
2009,Teruel,44135,Libros,0,1,-1
2009,Teruel,44136,Lidón,0,2,-2
2009,Teruel,44137,Linares de Mora,2,2,0
2009,Teruel,44141,Lledó,0,5,-5
2009,Teruel,44138,Loscos,0,2,-2
2009,Teruel,44143,Manzanera,6,5,1
2009,Teruel,44144,Martín del Río,4,7,-3
2009,Teruel,44145,Mas de las Matas,8,22,-14
2009,Teruel,44146,Mata de los Olmos (La),3,4,-1
2009,Teruel,44147,Mazaleón,2,6,-4
2009,Teruel,44148,Mezquita de Jarque,1,3,-2
2009,Teruel,44149,Mirambel,0,3,-3
2009,Teruel,44150,Miravete de la Sierra,0,2,-2
2009,Teruel,44151,Molinos,1,10,-9
2009,Teruel,44152,Monforte de Moyuela,0,1,-1
2009,Teruel,44153,Monreal del Campo,39,37,2
2009,Teruel,44154,Monroyo,2,6,-4
2009,Teruel,44155,Montalbán,8,16,-8
2009,Teruel,44156,Monteagudo del Castillo,1,2,-1
2009,Teruel,44157,Monterde de Albarracín,0,1,-1
2009,Teruel,44158,Mora de Rubielos,19,22,-3
2009,Teruel,44159,Moscardón,1,0,1
2009,Teruel,44160,Mosqueruela,3,10,-7
2009,Teruel,44161,Muniesa,5,5,0
2009,Teruel,44163,Noguera de Albarracín,0,3,-3
2009,Teruel,44165,Nogueruelas,3,4,-1
2009,Teruel,44168,Odón,1,4,-3
2009,Teruel,44169,Ojos Negros,5,5,0
2009,Teruel,44171,Olba,3,3,0
2009,Teruel,44172,Oliete,2,7,-5
2009,Teruel,44173,Olmos (Los),0,2,-2
2009,Teruel,44174,Orihuela del Tremedal,3,3,0
2009,Teruel,44175,Orrios,0,3,-3
2009,Teruel,44176,Palomar de Arroyos,0,3,-3
2009,Teruel,44177,Pancrudo,0,4,-4
2009,Teruel,44178,Parras de Castellote (Las),0,4,-4
2009,Teruel,44180,Peracense,0,3,-3
2009,Teruel,44181,Peralejos,0,1,-1
2009,Teruel,44182,Perales del Alfambra,1,6,-5
2009,Teruel,44179,Peñarroya de Tastavins,4,8,-4
2009,Teruel,44183,Pitarque,0,1,-1
2009,Teruel,44185,Pobo (El),0,2,-2
2009,Teruel,44187,Portellada (La),2,7,-5
2009,Teruel,44189,Pozondón,0,1,-1
2009,Teruel,44190,Pozuel del Campo,0,2,-2
2009,Teruel,44191,Puebla de Híjar (La),8,12,-4
2009,Teruel,44192,Puebla de Valverde (La),4,3,1
2009,Teruel,44193,Puertomingalvo,0,3,-3
2009,Teruel,44195,Rillo,1,1,0
2009,Teruel,44196,Riodeva,1,4,-3
2009,Teruel,44198,Royuela,3,4,-1
2009,Teruel,44201,Rubielos de Mora,5,13,-8
2009,Teruel,44194,Ráfales,0,4,-4
2009,Teruel,44205,Samper de Calanda,6,14,-8
2009,Teruel,44206,San Agustín,0,2,-2
2009,Teruel,44207,San Martín del Río,1,7,-6
2009,Teruel,44209,Santa Eulalia,6,17,-11
2009,Teruel,44210,Sarrión,14,13,1
2009,Teruel,44211,Segura de los Baños,0,1,-1
2009,Teruel,44213,Singra,2,1,1
2009,Teruel,44215,Terriente,0,3,-3
2009,Teruel,44216,Teruel,387,310,77
2009,Teruel,44218,Tormón,0,2,-2
2009,Teruel,44219,Tornos,0,2,-2
2009,Teruel,44220,Torralba de los Sisones,0,5,-5
2009,Teruel,44223,Torre de Arcas,1,2,-1
2009,Teruel,44224,Torre de las Arcas,0,1,-1
2009,Teruel,44225,Torre del Compte,0,4,-4
2009,Teruel,44227,Torre los Negros,0,2,-2
2009,Teruel,44221,Torrecilla de Alcañiz,0,2,-2
2009,Teruel,44222,Torrecilla del Rebollar,0,1,-1
2009,Teruel,44226,Torrelacárcel,1,6,-5
2009,Teruel,44228,Torremocha de Jiloca,0,3,-3
2009,Teruel,44229,Torres de Albarracín,0,2,-2
2009,Teruel,44230,Torrevelilla,3,3,0
2009,Teruel,44231,Torrijas,1,2,-1
2009,Teruel,44232,Torrijo del Campo,4,9,-5
2009,Teruel,44234,Tramacastiel,0,6,-6
2009,Teruel,44236,Tronchón,1,1,0
2009,Teruel,44237,Urrea de Gaén,2,8,-6
2009,Teruel,44238,Utrillas,33,34,-1
2009,Teruel,44240,Valbona,0,2,-2
2009,Teruel,44241,Valdealgorfa,2,13,-11
2009,Teruel,44244,Valdelinares,0,3,-3
2009,Teruel,44245,Valdeltormo,2,9,-7
2009,Teruel,44246,Valderrobres,24,28,-4
2009,Teruel,44247,Valjunquera,3,7,-4
2009,Teruel,44249,Vallecillo (El),0,1,-1
2009,Teruel,44251,Villafranca del Campo,3,3,0
2009,Teruel,44252,Villahermosa del Campo,0,1,-1
2009,Teruel,44256,Villanueva del Rebollar de la Sierra,2,1,1
2009,Teruel,44257,Villar del Cobo,1,4,-3
2009,Teruel,44260,Villarluengo,0,3,-3
2009,Teruel,44261,Villarquemado,3,23,-20
2009,Teruel,44262,Villarroya de los Pinares,0,3,-3
2009,Teruel,44263,Villastar,11,9,2
2009,Teruel,44264,Villel,5,5,0
2009,Teruel,44265,Vinaceite,0,1,-1
2009,Teruel,44266,Visiedo,0,2,-2
2008,Teruel,44001,Ababuj,0,1,-1
2008,Teruel,44002,Abejuela,0,3,-3
2008,Teruel,44003,Aguatón,0,0,0
2008,Teruel,44004,Aguaviva,4,6,-2
2008,Teruel,44006,Alacón,2,3,-1
2008,Teruel,44007,Alba,0,4,-4
2008,Teruel,44008,Albalate del Arzobispo,16,26,-10
2008,Teruel,44009,Albarracín,12,15,-3
2008,Teruel,44010,Albentosa,6,1,5
2008,Teruel,44011,Alcaine,1,0,1
2008,Teruel,44012,Alcalá de la Selva,3,3,0
2008,Teruel,44013,Alcañiz,192,139,53
2008,Teruel,44014,Alcorisa,55,34,21
2008,Teruel,44016,Alfambra,4,20,-16
2008,Teruel,44017,Aliaga,2,11,-9
2008,Teruel,44021,Allepuz,0,2,-2
2008,Teruel,44022,Alloza,6,10,-4
2008,Teruel,44023,Allueva,1,0,1
2008,Teruel,44019,Alobras,0,1,-1
2008,Teruel,44020,Alpeñés,0,1,-1
2008,Teruel,44024,Anadón,0,1,-1
2008,Teruel,44025,Andorra,77,76,1
2008,Teruel,44026,Arcos de las Salinas,0,1,-1
2008,Teruel,44027,Arens de Lledó,0,3,-3
2008,Teruel,44028,Argente,0,4,-4
2008,Teruel,44029,Ariño,2,10,-8
2008,Teruel,44031,Azaila,0,1,-1
2008,Teruel,44035,Barrachina,0,1,-1
2008,Teruel,44034,Bañón,0,1,-1
2008,Teruel,44037,Beceite,8,10,-2
2008,Teruel,44039,Bello,2,8,-6
2008,Teruel,44038,Belmonte de San José,2,1,1
2008,Teruel,44040,Berge,1,6,-5
2008,Teruel,44041,Bezas,0,1,-1
2008,Teruel,44042,Blancas,1,2,-1
2008,Teruel,44043,Blesa,0,4,-4
2008,Teruel,44044,Bordón,0,1,-1
2008,Teruel,44045,Bronchales,2,6,-4
2008,Teruel,44046,Bueña,0,1,-1
2008,Teruel,44047,Burbáguena,0,14,-14
2008,Teruel,44033,Báguena,1,9,-8
2008,Teruel,44048,Cabra de Mora,0,3,-3
2008,Teruel,44049,Calaceite,2,16,-14
2008,Teruel,44050,Calamocha,49,48,1
2008,Teruel,44051,Calanda,30,44,-14
2008,Teruel,44052,Calomarde,0,1,-1
2008,Teruel,44054,Camarena de la Sierra,2,2,0
2008,Teruel,44055,Camarillas,1,0,1
2008,Teruel,44053,Camañas,1,2,-1
2008,Teruel,44056,Caminreal,5,12,-7
2008,Teruel,44059,Cantavieja,7,9,-2
2008,Teruel,44064,Cascante del Río,0,1,-1
2008,Teruel,44065,Castejón de Tornos,0,1,-1
2008,Teruel,44066,Castel de Cabra,1,1,0
2008,Teruel,44070,Castellar (El),0,1,-1
2008,Teruel,44071,Castellote,6,8,-2
2008,Teruel,44067,Castelnou,0,1,-1
2008,Teruel,44068,Castelserás,5,8,-3
2008,Teruel,44061,Cañada de Verich (La),0,1,-1
2008,Teruel,44063,Cañizar del Olivar,0,1,-1
2008,Teruel,44074,Cedrillas,4,15,-11
2008,Teruel,44075,Celadas,3,6,-3
2008,Teruel,44076,Cella,18,32,-14
2008,Teruel,44080,Codoñera (La),6,3,3
2008,Teruel,44082,Corbalán,0,3,-3
2008,Teruel,44084,Cortes de Aragón,0,2,-2
2008,Teruel,44085,Cosa,0,2,-2
2008,Teruel,44086,Cretas,7,9,-2
2008,Teruel,44088,Cuba (La),2,2,0
2008,Teruel,44089,Cubla,0,2,-2
2008,Teruel,44090,Cucalón,1,0,1
2008,Teruel,44092,Cuervo (El),0,1,-1
2008,Teruel,44093,Cuevas de Almudén,1,0,1
2008,Teruel,44094,Cuevas Labradas,1,4,-3
2008,Teruel,44096,Ejulve,3,5,-2
2008,Teruel,44099,Escucha,6,10,-4
2008,Teruel,44100,Estercuel,0,2,-2
2008,Teruel,44101,Ferreruela de Huerva,1,1,0
2008,Teruel,44103,Formiche Alto,1,4,-3
2008,Teruel,44106,Fortanete,3,0,3
2008,Teruel,44107,Foz-Calanda,1,5,-4
2008,Teruel,44108,Fresneda (La),4,8,-4
2008,Teruel,44109,Frías de Albarracín,1,2,-1
2008,Teruel,44111,Fuentes Calientes,1,1,0
2008,Teruel,44112,Fuentes Claras,3,7,-4
2008,Teruel,44113,Fuentes de Rubielos,1,1,0
2008,Teruel,44114,Fuentespalda,0,8,-8
2008,Teruel,44105,Fórnoles,0,2,-2
2008,Teruel,44115,Galve,4,0,4
2008,Teruel,44116,Gargallo,0,1,-1
2008,Teruel,44117,Gea de Albarracín,3,5,-2
2008,Teruel,44118,Ginebrosa (La),1,1,0
2008,Teruel,44119,Griegos,0,2,-2
2008,Teruel,44120,Guadalaviar,2,6,-4
2008,Teruel,44121,Gúdar,0,2,-2
2008,Teruel,44123,Hinojosa de Jarque,0,4,-4
2008,Teruel,44124,Hoz de la Vieja (La),0,1,-1
2008,Teruel,44125,Huesa del Común,0,1,-1
2008,Teruel,44122,Híjar,18,35,-17
2008,Teruel,44126,Iglesuela del Cid (La),5,7,-2
2008,Teruel,44128,Jarque de la Val,0,0,0
2008,Teruel,44129,Jatiel,1,2,-1
2008,Teruel,44130,Jorcas,0,1,-1
2008,Teruel,44131,Josa,0,1,-1
2008,Teruel,44132,Lagueruela,0,1,-1
2008,Teruel,44133,Lanzuela,0,1,-1
2008,Teruel,44135,Libros,0,2,-2
2008,Teruel,44136,Lidón,0,1,-1
2008,Teruel,44137,Linares de Mora,1,5,-4
2008,Teruel,44141,Lledó,1,1,0
2008,Teruel,44138,Loscos,1,7,-6
2008,Teruel,44142,Maicas,0,1,-1
2008,Teruel,44143,Manzanera,2,4,-2
2008,Teruel,44144,Martín del Río,2,6,-4
2008,Teruel,44145,Mas de las Matas,8,16,-8
2008,Teruel,44146,Mata de los Olmos (La),2,3,-1
2008,Teruel,44147,Mazaleón,8,9,-1
2008,Teruel,44148,Mezquita de Jarque,0,1,-1
2008,Teruel,44149,Mirambel,3,2,1
2008,Teruel,44150,Miravete de la Sierra,0,1,-1
2008,Teruel,44151,Molinos,0,4,-4
2008,Teruel,44152,Monforte de Moyuela,0,2,-2
2008,Teruel,44153,Monreal del Campo,26,39,-13
2008,Teruel,44154,Monroyo,6,8,-2
2008,Teruel,44155,Montalbán,13,18,-5
2008,Teruel,44156,Monteagudo del Castillo,1,2,-1
2008,Teruel,44158,Mora de Rubielos,23,15,8
2008,Teruel,44159,Moscardón,5,0,5
2008,Teruel,44160,Mosqueruela,1,9,-8
2008,Teruel,44161,Muniesa,6,12,-6
2008,Teruel,44163,Noguera de Albarracín,0,1,-1
2008,Teruel,44164,Nogueras,0,0,0
2008,Teruel,44165,Nogueruelas,0,3,-3
2008,Teruel,44167,Obón,0,1,-1
2008,Teruel,44168,Odón,1,5,-4
2008,Teruel,44169,Ojos Negros,2,9,-7
2008,Teruel,44171,Olba,4,1,3
2008,Teruel,44172,Oliete,1,12,-11
2008,Teruel,44173,Olmos (Los),0,1,-1
2008,Teruel,44174,Orihuela del Tremedal,3,9,-6
2008,Teruel,44175,Orrios,0,4,-4
2008,Teruel,44176,Palomar de Arroyos,1,2,-1
2008,Teruel,44177,Pancrudo,1,3,-2
2008,Teruel,44178,Parras de Castellote (Las),0,2,-2
2008,Teruel,44180,Peracense,0,2,-2
2008,Teruel,44181,Peralejos,0,2,-2
2008,Teruel,44182,Perales del Alfambra,0,6,-6
2008,Teruel,44179,Peñarroya de Tastavins,6,7,-1
2008,Teruel,44183,Pitarque,0,1,-1
2008,Teruel,44184,Plou,0,1,-1
2008,Teruel,44185,Pobo (El),1,5,-4
2008,Teruel,44187,Portellada (La),1,3,-2
2008,Teruel,44190,Pozuel del Campo,0,1,-1
2008,Teruel,44191,Puebla de Híjar (La),13,8,5
2008,Teruel,44192,Puebla de Valverde (La),5,4,1
2008,Teruel,44193,Puertomingalvo,3,1,2
2008,Teruel,44195,Rillo,0,2,-2
2008,Teruel,44196,Riodeva,0,3,-3
2008,Teruel,44198,Royuela,2,1,1
2008,Teruel,44200,Rubielos de la Cérida,0,3,-3
2008,Teruel,44201,Rubielos de Mora,4,7,-3
2008,Teruel,44194,Ráfales,2,4,-2
2008,Teruel,44204,Saldón,0,2,-2
2008,Teruel,44205,Samper de Calanda,3,13,-10
2008,Teruel,44206,San Agustín,0,3,-3
2008,Teruel,44207,San Martín del Río,0,5,-5
2008,Teruel,44208,Santa Cruz de Nogueras,0,1,-1
2008,Teruel,44209,Santa Eulalia,4,15,-11
2008,Teruel,44210,Sarrión,8,7,1
2008,Teruel,44212,Seno,1,0,1
2008,Teruel,44215,Terriente,3,3,0
2008,Teruel,44216,Teruel,362,327,35
2008,Teruel,44218,Tormón,0,1,-1
2008,Teruel,44219,Tornos,1,3,-2
2008,Teruel,44220,Torralba de los Sisones,1,0,1
2008,Teruel,44223,Torre de Arcas,1,0,1
2008,Teruel,44224,Torre de las Arcas,1,1,0
2008,Teruel,44225,Torre del Compte,0,3,-3
2008,Teruel,44227,Torre los Negros,0,1,-1
2008,Teruel,44221,Torrecilla de Alcañiz,0,1,-1
2008,Teruel,44222,Torrecilla del Rebollar,0,3,-3
2008,Teruel,44226,Torrelacárcel,1,4,-3
2008,Teruel,44228,Torremocha de Jiloca,1,2,-1
2008,Teruel,44229,Torres de Albarracín,0,2,-2
2008,Teruel,44230,Torrevelilla,0,3,-3
2008,Teruel,44231,Torrijas,0,1,-1
2008,Teruel,44232,Torrijo del Campo,3,16,-13
2008,Teruel,44234,Tramacastiel,0,1,-1
2008,Teruel,44235,Tramacastilla,0,4,-4
2008,Teruel,44236,Tronchón,2,0,2
2008,Teruel,44237,Urrea de Gaén,2,8,-6
2008,Teruel,44238,Utrillas,36,22,14
2008,Teruel,44239,Valacloche,0,1,-1
2008,Teruel,44240,Valbona,0,4,-4
2008,Teruel,44241,Valdealgorfa,3,7,-4
2008,Teruel,44244,Valdelinares,1,2,-1
2008,Teruel,44245,Valdeltormo,1,8,-7
2008,Teruel,44246,Valderrobres,15,34,-19
2008,Teruel,44247,Valjunquera,1,1,0
2008,Teruel,44249,Vallecillo (El),0,1,-1
2008,Teruel,44250,Veguillas de la Sierra,0,1,-1
2008,Teruel,44251,Villafranca del Campo,2,10,-8
2008,Teruel,44256,Villanueva del Rebollar de la Sierra,0,1,-1
2008,Teruel,44257,Villar del Cobo,0,3,-3
2008,Teruel,44258,Villar del Salz,0,2,-2
2008,Teruel,44260,Villarluengo,0,2,-2
2008,Teruel,44261,Villarquemado,8,12,-4
2008,Teruel,44262,Villarroya de los Pinares,2,2,0
2008,Teruel,44263,Villastar,4,7,-3
2008,Teruel,44264,Villel,5,4,1
2008,Teruel,44265,Vinaceite,0,2,-2
2008,Teruel,44266,Visiedo,0,6,-6
2007,Teruel,44004,Aguaviva,7,7,0
2007,Teruel,44006,Alacón,2,2,0
2007,Teruel,44007,Alba,3,5,-2
2007,Teruel,44008,Albalate del Arzobispo,18,32,-14
2007,Teruel,44009,Albarracín,7,15,-8
2007,Teruel,44010,Albentosa,2,3,-1
2007,Teruel,44011,Alcaine,1,0,1
2007,Teruel,44012,Alcalá de la Selva,0,5,-5
2007,Teruel,44013,Alcañiz,224,142,82
2007,Teruel,44014,Alcorisa,35,38,-3
2007,Teruel,44016,Alfambra,2,13,-11
2007,Teruel,44017,Aliaga,3,6,-3
2007,Teruel,44021,Allepuz,2,2,0
2007,Teruel,44022,Alloza,4,14,-10
2007,Teruel,44018,Almohaja,0,1,-1
2007,Teruel,44019,Alobras,0,2,-2
2007,Teruel,44024,Anadón,0,1,-1
2007,Teruel,44025,Andorra,61,66,-5
2007,Teruel,44026,Arcos de las Salinas,0,3,-3
2007,Teruel,44027,Arens de Lledó,0,4,-4
2007,Teruel,44028,Argente,0,4,-4
2007,Teruel,44029,Ariño,6,12,-6
2007,Teruel,44031,Azaila,0,7,-7
2007,Teruel,44035,Barrachina,3,2,1
2007,Teruel,44037,Beceite,4,10,-6
2007,Teruel,44039,Bello,0,8,-8
2007,Teruel,44038,Belmonte de San José,0,0,0
2007,Teruel,44040,Berge,4,3,1
2007,Teruel,44041,Bezas,1,1,0
2007,Teruel,44042,Blancas,0,3,-3
2007,Teruel,44043,Blesa,0,2,-2
2007,Teruel,44044,Bordón,0,2,-2
2007,Teruel,44045,Bronchales,2,7,-5
2007,Teruel,44046,Bueña,0,2,-2
2007,Teruel,44047,Burbáguena,0,19,-19
2007,Teruel,44033,Báguena,0,7,-7
2007,Teruel,44048,Cabra de Mora,0,2,-2
2007,Teruel,44049,Calaceite,6,16,-10
2007,Teruel,44050,Calamocha,45,49,-4
2007,Teruel,44051,Calanda,32,35,-3
2007,Teruel,44054,Camarena de la Sierra,1,0,1
2007,Teruel,44053,Camañas,1,2,-1
2007,Teruel,44056,Caminreal,3,12,-9
2007,Teruel,44059,Cantavieja,5,8,-3
2007,Teruel,44064,Cascante del Río,0,2,-2
2007,Teruel,44065,Castejón de Tornos,0,1,-1
2007,Teruel,44066,Castel de Cabra,1,2,-1
2007,Teruel,44070,Castellar (El),0,2,-2
2007,Teruel,44071,Castellote,9,19,-10
2007,Teruel,44067,Castelnou,1,1,0
2007,Teruel,44068,Castelserás,5,13,-8
2007,Teruel,44061,Cañada de Verich (La),0,2,-2
2007,Teruel,44062,Cañada Vellida,0,1,-1
2007,Teruel,44063,Cañizar del Olivar,0,1,-1
2007,Teruel,44074,Cedrillas,8,9,-1
2007,Teruel,44075,Celadas,1,3,-2
2007,Teruel,44076,Cella,28,32,-4
2007,Teruel,44077,Cerollera (La),0,3,-3
2007,Teruel,44080,Codoñera (La),4,3,1
2007,Teruel,44082,Corbalán,0,3,-3
2007,Teruel,44084,Cortes de Aragón,2,0,2
2007,Teruel,44085,Cosa,0,3,-3
2007,Teruel,44086,Cretas,8,9,-1
2007,Teruel,44087,Crivillén,0,6,-6
2007,Teruel,44088,Cuba (La),1,0,1
2007,Teruel,44089,Cubla,0,1,-1
2007,Teruel,44090,Cucalón,0,2,-2
2007,Teruel,44093,Cuevas de Almudén,0,1,-1
2007,Teruel,44094,Cuevas Labradas,0,3,-3
2007,Teruel,44096,Ejulve,1,2,-1
2007,Teruel,44097,Escorihuela,1,4,-3
2007,Teruel,44099,Escucha,9,9,0
2007,Teruel,44100,Estercuel,1,2,-1
2007,Teruel,44101,Ferreruela de Huerva,0,1,-1
2007,Teruel,44103,Formiche Alto,0,1,-1
2007,Teruel,44106,Fortanete,7,0,7
2007,Teruel,44107,Foz-Calanda,2,3,-1
2007,Teruel,44108,Fresneda (La),4,5,-1
2007,Teruel,44109,Frías de Albarracín,1,0,1
2007,Teruel,44112,Fuentes Claras,1,13,-12
2007,Teruel,44113,Fuentes de Rubielos,1,1,0
2007,Teruel,44114,Fuentespalda,3,3,0
2007,Teruel,44105,Fórnoles,0,3,-3
2007,Teruel,44115,Galve,0,0,0
2007,Teruel,44116,Gargallo,1,0,1
2007,Teruel,44117,Gea de Albarracín,4,10,-6
2007,Teruel,44118,Ginebrosa (La),1,1,0
2007,Teruel,44119,Griegos,1,1,0
2007,Teruel,44120,Guadalaviar,2,3,-1
2007,Teruel,44121,Gúdar,2,1,1
2007,Teruel,44123,Hinojosa de Jarque,1,1,0
2007,Teruel,44124,Hoz de la Vieja (La),0,2,-2
2007,Teruel,44125,Huesa del Común,1,2,-1
2007,Teruel,44122,Híjar,11,30,-19
2007,Teruel,44126,Iglesuela del Cid (La),3,4,-1
2007,Teruel,44127,Jabaloyas,1,2,-1
2007,Teruel,44128,Jarque de la Val,1,1,0
2007,Teruel,44129,Jatiel,1,3,-2
2007,Teruel,44130,Jorcas,0,2,-2
2007,Teruel,44135,Libros,0,2,-2
2007,Teruel,44136,Lidón,0,2,-2
2007,Teruel,44137,Linares de Mora,0,3,-3
2007,Teruel,44141,Lledó,0,2,-2
2007,Teruel,44138,Loscos,0,2,-2
2007,Teruel,44143,Manzanera,5,11,-6
2007,Teruel,44144,Martín del Río,4,6,-2
2007,Teruel,44145,Mas de las Matas,5,27,-22
2007,Teruel,44146,Mata de los Olmos (La),4,3,1
2007,Teruel,44147,Mazaleón,2,10,-8
2007,Teruel,44148,Mezquita de Jarque,0,2,-2
2007,Teruel,44149,Mirambel,2,3,-1
2007,Teruel,44150,Miravete de la Sierra,0,2,-2
2007,Teruel,44151,Molinos,1,9,-8
2007,Teruel,44153,Monreal del Campo,29,39,-10
2007,Teruel,44154,Monroyo,2,4,-2
2007,Teruel,44155,Montalbán,5,12,-7
2007,Teruel,44157,Monterde de Albarracín,0,3,-3
2007,Teruel,44158,Mora de Rubielos,12,18,-6
2007,Teruel,44160,Mosqueruela,2,11,-9
2007,Teruel,44161,Muniesa,5,18,-13
2007,Teruel,44163,Noguera de Albarracín,1,2,-1
2007,Teruel,44165,Nogueruelas,3,6,-3
2007,Teruel,44168,Odón,0,4,-4
2007,Teruel,44169,Ojos Negros,2,7,-5
2007,Teruel,44171,Olba,1,1,0
2007,Teruel,44172,Oliete,3,6,-3
2007,Teruel,44173,Olmos (Los),0,1,-1
2007,Teruel,44174,Orihuela del Tremedal,2,7,-5
2007,Teruel,44175,Orrios,1,2,-1
2007,Teruel,44176,Palomar de Arroyos,1,1,0
2007,Teruel,44177,Pancrudo,1,4,-3
2007,Teruel,44178,Parras de Castellote (Las),0,2,-2
2007,Teruel,44180,Peracense,0,2,-2
2007,Teruel,44181,Peralejos,0,1,-1
2007,Teruel,44182,Perales del Alfambra,2,4,-2
2007,Teruel,44179,Peñarroya de Tastavins,5,9,-4
2007,Teruel,44183,Pitarque,0,2,-2
2007,Teruel,44184,Plou,0,2,-2
2007,Teruel,44185,Pobo (El),0,2,-2
2007,Teruel,44187,Portellada (La),1,5,-4
2007,Teruel,44189,Pozondón,0,3,-3
2007,Teruel,44190,Pozuel del Campo,0,1,-1
2007,Teruel,44191,Puebla de Híjar (La),5,9,-4
2007,Teruel,44192,Puebla de Valverde (La),3,10,-7
2007,Teruel,44193,Puertomingalvo,3,3,0
2007,Teruel,44196,Riodeva,0,3,-3
2007,Teruel,44198,Royuela,1,4,-3
2007,Teruel,44199,Rubiales,0,3,-3
2007,Teruel,44200,Rubielos de la Cérida,0,3,-3
2007,Teruel,44201,Rubielos de Mora,3,6,-3
2007,Teruel,44194,Ráfales,2,2,0
2007,Teruel,44197,Ródenas,0,1,-1
2007,Teruel,44204,Saldón,1,0,1
2007,Teruel,44205,Samper de Calanda,2,17,-15
2007,Teruel,44206,San Agustín,1,3,-2
2007,Teruel,44207,San Martín del Río,0,6,-6
2007,Teruel,44209,Santa Eulalia,13,19,-6
2007,Teruel,44210,Sarrión,5,15,-10
2007,Teruel,44211,Segura de los Baños,0,1,-1
2007,Teruel,44213,Singra,0,1,-1
2007,Teruel,44215,Terriente,2,7,-5
2007,Teruel,44216,Teruel,381,284,97
2007,Teruel,44217,Toril y Masegoso,0,1,-1
2007,Teruel,44218,Tormón,0,1,-1
2007,Teruel,44219,Tornos,0,7,-7
2007,Teruel,44220,Torralba de los Sisones,0,1,-1
2007,Teruel,44223,Torre de Arcas,1,2,-1
2007,Teruel,44224,Torre de las Arcas,0,1,-1
2007,Teruel,44225,Torre del Compte,0,3,-3
2007,Teruel,44227,Torre los Negros,0,2,-2
2007,Teruel,44221,Torrecilla de Alcañiz,0,8,-8
2007,Teruel,44222,Torrecilla del Rebollar,1,2,-1
2007,Teruel,44226,Torrelacárcel,0,3,-3
2007,Teruel,44228,Torremocha de Jiloca,0,4,-4
2007,Teruel,44229,Torres de Albarracín,1,1,0
2007,Teruel,44230,Torrevelilla,2,8,-6
2007,Teruel,44231,Torrijas,0,1,-1
2007,Teruel,44232,Torrijo del Campo,5,9,-4
2007,Teruel,44235,Tramacastilla,1,3,-2
2007,Teruel,44236,Tronchón,2,0,2
2007,Teruel,44237,Urrea de Gaén,3,5,-2
2007,Teruel,44238,Utrillas,23,32,-9
2007,Teruel,44239,Valacloche,0,1,-1
2007,Teruel,44240,Valbona,1,5,-4
2007,Teruel,44241,Valdealgorfa,1,9,-8
2007,Teruel,44244,Valdelinares,0,2,-2
2007,Teruel,44245,Valdeltormo,2,5,-3
2007,Teruel,44246,Valderrobres,26,30,-4
2007,Teruel,44247,Valjunquera,3,7,-4
2007,Teruel,44249,Vallecillo (El),0,1,-1
2007,Teruel,44251,Villafranca del Campo,6,6,0
2007,Teruel,44252,Villahermosa del Campo,2,2,0
2007,Teruel,44257,Villar del Cobo,2,2,0
2007,Teruel,44258,Villar del Salz,0,1,-1
2007,Teruel,44260,Villarluengo,0,7,-7
2007,Teruel,44261,Villarquemado,4,17,-13
2007,Teruel,44262,Villarroya de los Pinares,1,3,-2
2007,Teruel,44263,Villastar,5,11,-6
2007,Teruel,44264,Villel,3,9,-6
2007,Teruel,44265,Vinaceite,0,5,-5
2007,Teruel,44266,Visiedo,0,5,-5
2007,Teruel,44267,Vivel del Río Martín,1,2,-1
2006,Teruel,44001,Ababuj,0,1,-1
2006,Teruel,44002,Abejuela,0,1,-1
2006,Teruel,44004,Aguaviva,3,5,-2
2006,Teruel,44005,Aguilar del Alfambra,0,1,-1
2006,Teruel,44006,Alacón,3,6,-3
2006,Teruel,44007,Alba,0,2,-2
2006,Teruel,44008,Albalate del Arzobispo,7,32,-25
2006,Teruel,44009,Albarracín,5,16,-11
2006,Teruel,44010,Albentosa,5,3,2
2006,Teruel,44012,Alcalá de la Selva,5,5,0
2006,Teruel,44013,Alcañiz,203,169,34
2006,Teruel,44014,Alcorisa,36,43,-7
2006,Teruel,44016,Alfambra,3,12,-9
2006,Teruel,44017,Aliaga,3,9,-6
2006,Teruel,44021,Allepuz,0,3,-3
2006,Teruel,44022,Alloza,4,10,-6
2006,Teruel,44023,Allueva,0,1,-1
2006,Teruel,44018,Almohaja,0,1,-1
2006,Teruel,44019,Alobras,0,2,-2
2006,Teruel,44025,Andorra,67,63,4
2006,Teruel,44026,Arcos de las Salinas,1,2,-1
2006,Teruel,44027,Arens de Lledó,0,4,-4
2006,Teruel,44028,Argente,0,3,-3
2006,Teruel,44029,Ariño,4,5,-1
2006,Teruel,44031,Azaila,1,5,-4
2006,Teruel,44035,Barrachina,0,3,-3
2006,Teruel,44034,Bañón,2,3,-1
2006,Teruel,44037,Beceite,3,10,-7
2006,Teruel,44039,Bello,0,7,-7
2006,Teruel,44038,Belmonte de San José,0,3,-3
2006,Teruel,44040,Berge,1,3,-2
2006,Teruel,44041,Bezas,0,1,-1
2006,Teruel,44042,Blancas,0,2,-2
2006,Teruel,44044,Bordón,0,4,-4
2006,Teruel,44045,Bronchales,1,6,-5
2006,Teruel,44046,Bueña,0,1,-1
2006,Teruel,44047,Burbáguena,0,12,-12
2006,Teruel,44033,Báguena,1,7,-6
2006,Teruel,44048,Cabra de Mora,0,1,-1
2006,Teruel,44049,Calaceite,5,19,-14
2006,Teruel,44050,Calamocha,38,48,-10
2006,Teruel,44051,Calanda,24,59,-35
2006,Teruel,44052,Calomarde,0,1,-1
2006,Teruel,44054,Camarena de la Sierra,0,2,-2
2006,Teruel,44055,Camarillas,1,1,0
2006,Teruel,44053,Camañas,0,1,-1
2006,Teruel,44056,Caminreal,2,11,-9
2006,Teruel,44059,Cantavieja,4,5,-1
2006,Teruel,44064,Cascante del Río,0,1,-1
2006,Teruel,44065,Castejón de Tornos,0,1,-1
2006,Teruel,44066,Castel de Cabra,0,4,-4
2006,Teruel,44071,Castellote,5,12,-7
2006,Teruel,44067,Castelnou,0,3,-3
2006,Teruel,44068,Castelserás,11,14,-3
2006,Teruel,44060,Cañada de Benatanduz,0,2,-2
2006,Teruel,44061,Cañada de Verich (La),0,1,-1
2006,Teruel,44062,Cañada Vellida,0,2,-2
2006,Teruel,44063,Cañizar del Olivar,0,1,-1
2006,Teruel,44074,Cedrillas,4,12,-8
2006,Teruel,44075,Celadas,2,8,-6
2006,Teruel,44076,Cella,24,28,-4
2006,Teruel,44077,Cerollera (La),1,2,-1
2006,Teruel,44080,Codoñera (La),1,3,-2
2006,Teruel,44082,Corbalán,0,0,0
2006,Teruel,44086,Cretas,5,10,-5
2006,Teruel,44087,Crivillén,0,4,-4
2006,Teruel,44088,Cuba (La),0,0,0
2006,Teruel,44090,Cucalón,2,0,2
2006,Teruel,44092,Cuervo (El),1,3,-2
2006,Teruel,44093,Cuevas de Almudén,2,1,1
2006,Teruel,44094,Cuevas Labradas,0,1,-1
2006,Teruel,44096,Ejulve,0,2,-2
2006,Teruel,44097,Escorihuela,0,4,-4
2006,Teruel,44099,Escucha,10,8,2
2006,Teruel,44100,Estercuel,0,5,-5
2006,Teruel,44101,Ferreruela de Huerva,0,2,-2
2006,Teruel,44103,Formiche Alto,1,1,0
2006,Teruel,44106,Fortanete,0,7,-7
2006,Teruel,44107,Foz-Calanda,0,3,-3
2006,Teruel,44108,Fresneda (La),3,4,-1
2006,Teruel,44109,Frías de Albarracín,0,1,-1
2006,Teruel,44110,Fuenferrada,0,1,-1
2006,Teruel,44111,Fuentes Calientes,0,1,-1
2006,Teruel,44112,Fuentes Claras,8,9,-1
2006,Teruel,44113,Fuentes de Rubielos,2,0,2
2006,Teruel,44114,Fuentespalda,2,4,-2
2006,Teruel,44105,Fórnoles,1,2,-1
2006,Teruel,44115,Galve,1,2,-1
2006,Teruel,44116,Gargallo,0,1,-1
2006,Teruel,44117,Gea de Albarracín,0,6,-6
2006,Teruel,44118,Ginebrosa (La),2,2,0
2006,Teruel,44119,Griegos,0,1,-1
2006,Teruel,44120,Guadalaviar,1,3,-2
2006,Teruel,44121,Gúdar,0,0,0
2006,Teruel,44123,Hinojosa de Jarque,0,3,-3
2006,Teruel,44124,Hoz de la Vieja (La),1,3,-2
2006,Teruel,44125,Huesa del Común,0,1,-1
2006,Teruel,44122,Híjar,19,22,-3
2006,Teruel,44126,Iglesuela del Cid (La),4,10,-6
2006,Teruel,44127,Jabaloyas,0,3,-3
2006,Teruel,44128,Jarque de la Val,0,2,-2
2006,Teruel,44129,Jatiel,0,2,-2
2006,Teruel,44131,Josa,1,1,0
2006,Teruel,44133,Lanzuela,0,2,-2
2006,Teruel,44135,Libros,0,2,-2
2006,Teruel,44136,Lidón,0,2,-2
2006,Teruel,44137,Linares de Mora,4,2,2
2006,Teruel,44141,Lledó,0,4,-4
2006,Teruel,44142,Maicas,0,1,-1
2006,Teruel,44143,Manzanera,6,7,-1
2006,Teruel,44144,Martín del Río,1,7,-6
2006,Teruel,44145,Mas de las Matas,10,17,-7
2006,Teruel,44146,Mata de los Olmos (La),0,1,-1
2006,Teruel,44147,Mazaleón,2,9,-7
2006,Teruel,44148,Mezquita de Jarque,1,3,-2
2006,Teruel,44149,Mirambel,1,2,-1
2006,Teruel,44151,Molinos,0,5,-5
2006,Teruel,44153,Monreal del Campo,22,31,-9
2006,Teruel,44154,Monroyo,5,6,-1
2006,Teruel,44155,Montalbán,9,21,-12
2006,Teruel,44156,Monteagudo del Castillo,0,1,-1
2006,Teruel,44158,Mora de Rubielos,13,18,-5
2006,Teruel,44159,Moscardón,0,1,-1
2006,Teruel,44160,Mosqueruela,7,4,3
2006,Teruel,44161,Muniesa,5,5,0
2006,Teruel,44163,Noguera de Albarracín,0,1,-1
2006,Teruel,44165,Nogueruelas,1,3,-2
2006,Teruel,44167,Obón,0,1,-1
2006,Teruel,44168,Odón,3,5,-2
2006,Teruel,44169,Ojos Negros,9,5,4
2006,Teruel,44171,Olba,0,2,-2
2006,Teruel,44172,Oliete,1,3,-2
2006,Teruel,44174,Orihuela del Tremedal,4,4,0
2006,Teruel,44175,Orrios,0,2,-2
2006,Teruel,44176,Palomar de Arroyos,0,3,-3
2006,Teruel,44177,Pancrudo,2,1,1
2006,Teruel,44178,Parras de Castellote (Las),1,0,1
2006,Teruel,44180,Peracense,0,1,-1
2006,Teruel,44181,Peralejos,0,1,-1
2006,Teruel,44182,Perales del Alfambra,3,4,-1
2006,Teruel,44179,Peñarroya de Tastavins,2,9,-7
2006,Teruel,44184,Plou,0,2,-2
2006,Teruel,44185,Pobo (El),1,1,0
2006,Teruel,44187,Portellada (La),2,7,-5
2006,Teruel,44189,Pozondón,0,2,-2
2006,Teruel,44190,Pozuel del Campo,0,1,-1
2006,Teruel,44191,Puebla de Híjar (La),6,18,-12
2006,Teruel,44192,Puebla de Valverde (La),4,5,-1
2006,Teruel,44193,Puertomingalvo,1,1,0
2006,Teruel,44195,Rillo,0,3,-3
2006,Teruel,44196,Riodeva,0,5,-5
2006,Teruel,44198,Royuela,2,5,-3
2006,Teruel,44199,Rubiales,0,1,-1
2006,Teruel,44201,Rubielos de Mora,7,4,3
2006,Teruel,44194,Ráfales,0,6,-6
2006,Teruel,44197,Ródenas,0,2,-2
2006,Teruel,44205,Samper de Calanda,5,19,-14
2006,Teruel,44206,San Agustín,0,1,-1
2006,Teruel,44207,San Martín del Río,0,3,-3
2006,Teruel,44208,Santa Cruz de Nogueras,0,1,-1
2006,Teruel,44209,Santa Eulalia,1,25,-24
2006,Teruel,44210,Sarrión,7,12,-5
2006,Teruel,44213,Singra,0,1,-1
2006,Teruel,44215,Terriente,0,4,-4
2006,Teruel,44216,Teruel,357,317,40
2006,Teruel,44217,Toril y Masegoso,0,2,-2
2006,Teruel,44219,Tornos,1,1,0
2006,Teruel,44220,Torralba de los Sisones,3,3,0
2006,Teruel,44223,Torre de Arcas,1,2,-1
2006,Teruel,44225,Torre del Compte,0,1,-1
2006,Teruel,44227,Torre los Negros,0,1,-1
2006,Teruel,44221,Torrecilla de Alcañiz,3,7,-4
2006,Teruel,44222,Torrecilla del Rebollar,1,2,-1
2006,Teruel,44226,Torrelacárcel,1,2,-1
2006,Teruel,44228,Torremocha de Jiloca,0,4,-4
2006,Teruel,44229,Torres de Albarracín,2,1,1
2006,Teruel,44230,Torrevelilla,1,3,-2
2006,Teruel,44232,Torrijo del Campo,2,7,-5
2006,Teruel,44234,Tramacastiel,0,3,-3
2006,Teruel,44235,Tramacastilla,3,1,2
2006,Teruel,44236,Tronchón,0,1,-1
2006,Teruel,44237,Urrea de Gaén,2,10,-8
2006,Teruel,44238,Utrillas,25,30,-5
2006,Teruel,44240,Valbona,1,2,-1
2006,Teruel,44241,Valdealgorfa,0,11,-11
2006,Teruel,44244,Valdelinares,0,1,-1
2006,Teruel,44245,Valdeltormo,0,1,-1
2006,Teruel,44246,Valderrobres,19,29,-10
2006,Teruel,44247,Valjunquera,2,4,-2
2006,Teruel,44249,Vallecillo (El),0,1,-1
2006,Teruel,44251,Villafranca del Campo,3,5,-2
2006,Teruel,44252,Villahermosa del Campo,0,3,-3
2006,Teruel,44257,Villar del Cobo,0,2,-2
2006,Teruel,44258,Villar del Salz,0,4,-4
2006,Teruel,44260,Villarluengo,1,4,-3
2006,Teruel,44261,Villarquemado,4,18,-14
2006,Teruel,44262,Villarroya de los Pinares,3,3,0
2006,Teruel,44263,Villastar,1,3,-2
2006,Teruel,44264,Villel,6,6,0
2006,Teruel,44265,Vinaceite,0,6,-6
2006,Teruel,44266,Visiedo,0,1,-1
2006,Teruel,44268,Zoma (La),0,1,-1
2005,Teruel,44001,Ababuj,1,0,1
2005,Teruel,44002,Abejuela,1,0,1
2005,Teruel,44003,Aguatón,0,0,0
2005,Teruel,44004,Aguaviva,7,11,-4
2005,Teruel,44005,Aguilar del Alfambra,0,0,0
2005,Teruel,44006,Alacón,2,5,-3
2005,Teruel,44007,Alba,0,7,-7
2005,Teruel,44008,Albalate del Arzobispo,10,29,-19
2005,Teruel,44009,Albarracín,8,8,0
2005,Teruel,44010,Albentosa,2,3,-1
2005,Teruel,44011,Alcaine,1,3,-2
2005,Teruel,44012,Alcalá de la Selva,2,9,-7
2005,Teruel,44013,Alcañiz,199,153,46
2005,Teruel,44014,Alcorisa,35,39,-4
2005,Teruel,44016,Alfambra,4,19,-15
2005,Teruel,44017,Aliaga,5,7,-2
2005,Teruel,44021,Allepuz,2,2,0
2005,Teruel,44022,Alloza,3,7,-4
2005,Teruel,44019,Alobras,0,3,-3
2005,Teruel,44025,Andorra,51,74,-23
2005,Teruel,44026,Arcos de las Salinas,0,2,-2
2005,Teruel,44027,Arens de Lledó,2,1,1
2005,Teruel,44028,Argente,0,5,-5
2005,Teruel,44029,Ariño,2,5,-3
2005,Teruel,44031,Azaila,0,4,-4
2005,Teruel,44035,Barrachina,1,3,-2
2005,Teruel,44034,Bañón,0,2,-2
2005,Teruel,44037,Beceite,3,8,-5
2005,Teruel,44039,Bello,1,4,-3
2005,Teruel,44038,Belmonte de San José,0,1,-1
2005,Teruel,44040,Berge,2,5,-3
2005,Teruel,44041,Bezas,1,0,1
2005,Teruel,44043,Blesa,0,2,-2
2005,Teruel,44044,Bordón,1,0,1
2005,Teruel,44045,Bronchales,2,5,-3
2005,Teruel,44046,Bueña,0,4,-4
2005,Teruel,44047,Burbáguena,0,10,-10
2005,Teruel,44033,Báguena,2,7,-5
2005,Teruel,44048,Cabra de Mora,0,1,-1
2005,Teruel,44049,Calaceite,4,12,-8
2005,Teruel,44050,Calamocha,42,51,-9
2005,Teruel,44051,Calanda,22,50,-28
2005,Teruel,44052,Calomarde,0,0,0
2005,Teruel,44054,Camarena de la Sierra,0,2,-2
2005,Teruel,44055,Camarillas,0,1,-1
2005,Teruel,44053,Camañas,1,4,-3
2005,Teruel,44056,Caminreal,6,16,-10
2005,Teruel,44059,Cantavieja,5,7,-2
2005,Teruel,44064,Cascante del Río,1,0,1
2005,Teruel,44065,Castejón de Tornos,1,1,0
2005,Teruel,44066,Castel de Cabra,2,2,0
2005,Teruel,44070,Castellar (El),1,0,1
2005,Teruel,44071,Castellote,5,7,-2
2005,Teruel,44067,Castelnou,1,2,-1
2005,Teruel,44068,Castelserás,7,11,-4
2005,Teruel,44060,Cañada de Benatanduz,0,3,-3
2005,Teruel,44061,Cañada de Verich (La),0,1,-1
2005,Teruel,44063,Cañizar del Olivar,1,3,-2
2005,Teruel,44074,Cedrillas,8,5,3
2005,Teruel,44075,Celadas,3,6,-3
2005,Teruel,44076,Cella,30,35,-5
2005,Teruel,44080,Codoñera (La),2,2,0
2005,Teruel,44082,Corbalán,0,1,-1
2005,Teruel,44084,Cortes de Aragón,0,1,-1
2005,Teruel,44085,Cosa,0,1,-1
2005,Teruel,44086,Cretas,6,9,-3
2005,Teruel,44088,Cuba (La),1,2,-1
2005,Teruel,44089,Cubla,0,1,-1
2005,Teruel,44090,Cucalón,2,1,1
2005,Teruel,44093,Cuevas de Almudén,1,0,1
2005,Teruel,44094,Cuevas Labradas,0,5,-5
2005,Teruel,44096,Ejulve,2,1,1
2005,Teruel,44097,Escorihuela,0,4,-4
2005,Teruel,44099,Escucha,8,12,-4
2005,Teruel,44100,Estercuel,1,6,-5
2005,Teruel,44101,Ferreruela de Huerva,0,1,-1
2005,Teruel,44102,Fonfría,0,1,-1
2005,Teruel,44103,Formiche Alto,0,5,-5
2005,Teruel,44106,Fortanete,0,1,-1
2005,Teruel,44107,Foz-Calanda,3,5,-2
2005,Teruel,44108,Fresneda (La),3,10,-7
2005,Teruel,44109,Frías de Albarracín,1,3,-2
2005,Teruel,44110,Fuenferrada,0,1,-1
2005,Teruel,44111,Fuentes Calientes,1,4,-3
2005,Teruel,44112,Fuentes Claras,1,11,-10
2005,Teruel,44113,Fuentes de Rubielos,2,1,1
2005,Teruel,44114,Fuentespalda,1,10,-9
2005,Teruel,44115,Galve,1,5,-4
2005,Teruel,44116,Gargallo,2,3,-1
2005,Teruel,44117,Gea de Albarracín,0,7,-7
2005,Teruel,44118,Ginebrosa (La),1,5,-4
2005,Teruel,44119,Griegos,1,0,1
2005,Teruel,44120,Guadalaviar,2,4,-2
2005,Teruel,44121,Gúdar,1,2,-1
2005,Teruel,44123,Hinojosa de Jarque,0,6,-6
2005,Teruel,44124,Hoz de la Vieja (La),0,5,-5
2005,Teruel,44125,Huesa del Común,1,1,0
2005,Teruel,44122,Híjar,12,30,-18
2005,Teruel,44126,Iglesuela del Cid (La),3,6,-3
2005,Teruel,44127,Jabaloyas,0,1,-1
2005,Teruel,44128,Jarque de la Val,1,1,0
2005,Teruel,44129,Jatiel,0,1,-1
2005,Teruel,44130,Jorcas,0,1,-1
2005,Teruel,44131,Josa,0,1,-1
2005,Teruel,44132,Lagueruela,0,1,-1
2005,Teruel,44133,Lanzuela,0,1,-1
2005,Teruel,44137,Linares de Mora,0,7,-7
2005,Teruel,44141,Lledó,0,4,-4
2005,Teruel,44138,Loscos,0,8,-8
2005,Teruel,44142,Maicas,0,1,-1
2005,Teruel,44143,Manzanera,3,5,-2
2005,Teruel,44144,Martín del Río,4,5,-1
2005,Teruel,44145,Mas de las Matas,11,18,-7
2005,Teruel,44146,Mata de los Olmos (La),1,5,-4
2005,Teruel,44147,Mazaleón,3,8,-5
2005,Teruel,44148,Mezquita de Jarque,2,2,0
2005,Teruel,44149,Mirambel,0,5,-5
2005,Teruel,44151,Molinos,1,5,-4
2005,Teruel,44153,Monreal del Campo,18,24,-6
2005,Teruel,44154,Monroyo,4,10,-6
2005,Teruel,44155,Montalbán,6,9,-3
2005,Teruel,44156,Monteagudo del Castillo,0,1,-1
2005,Teruel,44157,Monterde de Albarracín,0,1,-1
2005,Teruel,44158,Mora de Rubielos,13,20,-7
2005,Teruel,44159,Moscardón,2,0,2
2005,Teruel,44160,Mosqueruela,5,7,-2
2005,Teruel,44161,Muniesa,2,11,-9
2005,Teruel,44163,Noguera de Albarracín,1,2,-1
2005,Teruel,44165,Nogueruelas,3,5,-2
2005,Teruel,44168,Odón,2,4,-2
2005,Teruel,44169,Ojos Negros,3,12,-9
2005,Teruel,44171,Olba,0,2,-2
2005,Teruel,44172,Oliete,2,11,-9
2005,Teruel,44174,Orihuela del Tremedal,2,9,-7
2005,Teruel,44175,Orrios,1,2,-1
2005,Teruel,44176,Palomar de Arroyos,1,3,-2
2005,Teruel,44177,Pancrudo,1,6,-5
2005,Teruel,44178,Parras de Castellote (Las),1,2,-1
2005,Teruel,44180,Peracense,0,3,-3
2005,Teruel,44181,Peralejos,0,4,-4
2005,Teruel,44182,Perales del Alfambra,0,5,-5
2005,Teruel,44179,Peñarroya de Tastavins,5,12,-7
2005,Teruel,44183,Pitarque,0,1,-1
2005,Teruel,44184,Plou,0,1,-1
2005,Teruel,44185,Pobo (El),0,1,-1
2005,Teruel,44187,Portellada (La),0,3,-3
2005,Teruel,44189,Pozondón,0,0,0
2005,Teruel,44190,Pozuel del Campo,0,2,-2
2005,Teruel,44191,Puebla de Híjar (La),12,14,-2
2005,Teruel,44192,Puebla de Valverde (La),4,11,-7
2005,Teruel,44193,Puertomingalvo,0,0,0
2005,Teruel,44195,Rillo,1,4,-3
2005,Teruel,44196,Riodeva,1,3,-2
2005,Teruel,44198,Royuela,0,2,-2
2005,Teruel,44199,Rubiales,0,1,-1
2005,Teruel,44201,Rubielos de Mora,5,8,-3
2005,Teruel,44194,Ráfales,0,4,-4
2005,Teruel,44197,Ródenas,0,2,-2
2005,Teruel,44204,Saldón,0,1,-1
2005,Teruel,44205,Samper de Calanda,6,12,-6
2005,Teruel,44206,San Agustín,0,2,-2
2005,Teruel,44207,San Martín del Río,2,4,-2
2005,Teruel,44208,Santa Cruz de Nogueras,0,1,-1
2005,Teruel,44209,Santa Eulalia,7,17,-10
2005,Teruel,44210,Sarrión,11,19,-8
2005,Teruel,44211,Segura de los Baños,0,1,-1
2005,Teruel,44212,Seno,0,1,-1
2005,Teruel,44213,Singra,0,2,-2
2005,Teruel,44215,Terriente,1,2,-1
2005,Teruel,44216,Teruel,346,339,7
2005,Teruel,44218,Tormón,0,1,-1
2005,Teruel,44219,Tornos,1,2,-1
2005,Teruel,44220,Torralba de los Sisones,0,1,-1
2005,Teruel,44223,Torre de Arcas,1,2,-1
2005,Teruel,44224,Torre de las Arcas,1,0,1
2005,Teruel,44225,Torre del Compte,0,4,-4
2005,Teruel,44227,Torre los Negros,1,0,1
2005,Teruel,44221,Torrecilla de Alcañiz,1,4,-3
2005,Teruel,44222,Torrecilla del Rebollar,0,3,-3
2005,Teruel,44226,Torrelacárcel,0,6,-6
2005,Teruel,44228,Torremocha de Jiloca,0,4,-4
2005,Teruel,44229,Torres de Albarracín,3,1,2
2005,Teruel,44230,Torrevelilla,2,2,0
2005,Teruel,44231,Torrijas,1,1,0
2005,Teruel,44232,Torrijo del Campo,2,9,-7
2005,Teruel,44234,Tramacastiel,0,2,-2
2005,Teruel,44235,Tramacastilla,0,4,-4
2005,Teruel,44237,Urrea de Gaén,1,8,-7
2005,Teruel,44238,Utrillas,10,33,-23
2005,Teruel,44239,Valacloche,0,1,-1
2005,Teruel,44240,Valbona,0,1,-1
2005,Teruel,44241,Valdealgorfa,3,11,-8
2005,Teruel,44245,Valdeltormo,2,2,0
2005,Teruel,44246,Valderrobres,23,27,-4
2005,Teruel,44247,Valjunquera,2,5,-3
2005,Teruel,44249,Vallecillo (El),0,1,-1
2005,Teruel,44251,Villafranca del Campo,2,10,-8
2005,Teruel,44252,Villahermosa del Campo,0,1,-1
2005,Teruel,44257,Villar del Cobo,1,4,-3
2005,Teruel,44258,Villar del Salz,0,2,-2
2005,Teruel,44260,Villarluengo,0,1,-1
2005,Teruel,44261,Villarquemado,4,16,-12
2005,Teruel,44262,Villarroya de los Pinares,1,1,0
2005,Teruel,44263,Villastar,2,4,-2
2005,Teruel,44264,Villel,3,8,-5
2005,Teruel,44265,Vinaceite,4,3,1
2005,Teruel,44266,Visiedo,0,7,-7
2005,Teruel,44267,Vivel del Río Martín,0,2,-2
2005,Teruel,44268,Zoma (La),0,1,-1
2004,Teruel,44001,Ababuj,0,1,-1
2004,Teruel,44003,Aguatón,0,1,-1
2004,Teruel,44004,Aguaviva,1,10,-9
2004,Teruel,44005,Aguilar del Alfambra,1,3,-2
2004,Teruel,44006,Alacón,3,9,-6
2004,Teruel,44007,Alba,2,6,-4
2004,Teruel,44008,Albalate del Arzobispo,11,38,-27
2004,Teruel,44009,Albarracín,9,7,2
2004,Teruel,44010,Albentosa,4,6,-2
2004,Teruel,44012,Alcalá de la Selva,2,3,-1
2004,Teruel,44013,Alcañiz,157,163,-6
2004,Teruel,44014,Alcorisa,30,42,-12
2004,Teruel,44016,Alfambra,3,14,-11
2004,Teruel,44017,Aliaga,0,6,-6
2004,Teruel,44021,Allepuz,0,6,-6
2004,Teruel,44022,Alloza,2,6,-4
2004,Teruel,44019,Alobras,1,0,1
2004,Teruel,44025,Andorra,67,61,6
2004,Teruel,44026,Arcos de las Salinas,0,1,-1
2004,Teruel,44027,Arens de Lledó,0,3,-3
2004,Teruel,44028,Argente,0,5,-5
2004,Teruel,44029,Ariño,7,14,-7
2004,Teruel,44031,Azaila,0,1,-1
2004,Teruel,44035,Barrachina,0,3,-3
2004,Teruel,44034,Bañón,1,0,1
2004,Teruel,44037,Beceite,2,9,-7
2004,Teruel,44039,Bello,2,9,-7
2004,Teruel,44038,Belmonte de San José,2,1,1
2004,Teruel,44040,Berge,2,2,0
2004,Teruel,44041,Bezas,0,1,-1
2004,Teruel,44042,Blancas,0,1,-1
2004,Teruel,44044,Bordón,1,0,1
2004,Teruel,44045,Bronchales,2,8,-6
2004,Teruel,44046,Bueña,0,1,-1
2004,Teruel,44047,Burbáguena,0,10,-10
2004,Teruel,44033,Báguena,0,12,-12
2004,Teruel,44048,Cabra de Mora,0,1,-1
2004,Teruel,44049,Calaceite,5,14,-9
2004,Teruel,44050,Calamocha,33,29,4
2004,Teruel,44051,Calanda,22,40,-18
2004,Teruel,44052,Calomarde,0,1,-1
2004,Teruel,44054,Camarena de la Sierra,1,2,-1
2004,Teruel,44055,Camarillas,0,1,-1
2004,Teruel,44056,Caminreal,2,9,-7
2004,Teruel,44059,Cantavieja,8,5,3
2004,Teruel,44064,Cascante del Río,0,5,-5
2004,Teruel,44065,Castejón de Tornos,0,2,-2
2004,Teruel,44066,Castel de Cabra,0,3,-3
2004,Teruel,44070,Castellar (El),0,1,-1
2004,Teruel,44071,Castellote,4,10,-6
2004,Teruel,44067,Castelnou,0,2,-2
2004,Teruel,44068,Castelserás,7,19,-12
2004,Teruel,44060,Cañada de Benatanduz,0,1,-1
2004,Teruel,44061,Cañada de Verich (La),2,0,2
2004,Teruel,44062,Cañada Vellida,0,3,-3
2004,Teruel,44063,Cañizar del Olivar,0,5,-5
2004,Teruel,44074,Cedrillas,3,14,-11
2004,Teruel,44075,Celadas,1,2,-1
2004,Teruel,44076,Cella,15,21,-6
2004,Teruel,44077,Cerollera (La),0,2,-2
2004,Teruel,44080,Codoñera (La),4,2,2
2004,Teruel,44082,Corbalán,0,1,-1
2004,Teruel,44084,Cortes de Aragón,0,5,-5
2004,Teruel,44085,Cosa,0,1,-1
2004,Teruel,44086,Cretas,6,10,-4
2004,Teruel,44089,Cubla,0,2,-2
2004,Teruel,44090,Cucalón,1,2,-1
2004,Teruel,44092,Cuervo (El),0,2,-2
2004,Teruel,44093,Cuevas de Almudén,1,2,-1
2004,Teruel,44094,Cuevas Labradas,1,3,-2
2004,Teruel,44096,Ejulve,2,2,0
2004,Teruel,44097,Escorihuela,0,6,-6
2004,Teruel,44099,Escucha,8,5,3
2004,Teruel,44100,Estercuel,0,6,-6
2004,Teruel,44101,Ferreruela de Huerva,0,1,-1
2004,Teruel,44102,Fonfría,0,1,-1
2004,Teruel,44103,Formiche Alto,4,2,2
2004,Teruel,44106,Fortanete,2,1,1
2004,Teruel,44107,Foz-Calanda,4,4,0
2004,Teruel,44108,Fresneda (La),4,6,-2
2004,Teruel,44109,Frías de Albarracín,1,3,-2
2004,Teruel,44110,Fuenferrada,0,2,-2
2004,Teruel,44111,Fuentes Calientes,0,2,-2
2004,Teruel,44112,Fuentes Claras,2,8,-6
2004,Teruel,44113,Fuentes de Rubielos,2,1,1
2004,Teruel,44114,Fuentespalda,3,3,0
2004,Teruel,44105,Fórnoles,1,1,0
2004,Teruel,44115,Galve,3,1,2
2004,Teruel,44116,Gargallo,0,2,-2
2004,Teruel,44117,Gea de Albarracín,3,4,-1
2004,Teruel,44118,Ginebrosa (La),1,7,-6
2004,Teruel,44119,Griegos,1,2,-1
2004,Teruel,44120,Guadalaviar,3,5,-2
2004,Teruel,44121,Gúdar,2,0,2
2004,Teruel,44123,Hinojosa de Jarque,1,5,-4
2004,Teruel,44125,Huesa del Común,0,2,-2
2004,Teruel,44122,Híjar,10,27,-17
2004,Teruel,44126,Iglesuela del Cid (La),4,5,-1
2004,Teruel,44127,Jabaloyas,0,2,-2
2004,Teruel,44128,Jarque de la Val,0,1,-1
2004,Teruel,44129,Jatiel,0,2,-2
2004,Teruel,44130,Jorcas,0,1,-1
2004,Teruel,44131,Josa,0,1,-1
2004,Teruel,44133,Lanzuela,0,1,-1
2004,Teruel,44135,Libros,0,5,-5
2004,Teruel,44136,Lidón,1,3,-2
2004,Teruel,44137,Linares de Mora,0,4,-4
2004,Teruel,44141,Lledó,0,1,-1
2004,Teruel,44138,Loscos,0,1,-1
2004,Teruel,44143,Manzanera,7,5,2
2004,Teruel,44144,Martín del Río,3,3,0
2004,Teruel,44145,Mas de las Matas,9,22,-13
2004,Teruel,44146,Mata de los Olmos (La),0,3,-3
2004,Teruel,44147,Mazaleón,7,4,3
2004,Teruel,44148,Mezquita de Jarque,1,1,0
2004,Teruel,44149,Mirambel,0,0,0
2004,Teruel,44150,Miravete de la Sierra,0,2,-2
2004,Teruel,44151,Molinos,1,4,-3
2004,Teruel,44153,Monreal del Campo,22,24,-2
2004,Teruel,44154,Monroyo,1,2,-1
2004,Teruel,44155,Montalbán,8,14,-6
2004,Teruel,44158,Mora de Rubielos,7,13,-6
2004,Teruel,44160,Mosqueruela,9,7,2
2004,Teruel,44161,Muniesa,3,6,-3
2004,Teruel,44163,Noguera de Albarracín,0,2,-2
2004,Teruel,44165,Nogueruelas,0,9,-9
2004,Teruel,44168,Odón,1,3,-2
2004,Teruel,44169,Ojos Negros,3,7,-4
2004,Teruel,44171,Olba,1,2,-1
2004,Teruel,44172,Oliete,1,8,-7
2004,Teruel,44173,Olmos (Los),1,0,1
2004,Teruel,44174,Orihuela del Tremedal,2,5,-3
2004,Teruel,44175,Orrios,0,5,-5
2004,Teruel,44177,Pancrudo,1,2,-1
2004,Teruel,44178,Parras de Castellote (Las),0,5,-5
2004,Teruel,44180,Peracense,0,3,-3
2004,Teruel,44181,Peralejos,0,1,-1
2004,Teruel,44182,Perales del Alfambra,1,4,-3
2004,Teruel,44179,Peñarroya de Tastavins,0,3,-3
2004,Teruel,44183,Pitarque,0,2,-2
2004,Teruel,44184,Plou,0,2,-2
2004,Teruel,44185,Pobo (El),0,2,-2
2004,Teruel,44187,Portellada (La),0,2,-2
2004,Teruel,44189,Pozondón,0,4,-4
2004,Teruel,44190,Pozuel del Campo,0,5,-5
2004,Teruel,44191,Puebla de Híjar (La),6,15,-9
2004,Teruel,44192,Puebla de Valverde (La),6,8,-2
2004,Teruel,44193,Puertomingalvo,2,4,-2
2004,Teruel,44195,Rillo,0,5,-5
2004,Teruel,44196,Riodeva,0,6,-6
2004,Teruel,44198,Royuela,2,5,-3
2004,Teruel,44199,Rubiales,0,1,-1
2004,Teruel,44201,Rubielos de Mora,5,7,-2
2004,Teruel,44194,Ráfales,0,9,-9
2004,Teruel,44197,Ródenas,0,2,-2
2004,Teruel,44204,Saldón,0,2,-2
2004,Teruel,44205,Samper de Calanda,7,16,-9
2004,Teruel,44206,San Agustín,2,1,1
2004,Teruel,44207,San Martín del Río,0,2,-2
2004,Teruel,44209,Santa Eulalia,4,20,-16
2004,Teruel,44210,Sarrión,5,15,-10
2004,Teruel,44211,Segura de los Baños,0,1,-1
2004,Teruel,44212,Seno,0,0,0
2004,Teruel,44215,Terriente,0,3,-3
2004,Teruel,44216,Teruel,367,324,43
2004,Teruel,44219,Tornos,1,7,-6
2004,Teruel,44220,Torralba de los Sisones,0,1,-1
2004,Teruel,44225,Torre del Compte,1,1,0
2004,Teruel,44227,Torre los Negros,0,0,0
2004,Teruel,44221,Torrecilla de Alcañiz,2,8,-6
2004,Teruel,44222,Torrecilla del Rebollar,0,4,-4
2004,Teruel,44226,Torrelacárcel,2,5,-3
2004,Teruel,44228,Torremocha de Jiloca,0,2,-2
2004,Teruel,44229,Torres de Albarracín,1,1,0
2004,Teruel,44230,Torrevelilla,0,3,-3
2004,Teruel,44231,Torrijas,0,1,-1
2004,Teruel,44232,Torrijo del Campo,1,8,-7
2004,Teruel,44234,Tramacastiel,0,2,-2
2004,Teruel,44235,Tramacastilla,0,1,-1
2004,Teruel,44236,Tronchón,0,1,-1
2004,Teruel,44237,Urrea de Gaén,1,5,-4
2004,Teruel,44238,Utrillas,42,23,19
2004,Teruel,44239,Valacloche,0,1,-1
2004,Teruel,44240,Valbona,2,3,-1
2004,Teruel,44241,Valdealgorfa,4,7,-3
2004,Teruel,44243,Valdecuenca,0,1,-1
2004,Teruel,44244,Valdelinares,0,2,-2
2004,Teruel,44245,Valdeltormo,0,7,-7
2004,Teruel,44246,Valderrobres,21,27,-6
2004,Teruel,44247,Valjunquera,1,6,-5
2004,Teruel,44250,Veguillas de la Sierra,0,2,-2
2004,Teruel,44251,Villafranca del Campo,1,4,-3
2004,Teruel,44252,Villahermosa del Campo,0,1,-1
2004,Teruel,44256,Villanueva del Rebollar de la Sierra,1,2,-1
2004,Teruel,44257,Villar del Cobo,0,2,-2
2004,Teruel,44258,Villar del Salz,0,1,-1
2004,Teruel,44260,Villarluengo,1,3,-2
2004,Teruel,44261,Villarquemado,6,19,-13
2004,Teruel,44262,Villarroya de los Pinares,1,2,-1
2004,Teruel,44263,Villastar,2,4,-2
2004,Teruel,44264,Villel,1,8,-7
2004,Teruel,44265,Vinaceite,0,2,-2
2004,Teruel,44266,Visiedo,0,5,-5
2004,Teruel,44267,Vivel del Río Martín,1,0,1
2003,Teruel,44001,Ababuj,0,1,-1
2003,Teruel,44002,Abejuela,1,0,1
2003,Teruel,44003,Aguatón,0,2,-2
2003,Teruel,44004,Aguaviva,4,8,-4
2003,Teruel,44005,Aguilar del Alfambra,1,0,1
2003,Teruel,44006,Alacón,1,8,-7
2003,Teruel,44007,Alba,0,2,-2
2003,Teruel,44008,Albalate del Arzobispo,11,35,-24
2003,Teruel,44009,Albarracín,5,20,-15
2003,Teruel,44010,Albentosa,2,9,-7
2003,Teruel,44012,Alcalá de la Selva,7,4,3
2003,Teruel,44013,Alcañiz,155,186,-31
2003,Teruel,44014,Alcorisa,35,31,4
2003,Teruel,44016,Alfambra,2,7,-5
2003,Teruel,44017,Aliaga,2,3,-1
2003,Teruel,44021,Allepuz,0,2,-2
2003,Teruel,44022,Alloza,3,11,-8
2003,Teruel,44018,Almohaja,0,1,-1
2003,Teruel,44019,Alobras,0,3,-3
2003,Teruel,44025,Andorra,49,55,-6
2003,Teruel,44026,Arcos de las Salinas,0,4,-4
2003,Teruel,44027,Arens de Lledó,1,3,-2
2003,Teruel,44028,Argente,3,2,1
2003,Teruel,44029,Ariño,7,12,-5
2003,Teruel,44031,Azaila,1,2,-1
2003,Teruel,44035,Barrachina,0,5,-5
2003,Teruel,44034,Bañón,1,4,-3
2003,Teruel,44037,Beceite,3,8,-5
2003,Teruel,44039,Bello,4,1,3
2003,Teruel,44038,Belmonte de San José,1,3,-2
2003,Teruel,44040,Berge,3,4,-1
2003,Teruel,44041,Bezas,1,0,1
2003,Teruel,44042,Blancas,0,4,-4
2003,Teruel,44043,Blesa,0,1,-1
2003,Teruel,44044,Bordón,2,2,0
2003,Teruel,44045,Bronchales,2,5,-3
2003,Teruel,44046,Bueña,0,4,-4
2003,Teruel,44047,Burbáguena,0,10,-10
2003,Teruel,44033,Báguena,2,12,-10
2003,Teruel,44049,Calaceite,5,23,-18
2003,Teruel,44050,Calamocha,38,50,-12
2003,Teruel,44051,Calanda,25,41,-16
2003,Teruel,44054,Camarena de la Sierra,2,6,-4
2003,Teruel,44055,Camarillas,0,1,-1
2003,Teruel,44053,Camañas,0,1,-1
2003,Teruel,44056,Caminreal,1,10,-9
2003,Teruel,44059,Cantavieja,5,10,-5
2003,Teruel,44064,Cascante del Río,0,4,-4
2003,Teruel,44065,Castejón de Tornos,0,1,-1
2003,Teruel,44066,Castel de Cabra,0,1,-1
2003,Teruel,44070,Castellar (El),0,2,-2
2003,Teruel,44071,Castellote,2,19,-17
2003,Teruel,44067,Castelnou,0,3,-3
2003,Teruel,44068,Castelserás,0,9,-9
2003,Teruel,44061,Cañada de Verich (La),0,2,-2
2003,Teruel,44062,Cañada Vellida,0,1,-1
2003,Teruel,44063,Cañizar del Olivar,3,4,-1
2003,Teruel,44074,Cedrillas,3,13,-10
2003,Teruel,44075,Celadas,1,4,-3
2003,Teruel,44076,Cella,14,45,-31
2003,Teruel,44080,Codoñera (La),0,6,-6
2003,Teruel,44082,Corbalán,1,1,0
2003,Teruel,44084,Cortes de Aragón,1,2,-1
2003,Teruel,44085,Cosa,0,1,-1
2003,Teruel,44086,Cretas,1,7,-6
2003,Teruel,44088,Cuba (La),1,1,0
2003,Teruel,44090,Cucalón,0,2,-2
2003,Teruel,44092,Cuervo (El),0,4,-4
2003,Teruel,44093,Cuevas de Almudén,1,3,-2
2003,Teruel,44096,Ejulve,0,2,-2
2003,Teruel,44097,Escorihuela,0,3,-3
2003,Teruel,44099,Escucha,10,6,4
2003,Teruel,44100,Estercuel,2,3,-1
2003,Teruel,44101,Ferreruela de Huerva,0,3,-3
2003,Teruel,44102,Fonfría,0,1,-1
2003,Teruel,44103,Formiche Alto,2,2,0
2003,Teruel,44106,Fortanete,1,2,-1
2003,Teruel,44107,Foz-Calanda,2,3,-1
2003,Teruel,44108,Fresneda (La),1,8,-7
2003,Teruel,44109,Frías de Albarracín,1,1,0
2003,Teruel,44112,Fuentes Claras,2,8,-6
2003,Teruel,44113,Fuentes de Rubielos,2,1,1
2003,Teruel,44114,Fuentespalda,4,4,0
2003,Teruel,44115,Galve,1,2,-1
2003,Teruel,44116,Gargallo,2,3,-1
2003,Teruel,44117,Gea de Albarracín,1,8,-7
2003,Teruel,44118,Ginebrosa (La),0,3,-3
2003,Teruel,44119,Griegos,0,2,-2
2003,Teruel,44120,Guadalaviar,1,4,-3
2003,Teruel,44121,Gúdar,0,0,0
2003,Teruel,44123,Hinojosa de Jarque,0,4,-4
2003,Teruel,44124,Hoz de la Vieja (La),0,5,-5
2003,Teruel,44122,Híjar,23,24,-1
2003,Teruel,44126,Iglesuela del Cid (La),5,4,1
2003,Teruel,44127,Jabaloyas,1,1,0
2003,Teruel,44128,Jarque de la Val,0,1,-1
2003,Teruel,44130,Jorcas,0,1,-1
2003,Teruel,44135,Libros,0,1,-1
2003,Teruel,44136,Lidón,0,3,-3
2003,Teruel,44137,Linares de Mora,2,11,-9
2003,Teruel,44141,Lledó,1,2,-1
2003,Teruel,44138,Loscos,0,1,-1
2003,Teruel,44142,Maicas,1,1,0
2003,Teruel,44143,Manzanera,1,7,-6
2003,Teruel,44144,Martín del Río,5,6,-1
2003,Teruel,44145,Mas de las Matas,7,37,-30
2003,Teruel,44146,Mata de los Olmos (La),4,7,-3
2003,Teruel,44147,Mazaleón,3,16,-13
2003,Teruel,44148,Mezquita de Jarque,0,4,-4
2003,Teruel,44149,Mirambel,1,2,-1
2003,Teruel,44150,Miravete de la Sierra,0,1,-1
2003,Teruel,44151,Molinos,2,4,-2
2003,Teruel,44152,Monforte de Moyuela,0,1,-1
2003,Teruel,44153,Monreal del Campo,15,21,-6
2003,Teruel,44154,Monroyo,0,2,-2
2003,Teruel,44155,Montalbán,13,18,-5
2003,Teruel,44158,Mora de Rubielos,12,20,-8
2003,Teruel,44159,Moscardón,1,1,0
2003,Teruel,44160,Mosqueruela,9,16,-7
2003,Teruel,44161,Muniesa,4,6,-2
2003,Teruel,44163,Noguera de Albarracín,1,6,-5
2003,Teruel,44164,Nogueras,0,1,-1
2003,Teruel,44165,Nogueruelas,1,5,-4
2003,Teruel,44167,Obón,0,1,-1
2003,Teruel,44168,Odón,1,4,-3
2003,Teruel,44169,Ojos Negros,2,6,-4
2003,Teruel,44171,Olba,1,3,-2
2003,Teruel,44172,Oliete,3,7,-4
2003,Teruel,44173,Olmos (Los),1,3,-2
2003,Teruel,44174,Orihuela del Tremedal,6,4,2
2003,Teruel,44175,Orrios,1,2,-1
2003,Teruel,44176,Palomar de Arroyos,0,6,-6
2003,Teruel,44177,Pancrudo,1,1,0
2003,Teruel,44178,Parras de Castellote (Las),0,1,-1
2003,Teruel,44180,Peracense,0,1,-1
2003,Teruel,44181,Peralejos,0,1,-1
2003,Teruel,44182,Perales del Alfambra,1,4,-3
2003,Teruel,44179,Peñarroya de Tastavins,2,7,-5
2003,Teruel,44183,Pitarque,1,1,0
2003,Teruel,44184,Plou,0,1,-1
2003,Teruel,44185,Pobo (El),0,2,-2
2003,Teruel,44187,Portellada (La),0,5,-5
2003,Teruel,44189,Pozondón,0,1,-1
2003,Teruel,44191,Puebla de Híjar (La),4,16,-12
2003,Teruel,44192,Puebla de Valverde (La),2,4,-2
2003,Teruel,44193,Puertomingalvo,0,1,-1
2003,Teruel,44195,Rillo,0,3,-3
2003,Teruel,44196,Riodeva,1,2,-1
2003,Teruel,44198,Royuela,0,2,-2
2003,Teruel,44200,Rubielos de la Cérida,0,2,-2
2003,Teruel,44201,Rubielos de Mora,4,5,-1
2003,Teruel,44194,Ráfales,0,3,-3
2003,Teruel,44197,Ródenas,0,1,-1
2003,Teruel,44205,Samper de Calanda,4,14,-10
2003,Teruel,44206,San Agustín,0,3,-3
2003,Teruel,44207,San Martín del Río,1,2,-1
2003,Teruel,44208,Santa Cruz de Nogueras,1,0,1
2003,Teruel,44209,Santa Eulalia,5,16,-11
2003,Teruel,44210,Sarrión,10,14,-4
2003,Teruel,44211,Segura de los Baños,0,2,-2
2003,Teruel,44213,Singra,1,1,0
2003,Teruel,44215,Terriente,0,2,-2
2003,Teruel,44216,Teruel,310,350,-40
2003,Teruel,44217,Toril y Masegoso,0,1,-1
2003,Teruel,44219,Tornos,2,4,-2
2003,Teruel,44220,Torralba de los Sisones,0,2,-2
2003,Teruel,44224,Torre de las Arcas,0,1,-1
2003,Teruel,44225,Torre del Compte,0,5,-5
2003,Teruel,44227,Torre los Negros,1,1,0
2003,Teruel,44221,Torrecilla de Alcañiz,3,8,-5
2003,Teruel,44222,Torrecilla del Rebollar,1,1,0
2003,Teruel,44226,Torrelacárcel,0,4,-4
2003,Teruel,44228,Torremocha de Jiloca,0,2,-2
2003,Teruel,44229,Torres de Albarracín,1,2,-1
2003,Teruel,44230,Torrevelilla,1,5,-4
2003,Teruel,44232,Torrijo del Campo,1,2,-1
2003,Teruel,44234,Tramacastiel,0,3,-3
2003,Teruel,44235,Tramacastilla,0,1,-1
2003,Teruel,44236,Tronchón,0,5,-5
2003,Teruel,44237,Urrea de Gaén,1,8,-7
2003,Teruel,44238,Utrillas,19,33,-14
2003,Teruel,44239,Valacloche,1,0,1
2003,Teruel,44240,Valbona,0,3,-3
2003,Teruel,44241,Valdealgorfa,3,12,-9
2003,Teruel,44244,Valdelinares,2,1,1
2003,Teruel,44245,Valdeltormo,1,6,-5
2003,Teruel,44246,Valderrobres,22,33,-11
2003,Teruel,44247,Valjunquera,2,10,-8
2003,Teruel,44251,Villafranca del Campo,1,2,-1
2003,Teruel,44252,Villahermosa del Campo,1,2,-1
2003,Teruel,44256,Villanueva del Rebollar de la Sierra,1,0,1
2003,Teruel,44257,Villar del Cobo,0,2,-2
2003,Teruel,44258,Villar del Salz,0,3,-3
2003,Teruel,44260,Villarluengo,0,3,-3
2003,Teruel,44261,Villarquemado,2,14,-12
2003,Teruel,44262,Villarroya de los Pinares,2,4,-2
2003,Teruel,44263,Villastar,3,7,-4
2003,Teruel,44264,Villel,2,8,-6
2003,Teruel,44265,Vinaceite,2,2,0
2003,Teruel,44266,Visiedo,1,1,0
2003,Teruel,44267,Vivel del Río Martín,0,2,-2
2003,Teruel,44268,Zoma (La),0,1,-1
2002,Teruel,44001,Ababuj,1,0,1
2002,Teruel,44002,Abejuela,0,1,-1
2002,Teruel,44003,Aguatón,0,1,-1
2002,Teruel,44004,Aguaviva,6,10,-4
2002,Teruel,44005,Aguilar del Alfambra,0,2,-2
2002,Teruel,44006,Alacón,1,9,-8
2002,Teruel,44007,Alba,0,6,-6
2002,Teruel,44008,Albalate del Arzobispo,15,35,-20
2002,Teruel,44009,Albarracín,2,21,-19
2002,Teruel,44010,Albentosa,2,2,0
2002,Teruel,44011,Alcaine,0,0,0
2002,Teruel,44012,Alcalá de la Selva,6,6,0
2002,Teruel,44013,Alcañiz,161,174,-13
2002,Teruel,44014,Alcorisa,23,33,-10
2002,Teruel,44016,Alfambra,0,6,-6
2002,Teruel,44017,Aliaga,0,6,-6
2002,Teruel,44021,Allepuz,1,3,-2
2002,Teruel,44022,Alloza,3,15,-12
2002,Teruel,44019,Alobras,0,1,-1
2002,Teruel,44025,Andorra,60,50,10
2002,Teruel,44026,Arcos de las Salinas,0,3,-3
2002,Teruel,44027,Arens de Lledó,1,7,-6
2002,Teruel,44028,Argente,0,1,-1
2002,Teruel,44029,Ariño,2,7,-5
2002,Teruel,44031,Azaila,0,3,-3
2002,Teruel,44035,Barrachina,0,2,-2
2002,Teruel,44034,Bañón,0,4,-4
2002,Teruel,44036,Bea,0,1,-1
2002,Teruel,44037,Beceite,3,5,-2
2002,Teruel,44039,Bello,0,5,-5
2002,Teruel,44038,Belmonte de San José,1,3,-2
2002,Teruel,44040,Berge,1,1,0
2002,Teruel,44041,Bezas,1,1,0
2002,Teruel,44042,Blancas,1,2,-1
2002,Teruel,44044,Bordón,1,4,-3
2002,Teruel,44045,Bronchales,2,5,-3
2002,Teruel,44046,Bueña,0,2,-2
2002,Teruel,44047,Burbáguena,0,13,-13
2002,Teruel,44033,Báguena,1,6,-5
2002,Teruel,44048,Cabra de Mora,0,2,-2
2002,Teruel,44049,Calaceite,10,14,-4
2002,Teruel,44050,Calamocha,30,36,-6
2002,Teruel,44051,Calanda,28,44,-16
2002,Teruel,44052,Calomarde,0,4,-4
2002,Teruel,44054,Camarena de la Sierra,0,1,-1
2002,Teruel,44055,Camarillas,0,1,-1
2002,Teruel,44053,Camañas,2,3,-1
2002,Teruel,44056,Caminreal,3,10,-7
2002,Teruel,44059,Cantavieja,7,9,-2
2002,Teruel,44064,Cascante del Río,0,3,-3
2002,Teruel,44065,Castejón de Tornos,0,1,-1
2002,Teruel,44066,Castel de Cabra,1,3,-2
2002,Teruel,44070,Castellar (El),1,2,-1
2002,Teruel,44071,Castellote,3,7,-4
2002,Teruel,44067,Castelnou,0,1,-1
2002,Teruel,44068,Castelserás,7,7,0
2002,Teruel,44060,Cañada de Benatanduz,0,2,-2
2002,Teruel,44063,Cañizar del Olivar,0,4,-4
2002,Teruel,44074,Cedrillas,4,12,-8
2002,Teruel,44075,Celadas,1,5,-4
2002,Teruel,44076,Cella,13,31,-18
2002,Teruel,44077,Cerollera (La),0,2,-2
2002,Teruel,44080,Codoñera (La),1,3,-2
2002,Teruel,44082,Corbalán,0,2,-2
2002,Teruel,44084,Cortes de Aragón,0,8,-8
2002,Teruel,44086,Cretas,1,7,-6
2002,Teruel,44087,Crivillén,0,2,-2
2002,Teruel,44088,Cuba (La),0,1,-1
2002,Teruel,44089,Cubla,0,4,-4
2002,Teruel,44090,Cucalón,0,2,-2
2002,Teruel,44092,Cuervo (El),1,2,-1
2002,Teruel,44093,Cuevas de Almudén,0,0,0
2002,Teruel,44094,Cuevas Labradas,0,0,0
2002,Teruel,44096,Ejulve,1,3,-2
2002,Teruel,44097,Escorihuela,0,6,-6
2002,Teruel,44099,Escucha,9,8,1
2002,Teruel,44100,Estercuel,2,4,-2
2002,Teruel,44101,Ferreruela de Huerva,0,1,-1
2002,Teruel,44102,Fonfría,0,1,-1
2002,Teruel,44103,Formiche Alto,2,3,-1
2002,Teruel,44106,Fortanete,1,2,-1
2002,Teruel,44107,Foz-Calanda,3,5,-2
2002,Teruel,44108,Fresneda (La),0,6,-6
2002,Teruel,44109,Frías de Albarracín,0,2,-2
2002,Teruel,44111,Fuentes Calientes,0,0,0
2002,Teruel,44112,Fuentes Claras,1,4,-3
2002,Teruel,44113,Fuentes de Rubielos,2,1,1
2002,Teruel,44114,Fuentespalda,0,6,-6
2002,Teruel,44105,Fórnoles,1,1,0
2002,Teruel,44115,Galve,1,2,-1
2002,Teruel,44116,Gargallo,1,3,-2
2002,Teruel,44117,Gea de Albarracín,1,11,-10
2002,Teruel,44118,Ginebrosa (La),0,4,-4
2002,Teruel,44119,Griegos,0,5,-5
2002,Teruel,44120,Guadalaviar,0,3,-3
2002,Teruel,44121,Gúdar,0,1,-1
2002,Teruel,44123,Hinojosa de Jarque,0,4,-4
2002,Teruel,44125,Huesa del Común,0,1,-1
2002,Teruel,44122,Híjar,11,31,-20
2002,Teruel,44126,Iglesuela del Cid (La),3,7,-4
2002,Teruel,44127,Jabaloyas,1,1,0
2002,Teruel,44128,Jarque de la Val,0,1,-1
2002,Teruel,44130,Jorcas,0,1,-1
2002,Teruel,44132,Lagueruela,0,1,-1
2002,Teruel,44135,Libros,1,2,-1
2002,Teruel,44136,Lidón,0,1,-1
2002,Teruel,44137,Linares de Mora,2,7,-5
2002,Teruel,44141,Lledó,0,4,-4
2002,Teruel,44138,Loscos,1,3,-2
2002,Teruel,44143,Manzanera,4,9,-5
2002,Teruel,44144,Martín del Río,3,8,-5
2002,Teruel,44145,Mas de las Matas,9,18,-9
2002,Teruel,44146,Mata de los Olmos (La),1,4,-3
2002,Teruel,44147,Mazaleón,2,7,-5
2002,Teruel,44148,Mezquita de Jarque,0,4,-4
2002,Teruel,44149,Mirambel,0,1,-1
2002,Teruel,44151,Molinos,2,7,-5
2002,Teruel,44152,Monforte de Moyuela,0,2,-2
2002,Teruel,44153,Monreal del Campo,16,23,-7
2002,Teruel,44154,Monroyo,0,2,-2
2002,Teruel,44155,Montalbán,8,12,-4
2002,Teruel,44156,Monteagudo del Castillo,1,1,0
2002,Teruel,44158,Mora de Rubielos,5,13,-8
2002,Teruel,44159,Moscardón,0,0,0
2002,Teruel,44160,Mosqueruela,2,11,-9
2002,Teruel,44161,Muniesa,6,13,-7
2002,Teruel,44163,Noguera de Albarracín,0,3,-3
2002,Teruel,44165,Nogueruelas,0,3,-3
2002,Teruel,44168,Odón,2,2,0
2002,Teruel,44169,Ojos Negros,2,7,-5
2002,Teruel,44171,Olba,0,3,-3
2002,Teruel,44172,Oliete,0,5,-5
2002,Teruel,44173,Olmos (Los),1,4,-3
2002,Teruel,44174,Orihuela del Tremedal,5,6,-1
2002,Teruel,44175,Orrios,0,1,-1
2002,Teruel,44176,Palomar de Arroyos,0,1,-1
2002,Teruel,44177,Pancrudo,1,2,-1
2002,Teruel,44178,Parras de Castellote (Las),0,2,-2
2002,Teruel,44180,Peracense,0,1,-1
2002,Teruel,44181,Peralejos,0,1,-1
2002,Teruel,44182,Perales del Alfambra,0,2,-2
2002,Teruel,44179,Peñarroya de Tastavins,4,9,-5
2002,Teruel,44183,Pitarque,0,1,-1
2002,Teruel,44184,Plou,0,1,-1
2002,Teruel,44187,Portellada (La),0,8,-8
2002,Teruel,44189,Pozondón,0,1,-1
2002,Teruel,44190,Pozuel del Campo,1,4,-3
2002,Teruel,44191,Puebla de Híjar (La),4,13,-9
2002,Teruel,44192,Puebla de Valverde (La),5,3,2
2002,Teruel,44193,Puertomingalvo,1,2,-1
2002,Teruel,44195,Rillo,0,2,-2
2002,Teruel,44196,Riodeva,0,7,-7
2002,Teruel,44198,Royuela,3,6,-3
2002,Teruel,44200,Rubielos de la Cérida,0,1,-1
2002,Teruel,44201,Rubielos de Mora,2,7,-5
2002,Teruel,44194,Ráfales,0,6,-6
2002,Teruel,44197,Ródenas,0,1,-1
2002,Teruel,44203,Salcedillo,0,1,-1
2002,Teruel,44204,Saldón,0,1,-1
2002,Teruel,44205,Samper de Calanda,8,15,-7
2002,Teruel,44206,San Agustín,0,5,-5
2002,Teruel,44207,San Martín del Río,0,2,-2
2002,Teruel,44208,Santa Cruz de Nogueras,0,0,0
2002,Teruel,44209,Santa Eulalia,5,20,-15
2002,Teruel,44210,Sarrión,2,20,-18
2002,Teruel,44213,Singra,0,2,-2
2002,Teruel,44215,Terriente,1,6,-5
2002,Teruel,44216,Teruel,287,340,-53
2002,Teruel,44219,Tornos,0,3,-3
2002,Teruel,44220,Torralba de los Sisones,0,2,-2
2002,Teruel,44224,Torre de las Arcas,0,2,-2
2002,Teruel,44225,Torre del Compte,0,7,-7
2002,Teruel,44227,Torre los Negros,0,3,-3
2002,Teruel,44221,Torrecilla de Alcañiz,3,7,-4
2002,Teruel,44222,Torrecilla del Rebollar,0,7,-7
2002,Teruel,44226,Torrelacárcel,0,5,-5
2002,Teruel,44228,Torremocha de Jiloca,0,4,-4
2002,Teruel,44229,Torres de Albarracín,1,3,-2
2002,Teruel,44230,Torrevelilla,0,1,-1
2002,Teruel,44231,Torrijas,0,1,-1
2002,Teruel,44232,Torrijo del Campo,0,5,-5
2002,Teruel,44234,Tramacastiel,1,0,1
2002,Teruel,44235,Tramacastilla,0,3,-3
2002,Teruel,44236,Tronchón,0,1,-1
2002,Teruel,44237,Urrea de Gaén,4,8,-4
2002,Teruel,44238,Utrillas,25,29,-4
2002,Teruel,44240,Valbona,0,2,-2
2002,Teruel,44241,Valdealgorfa,4,14,-10
2002,Teruel,44243,Valdecuenca,0,3,-3
2002,Teruel,44244,Valdelinares,0,2,-2
2002,Teruel,44245,Valdeltormo,0,3,-3
2002,Teruel,44246,Valderrobres,14,21,-7
2002,Teruel,44247,Valjunquera,0,4,-4
2002,Teruel,44251,Villafranca del Campo,1,5,-4
2002,Teruel,44252,Villahermosa del Campo,2,2,0
2002,Teruel,44257,Villar del Cobo,1,1,0
2002,Teruel,44258,Villar del Salz,1,1,0
2002,Teruel,44260,Villarluengo,2,3,-1
2002,Teruel,44261,Villarquemado,3,11,-8
2002,Teruel,44262,Villarroya de los Pinares,1,2,-1
2002,Teruel,44263,Villastar,1,4,-3
2002,Teruel,44264,Villel,0,5,-5
2002,Teruel,44265,Vinaceite,0,5,-5
2002,Teruel,44266,Visiedo,0,3,-3
2002,Teruel,44267,Vivel del Río Martín,0,2,-2
2001,Teruel,44001,Ababuj,1,1,0
2001,Teruel,44002,Abejuela,0,1,-1
2001,Teruel,44003,Aguatón,0,1,-1
2001,Teruel,44004,Aguaviva,3,10,-7
2001,Teruel,44005,Aguilar del Alfambra,0,0,0
2001,Teruel,44006,Alacón,4,4,0
2001,Teruel,44007,Alba,1,1,0
2001,Teruel,44008,Albalate del Arzobispo,15,30,-15
2001,Teruel,44009,Albarracín,11,15,-4
2001,Teruel,44010,Albentosa,2,1,1
2001,Teruel,44012,Alcalá de la Selva,5,12,-7
2001,Teruel,44013,Alcañiz,149,168,-19
2001,Teruel,44014,Alcorisa,38,30,8
2001,Teruel,44016,Alfambra,0,9,-9
2001,Teruel,44017,Aliaga,3,7,-4
2001,Teruel,44021,Allepuz,1,2,-1
2001,Teruel,44022,Alloza,2,17,-15
2001,Teruel,44018,Almohaja,0,1,-1
2001,Teruel,44019,Alobras,0,3,-3
2001,Teruel,44020,Alpeñés,1,0,1
2001,Teruel,44025,Andorra,68,59,9
2001,Teruel,44026,Arcos de las Salinas,0,1,-1
2001,Teruel,44027,Arens de Lledó,1,8,-7
2001,Teruel,44028,Argente,0,2,-2
2001,Teruel,44029,Ariño,3,10,-7
2001,Teruel,44031,Azaila,0,2,-2
2001,Teruel,44035,Barrachina,0,1,-1
2001,Teruel,44034,Bañón,1,3,-2
2001,Teruel,44037,Beceite,5,10,-5
2001,Teruel,44039,Bello,4,4,0
2001,Teruel,44038,Belmonte de San José,2,3,-1
2001,Teruel,44040,Berge,3,1,2
2001,Teruel,44042,Blancas,1,2,-1
2001,Teruel,44043,Blesa,0,1,-1
2001,Teruel,44044,Bordón,1,1,0
2001,Teruel,44045,Bronchales,3,7,-4
2001,Teruel,44046,Bueña,0,1,-1
2001,Teruel,44047,Burbáguena,1,5,-4
2001,Teruel,44032,Bádenas,0,2,-2
2001,Teruel,44033,Báguena,5,8,-3
2001,Teruel,44048,Cabra de Mora,0,1,-1
2001,Teruel,44049,Calaceite,5,11,-6
2001,Teruel,44050,Calamocha,27,37,-10
2001,Teruel,44051,Calanda,35,45,-10
2001,Teruel,44052,Calomarde,0,1,-1
2001,Teruel,44054,Camarena de la Sierra,1,2,-1
2001,Teruel,44055,Camarillas,0,3,-3
2001,Teruel,44053,Camañas,1,2,-1
2001,Teruel,44056,Caminreal,1,13,-12
2001,Teruel,44059,Cantavieja,6,13,-7
2001,Teruel,44064,Cascante del Río,0,0,0
2001,Teruel,44065,Castejón de Tornos,1,3,-2
2001,Teruel,44066,Castel de Cabra,0,1,-1
2001,Teruel,44070,Castellar (El),0,1,-1
2001,Teruel,44071,Castellote,2,12,-10
2001,Teruel,44067,Castelnou,1,0,1
2001,Teruel,44068,Castelserás,5,13,-8
2001,Teruel,44060,Cañada de Benatanduz,0,1,-1
2001,Teruel,44061,Cañada de Verich (La),3,1,2
2001,Teruel,44062,Cañada Vellida,0,1,-1
2001,Teruel,44063,Cañizar del Olivar,0,1,-1
2001,Teruel,44074,Cedrillas,1,11,-10
2001,Teruel,44075,Celadas,3,4,-1
2001,Teruel,44076,Cella,7,40,-33
2001,Teruel,44080,Codoñera (La),0,4,-4
2001,Teruel,44082,Corbalán,0,1,-1
2001,Teruel,44085,Cosa,1,1,0
2001,Teruel,44086,Cretas,4,7,-3
2001,Teruel,44087,Crivillén,0,3,-3
2001,Teruel,44088,Cuba (La),0,4,-4
2001,Teruel,44089,Cubla,0,3,-3
2001,Teruel,44090,Cucalón,0,1,-1
2001,Teruel,44092,Cuervo (El),0,1,-1
2001,Teruel,44093,Cuevas de Almudén,1,3,-2
2001,Teruel,44094,Cuevas Labradas,0,5,-5
2001,Teruel,44096,Ejulve,1,2,-1
2001,Teruel,44097,Escorihuela,0,3,-3
2001,Teruel,44099,Escucha,13,11,2
2001,Teruel,44100,Estercuel,1,9,-8
2001,Teruel,44101,Ferreruela de Huerva,0,1,-1
2001,Teruel,44103,Formiche Alto,2,2,0
2001,Teruel,44106,Fortanete,2,2,0
2001,Teruel,44107,Foz-Calanda,1,1,0
2001,Teruel,44108,Fresneda (La),0,3,-3
2001,Teruel,44109,Frías de Albarracín,1,3,-2
2001,Teruel,44110,Fuenferrada,0,1,-1
2001,Teruel,44111,Fuentes Calientes,0,2,-2
2001,Teruel,44112,Fuentes Claras,2,9,-7
2001,Teruel,44113,Fuentes de Rubielos,2,0,2
2001,Teruel,44114,Fuentespalda,1,4,-3
2001,Teruel,44105,Fórnoles,0,4,-4
2001,Teruel,44115,Galve,4,2,2
2001,Teruel,44116,Gargallo,2,1,1
2001,Teruel,44117,Gea de Albarracín,1,7,-6
2001,Teruel,44118,Ginebrosa (La),3,5,-2
2001,Teruel,44119,Griegos,0,0,0
2001,Teruel,44120,Guadalaviar,1,3,-2
2001,Teruel,44121,Gúdar,0,1,-1
2001,Teruel,44123,Hinojosa de Jarque,2,1,1
2001,Teruel,44124,Hoz de la Vieja (La),0,2,-2
2001,Teruel,44122,Híjar,17,31,-14
2001,Teruel,44126,Iglesuela del Cid (La),5,5,0
2001,Teruel,44128,Jarque de la Val,0,2,-2
2001,Teruel,44129,Jatiel,0,1,-1
2001,Teruel,44130,Jorcas,0,1,-1
2001,Teruel,44131,Josa,0,1,-1
2001,Teruel,44132,Lagueruela,0,2,-2
2001,Teruel,44135,Libros,1,4,-3
2001,Teruel,44136,Lidón,0,2,-2
2001,Teruel,44137,Linares de Mora,2,1,1
2001,Teruel,44141,Lledó,1,1,0
2001,Teruel,44138,Loscos,0,2,-2
2001,Teruel,44143,Manzanera,3,6,-3
2001,Teruel,44144,Martín del Río,3,5,-2
2001,Teruel,44145,Mas de las Matas,5,25,-20
2001,Teruel,44147,Mazaleón,5,7,-2
2001,Teruel,44148,Mezquita de Jarque,1,1,0
2001,Teruel,44149,Mirambel,0,1,-1
2001,Teruel,44150,Miravete de la Sierra,0,1,-1
2001,Teruel,44151,Molinos,0,5,-5
2001,Teruel,44153,Monreal del Campo,23,21,2
2001,Teruel,44154,Monroyo,0,4,-4
2001,Teruel,44155,Montalbán,10,14,-4
2001,Teruel,44157,Monterde de Albarracín,0,1,-1
2001,Teruel,44158,Mora de Rubielos,13,23,-10
2001,Teruel,44160,Mosqueruela,5,9,-4
2001,Teruel,44161,Muniesa,4,13,-9
2001,Teruel,44163,Noguera de Albarracín,0,1,-1
2001,Teruel,44165,Nogueruelas,0,4,-4
2001,Teruel,44167,Obón,0,1,-1
2001,Teruel,44168,Odón,1,4,-3
2001,Teruel,44169,Ojos Negros,0,5,-5
2001,Teruel,44171,Olba,0,2,-2
2001,Teruel,44172,Oliete,1,7,-6
2001,Teruel,44173,Olmos (Los),3,2,1
2001,Teruel,44174,Orihuela del Tremedal,7,9,-2
2001,Teruel,44176,Palomar de Arroyos,1,0,1
2001,Teruel,44177,Pancrudo,0,5,-5
2001,Teruel,44178,Parras de Castellote (Las),0,3,-3
2001,Teruel,44180,Peracense,0,1,-1
2001,Teruel,44181,Peralejos,0,2,-2
2001,Teruel,44182,Perales del Alfambra,1,2,-1
2001,Teruel,44179,Peñarroya de Tastavins,5,4,1
2001,Teruel,44183,Pitarque,2,0,2
2001,Teruel,44184,Plou,0,1,-1
2001,Teruel,44185,Pobo (El),0,1,-1
2001,Teruel,44187,Portellada (La),0,8,-8
2001,Teruel,44189,Pozondón,0,1,-1
2001,Teruel,44190,Pozuel del Campo,0,3,-3
2001,Teruel,44191,Puebla de Híjar (La),0,11,-11
2001,Teruel,44192,Puebla de Valverde (La),4,1,3
2001,Teruel,44193,Puertomingalvo,0,0,0
2001,Teruel,44195,Rillo,1,1,0
2001,Teruel,44196,Riodeva,1,4,-3
2001,Teruel,44198,Royuela,3,5,-2
2001,Teruel,44200,Rubielos de la Cérida,0,3,-3
2001,Teruel,44201,Rubielos de Mora,4,9,-5
2001,Teruel,44194,Ráfales,0,3,-3
2001,Teruel,44197,Ródenas,0,2,-2
2001,Teruel,44204,Saldón,0,4,-4
2001,Teruel,44205,Samper de Calanda,6,17,-11
2001,Teruel,44206,San Agustín,1,1,0
2001,Teruel,44207,San Martín del Río,0,3,-3
2001,Teruel,44208,Santa Cruz de Nogueras,0,1,-1
2001,Teruel,44209,Santa Eulalia,3,10,-7
2001,Teruel,44210,Sarrión,3,17,-14
2001,Teruel,44211,Segura de los Baños,0,2,-2
2001,Teruel,44212,Seno,0,1,-1
2001,Teruel,44213,Singra,1,3,-2
2001,Teruel,44215,Terriente,0,1,-1
2001,Teruel,44216,Teruel,301,348,-47
2001,Teruel,44217,Toril y Masegoso,0,0,0
2001,Teruel,44219,Tornos,0,1,-1
2001,Teruel,44220,Torralba de los Sisones,0,2,-2
2001,Teruel,44224,Torre de las Arcas,0,1,-1
2001,Teruel,44225,Torre del Compte,0,1,-1
2001,Teruel,44227,Torre los Negros,0,1,-1
2001,Teruel,44221,Torrecilla de Alcañiz,1,1,0
2001,Teruel,44222,Torrecilla del Rebollar,1,1,0
2001,Teruel,44226,Torrelacárcel,1,4,-3
2001,Teruel,44229,Torres de Albarracín,0,1,-1
2001,Teruel,44230,Torrevelilla,0,4,-4
2001,Teruel,44231,Torrijas,0,1,-1
2001,Teruel,44232,Torrijo del Campo,3,3,0
2001,Teruel,44234,Tramacastiel,0,2,-2
2001,Teruel,44235,Tramacastilla,0,1,-1
2001,Teruel,44236,Tronchón,1,1,0
2001,Teruel,44237,Urrea de Gaén,3,9,-6
2001,Teruel,44238,Utrillas,20,27,-7
2001,Teruel,44240,Valbona,2,3,-1
2001,Teruel,44241,Valdealgorfa,3,11,-8
2001,Teruel,44243,Valdecuenca,0,1,-1
2001,Teruel,44244,Valdelinares,2,1,1
2001,Teruel,44245,Valdeltormo,1,7,-6
2001,Teruel,44246,Valderrobres,15,21,-6
2001,Teruel,44247,Valjunquera,4,9,-5
2001,Teruel,44249,Vallecillo (El),0,1,-1
2001,Teruel,44251,Villafranca del Campo,3,2,1
2001,Teruel,44252,Villahermosa del Campo,0,1,-1
2001,Teruel,44256,Villanueva del Rebollar de la Sierra,2,1,1
2001,Teruel,44257,Villar del Cobo,1,2,-1
2001,Teruel,44258,Villar del Salz,1,2,-1
2001,Teruel,44260,Villarluengo,0,1,-1
2001,Teruel,44261,Villarquemado,6,13,-7
2001,Teruel,44262,Villarroya de los Pinares,3,0,3
2001,Teruel,44263,Villastar,2,6,-4
2001,Teruel,44264,Villel,1,2,-1
2001,Teruel,44265,Vinaceite,1,4,-3
2001,Teruel,44266,Visiedo,1,4,-3
2001,Teruel,44267,Vivel del Río Martín,0,4,-4
2000,Teruel,44002,Abejuela,0,2,-2
2000,Teruel,44004,Aguaviva,5,7,-2
2000,Teruel,44005,Aguilar del Alfambra,1,0,1
2000,Teruel,44006,Alacón,1,4,-3
2000,Teruel,44007,Alba,0,4,-4
2000,Teruel,44008,Albalate del Arzobispo,11,38,-27
2000,Teruel,44009,Albarracín,14,18,-4
2000,Teruel,44010,Albentosa,4,1,3
2000,Teruel,44011,Alcaine,0,2,-2
2000,Teruel,44012,Alcalá de la Selva,1,4,-3
2000,Teruel,44013,Alcañiz,137,140,-3
2000,Teruel,44014,Alcorisa,27,37,-10
2000,Teruel,44016,Alfambra,2,11,-9
2000,Teruel,44017,Aliaga,2,9,-7
2000,Teruel,44021,Allepuz,0,2,-2
2000,Teruel,44022,Alloza,4,15,-11
2000,Teruel,44025,Andorra,68,67,1
2000,Teruel,44026,Arcos de las Salinas,0,2,-2
2000,Teruel,44027,Arens de Lledó,0,0,0
2000,Teruel,44028,Argente,2,0,2
2000,Teruel,44029,Ariño,7,18,-11
2000,Teruel,44031,Azaila,0,3,-3
2000,Teruel,44035,Barrachina,1,4,-3
2000,Teruel,44034,Bañón,1,2,-1
2000,Teruel,44036,Bea,0,1,-1
2000,Teruel,44037,Beceite,2,6,-4
2000,Teruel,44039,Bello,0,10,-10
2000,Teruel,44038,Belmonte de San José,1,2,-1
2000,Teruel,44040,Berge,1,1,0
2000,Teruel,44041,Bezas,0,4,-4
2000,Teruel,44042,Blancas,0,4,-4
2000,Teruel,44043,Blesa,0,3,-3
2000,Teruel,44044,Bordón,3,1,2
2000,Teruel,44045,Bronchales,0,7,-7
2000,Teruel,44046,Bueña,0,1,-1
2000,Teruel,44047,Burbáguena,1,11,-10
2000,Teruel,44033,Báguena,2,11,-9
2000,Teruel,44049,Calaceite,3,16,-13
2000,Teruel,44050,Calamocha,30,32,-2
2000,Teruel,44051,Calanda,24,43,-19
2000,Teruel,44054,Camarena de la Sierra,3,1,2
2000,Teruel,44055,Camarillas,1,2,-1
2000,Teruel,44053,Camañas,1,2,-1
2000,Teruel,44056,Caminreal,3,9,-6
2000,Teruel,44059,Cantavieja,7,9,-2
2000,Teruel,44064,Cascante del Río,0,5,-5
2000,Teruel,44065,Castejón de Tornos,0,1,-1
2000,Teruel,44066,Castel de Cabra,0,3,-3
2000,Teruel,44070,Castellar (El),1,2,-1
2000,Teruel,44071,Castellote,1,8,-7
2000,Teruel,44067,Castelnou,0,0,0
2000,Teruel,44068,Castelserás,9,12,-3
2000,Teruel,44060,Cañada de Benatanduz,0,1,-1
2000,Teruel,44061,Cañada de Verich (La),2,1,1
2000,Teruel,44062,Cañada Vellida,0,2,-2
2000,Teruel,44063,Cañizar del Olivar,0,5,-5
2000,Teruel,44074,Cedrillas,6,9,-3
2000,Teruel,44075,Celadas,1,11,-10
2000,Teruel,44076,Cella,21,29,-8
2000,Teruel,44077,Cerollera (La),0,1,-1
2000,Teruel,44080,Codoñera (La),4,5,-1
2000,Teruel,44082,Corbalán,0,4,-4
2000,Teruel,44085,Cosa,0,3,-3
2000,Teruel,44086,Cretas,2,12,-10
2000,Teruel,44087,Crivillén,0,1,-1
2000,Teruel,44088,Cuba (La),1,2,-1
2000,Teruel,44089,Cubla,0,2,-2
2000,Teruel,44090,Cucalón,0,1,-1
2000,Teruel,44092,Cuervo (El),0,2,-2
2000,Teruel,44093,Cuevas de Almudén,1,0,1
2000,Teruel,44094,Cuevas Labradas,0,4,-4
2000,Teruel,44096,Ejulve,2,8,-6
2000,Teruel,44097,Escorihuela,0,5,-5
2000,Teruel,44099,Escucha,9,5,4
2000,Teruel,44100,Estercuel,0,5,-5
2000,Teruel,44101,Ferreruela de Huerva,0,1,-1
2000,Teruel,44103,Formiche Alto,4,4,0
2000,Teruel,44106,Fortanete,1,1,0
2000,Teruel,44107,Foz-Calanda,3,1,2
2000,Teruel,44108,Fresneda (La),4,9,-5
2000,Teruel,44109,Frías de Albarracín,0,1,-1
2000,Teruel,44111,Fuentes Calientes,0,1,-1
2000,Teruel,44112,Fuentes Claras,2,5,-3
2000,Teruel,44113,Fuentes de Rubielos,1,2,-1
2000,Teruel,44114,Fuentespalda,0,7,-7
2000,Teruel,44105,Fórnoles,0,3,-3
2000,Teruel,44115,Galve,0,3,-3
2000,Teruel,44116,Gargallo,0,1,-1
2000,Teruel,44117,Gea de Albarracín,2,8,-6
2000,Teruel,44118,Ginebrosa (La),4,5,-1
2000,Teruel,44120,Guadalaviar,3,4,-1
2000,Teruel,44121,Gúdar,1,0,1
2000,Teruel,44124,Hoz de la Vieja (La),0,1,-1
2000,Teruel,44125,Huesa del Común,0,3,-3
2000,Teruel,44122,Híjar,15,32,-17
2000,Teruel,44126,Iglesuela del Cid (La),2,5,-3
2000,Teruel,44127,Jabaloyas,0,4,-4
2000,Teruel,44129,Jatiel,0,3,-3
2000,Teruel,44130,Jorcas,0,2,-2
2000,Teruel,44132,Lagueruela,0,4,-4
2000,Teruel,44135,Libros,0,4,-4
2000,Teruel,44136,Lidón,0,1,-1
2000,Teruel,44137,Linares de Mora,0,3,-3
2000,Teruel,44141,Lledó,0,3,-3
2000,Teruel,44138,Loscos,0,5,-5
2000,Teruel,44143,Manzanera,4,5,-1
2000,Teruel,44144,Martín del Río,3,9,-6
2000,Teruel,44145,Mas de las Matas,8,29,-21
2000,Teruel,44146,Mata de los Olmos (La),0,2,-2
2000,Teruel,44147,Mazaleón,2,5,-3
2000,Teruel,44149,Mirambel,0,1,-1
2000,Teruel,44150,Miravete de la Sierra,0,0,0
2000,Teruel,44151,Molinos,3,4,-1
2000,Teruel,44152,Monforte de Moyuela,0,4,-4
2000,Teruel,44153,Monreal del Campo,28,19,9
2000,Teruel,44154,Monroyo,3,2,1
2000,Teruel,44155,Montalbán,9,18,-9
2000,Teruel,44156,Monteagudo del Castillo,1,2,-1
2000,Teruel,44157,Monterde de Albarracín,0,1,-1
2000,Teruel,44158,Mora de Rubielos,10,18,-8
2000,Teruel,44159,Moscardón,0,2,-2
2000,Teruel,44160,Mosqueruela,5,6,-1
2000,Teruel,44161,Muniesa,7,11,-4
2000,Teruel,44163,Noguera de Albarracín,0,1,-1
2000,Teruel,44164,Nogueras,0,1,-1
2000,Teruel,44165,Nogueruelas,2,5,-3
2000,Teruel,44168,Odón,5,1,4
2000,Teruel,44169,Ojos Negros,2,8,-6
2000,Teruel,44171,Olba,1,2,-1
2000,Teruel,44172,Oliete,5,19,-14
2000,Teruel,44173,Olmos (Los),3,1,2
2000,Teruel,44174,Orihuela del Tremedal,2,2,0
2000,Teruel,44175,Orrios,0,1,-1
2000,Teruel,44176,Palomar de Arroyos,2,3,-1
2000,Teruel,44177,Pancrudo,1,2,-1
2000,Teruel,44178,Parras de Castellote (Las),0,1,-1
2000,Teruel,44180,Peracense,0,1,-1
2000,Teruel,44181,Peralejos,0,1,-1
2000,Teruel,44182,Perales del Alfambra,3,3,0
2000,Teruel,44179,Peñarroya de Tastavins,3,6,-3
2000,Teruel,44183,Pitarque,0,1,-1
2000,Teruel,44184,Plou,0,2,-2
2000,Teruel,44185,Pobo (El),0,5,-5
2000,Teruel,44187,Portellada (La),0,5,-5
2000,Teruel,44189,Pozondón,0,1,-1
2000,Teruel,44190,Pozuel del Campo,0,3,-3
2000,Teruel,44191,Puebla de Híjar (La),6,18,-12
2000,Teruel,44192,Puebla de Valverde (La),2,7,-5
2000,Teruel,44193,Puertomingalvo,0,1,-1
2000,Teruel,44196,Riodeva,2,2,0
2000,Teruel,44198,Royuela,0,1,-1
2000,Teruel,44200,Rubielos de la Cérida,0,3,-3
2000,Teruel,44201,Rubielos de Mora,9,7,2
2000,Teruel,44194,Ráfales,0,7,-7
2000,Teruel,44197,Ródenas,0,1,-1
2000,Teruel,44204,Saldón,0,3,-3
2000,Teruel,44205,Samper de Calanda,3,11,-8
2000,Teruel,44206,San Agustín,1,4,-3
2000,Teruel,44207,San Martín del Río,0,8,-8
2000,Teruel,44209,Santa Eulalia,2,21,-19
2000,Teruel,44210,Sarrión,7,15,-8
2000,Teruel,44211,Segura de los Baños,0,1,-1
2000,Teruel,44213,Singra,1,2,-1
2000,Teruel,44215,Terriente,0,3,-3
2000,Teruel,44216,Teruel,353,321,32
2000,Teruel,44217,Toril y Masegoso,0,1,-1
2000,Teruel,44218,Tormón,0,1,-1
2000,Teruel,44219,Tornos,0,5,-5
2000,Teruel,44220,Torralba de los Sisones,2,0,2
2000,Teruel,44223,Torre de Arcas,0,1,-1
2000,Teruel,44227,Torre los Negros,0,1,-1
2000,Teruel,44221,Torrecilla de Alcañiz,5,1,4
2000,Teruel,44222,Torrecilla del Rebollar,0,4,-4
2000,Teruel,44226,Torrelacárcel,0,2,-2
2000,Teruel,44228,Torremocha de Jiloca,0,1,-1
2000,Teruel,44229,Torres de Albarracín,1,3,-2
2000,Teruel,44230,Torrevelilla,1,1,0
2000,Teruel,44231,Torrijas,0,1,-1
2000,Teruel,44232,Torrijo del Campo,2,10,-8
2000,Teruel,44234,Tramacastiel,0,5,-5
2000,Teruel,44235,Tramacastilla,2,1,1
2000,Teruel,44236,Tronchón,1,1,0
2000,Teruel,44237,Urrea de Gaén,0,11,-11
2000,Teruel,44238,Utrillas,27,22,5
2000,Teruel,44239,Valacloche,0,1,-1
2000,Teruel,44240,Valbona,0,2,-2
2000,Teruel,44241,Valdealgorfa,5,13,-8
2000,Teruel,44244,Valdelinares,2,5,-3
2000,Teruel,44245,Valdeltormo,5,9,-4
2000,Teruel,44246,Valderrobres,24,24,0
2000,Teruel,44247,Valjunquera,1,8,-7
2000,Teruel,44249,Vallecillo (El),0,1,-1
2000,Teruel,44251,Villafranca del Campo,1,11,-10
2000,Teruel,44256,Villanueva del Rebollar de la Sierra,1,1,0
2000,Teruel,44257,Villar del Cobo,2,1,1
2000,Teruel,44258,Villar del Salz,1,2,-1
2000,Teruel,44260,Villarluengo,1,1,0
2000,Teruel,44261,Villarquemado,9,13,-4
2000,Teruel,44262,Villarroya de los Pinares,1,2,-1
2000,Teruel,44263,Villastar,4,6,-2
2000,Teruel,44264,Villel,2,3,-1
2000,Teruel,44265,Vinaceite,0,8,-8
2000,Teruel,44266,Visiedo,0,4,-4
2000,Teruel,44267,Vivel del Río Martín,0,2,-2
1999,Teruel,44001,Ababuj,0,1,-1
1999,Teruel,44004,Aguaviva,3,9,-6
1999,Teruel,44006,Alacón,2,7,-5
1999,Teruel,44007,Alba,0,6,-6
1999,Teruel,44008,Albalate del Arzobispo,8,31,-23
1999,Teruel,44009,Albarracín,7,11,-4
1999,Teruel,44010,Albentosa,1,1,0
1999,Teruel,44011,Alcaine,1,0,1
1999,Teruel,44012,Alcalá de la Selva,5,9,-4
1999,Teruel,44013,Alcañiz,121,185,-64
1999,Teruel,44014,Alcorisa,28,41,-13
1999,Teruel,44016,Alfambra,3,5,-2
1999,Teruel,44017,Aliaga,3,10,-7
1999,Teruel,44021,Allepuz,2,4,-2
1999,Teruel,44022,Alloza,3,13,-10
1999,Teruel,44018,Almohaja,0,1,-1
1999,Teruel,44024,Anadón,0,1,-1
1999,Teruel,44025,Andorra,64,61,3
1999,Teruel,44026,Arcos de las Salinas,0,6,-6
1999,Teruel,44027,Arens de Lledó,0,4,-4
1999,Teruel,44028,Argente,0,3,-3
1999,Teruel,44029,Ariño,4,9,-5
1999,Teruel,44031,Azaila,0,1,-1
1999,Teruel,44035,Barrachina,0,1,-1
1999,Teruel,44034,Bañón,1,1,0
1999,Teruel,44037,Beceite,6,13,-7
1999,Teruel,44039,Bello,2,5,-3
1999,Teruel,44038,Belmonte de San José,0,4,-4
1999,Teruel,44040,Berge,3,2,1
1999,Teruel,44041,Bezas,0,1,-1
1999,Teruel,44042,Blancas,1,8,-7
1999,Teruel,44043,Blesa,1,3,-2
1999,Teruel,44044,Bordón,1,4,-3
1999,Teruel,44045,Bronchales,1,3,-2
1999,Teruel,44046,Bueña,0,2,-2
1999,Teruel,44047,Burbáguena,1,16,-15
1999,Teruel,44033,Báguena,1,7,-6
1999,Teruel,44048,Cabra de Mora,1,3,-2
1999,Teruel,44049,Calaceite,5,17,-12
1999,Teruel,44050,Calamocha,35,52,-17
1999,Teruel,44051,Calanda,16,44,-28
1999,Teruel,44054,Camarena de la Sierra,0,3,-3
1999,Teruel,44055,Camarillas,1,2,-1
1999,Teruel,44053,Camañas,1,1,0
1999,Teruel,44056,Caminreal,1,11,-10
1999,Teruel,44059,Cantavieja,6,6,0
1999,Teruel,44064,Cascante del Río,0,3,-3
1999,Teruel,44065,Castejón de Tornos,1,2,-1
1999,Teruel,44066,Castel de Cabra,1,0,1
1999,Teruel,44071,Castellote,6,10,-4
1999,Teruel,44067,Castelnou,0,1,-1
1999,Teruel,44068,Castelserás,7,13,-6
1999,Teruel,44060,Cañada de Benatanduz,0,0,0
1999,Teruel,44061,Cañada de Verich (La),1,2,-1
1999,Teruel,44062,Cañada Vellida,0,1,-1
1999,Teruel,44063,Cañizar del Olivar,0,1,-1
1999,Teruel,44074,Cedrillas,3,5,-2
1999,Teruel,44075,Celadas,6,7,-1
1999,Teruel,44076,Cella,13,31,-18
1999,Teruel,44077,Cerollera (La),1,0,1
1999,Teruel,44080,Codoñera (La),3,9,-6
1999,Teruel,44082,Corbalán,1,0,1
1999,Teruel,44084,Cortes de Aragón,0,2,-2
1999,Teruel,44085,Cosa,1,1,0
1999,Teruel,44086,Cretas,1,10,-9
1999,Teruel,44088,Cuba (La),0,1,-1
1999,Teruel,44089,Cubla,0,2,-2
1999,Teruel,44090,Cucalón,0,1,-1
1999,Teruel,44092,Cuervo (El),0,4,-4
1999,Teruel,44093,Cuevas de Almudén,2,1,1
1999,Teruel,44094,Cuevas Labradas,0,2,-2
1999,Teruel,44096,Ejulve,1,1,0
1999,Teruel,44097,Escorihuela,0,1,-1
1999,Teruel,44099,Escucha,10,11,-1
1999,Teruel,44100,Estercuel,1,0,1
1999,Teruel,44103,Formiche Alto,4,2,2
1999,Teruel,44106,Fortanete,1,4,-3
1999,Teruel,44107,Foz-Calanda,3,2,1
1999,Teruel,44108,Fresneda (La),1,10,-9
1999,Teruel,44109,Frías de Albarracín,0,3,-3
1999,Teruel,44112,Fuentes Claras,5,10,-5
1999,Teruel,44113,Fuentes de Rubielos,3,1,2
1999,Teruel,44114,Fuentespalda,1,4,-3
1999,Teruel,44105,Fórnoles,0,2,-2
1999,Teruel,44115,Galve,1,1,0
1999,Teruel,44116,Gargallo,3,4,-1
1999,Teruel,44117,Gea de Albarracín,1,4,-3
1999,Teruel,44118,Ginebrosa (La),1,1,0
1999,Teruel,44119,Griegos,1,1,0
1999,Teruel,44120,Guadalaviar,1,2,-1
1999,Teruel,44123,Hinojosa de Jarque,0,2,-2
1999,Teruel,44124,Hoz de la Vieja (La),0,3,-3
1999,Teruel,44125,Huesa del Común,0,2,-2
1999,Teruel,44122,Híjar,11,28,-17
1999,Teruel,44126,Iglesuela del Cid (La),3,7,-4
1999,Teruel,44127,Jabaloyas,0,2,-2
1999,Teruel,44128,Jarque de la Val,0,1,-1
1999,Teruel,44129,Jatiel,0,1,-1
1999,Teruel,44130,Jorcas,0,1,-1
1999,Teruel,44131,Josa,0,1,-1
1999,Teruel,44135,Libros,0,2,-2
1999,Teruel,44136,Lidón,0,2,-2
1999,Teruel,44137,Linares de Mora,1,4,-3
1999,Teruel,44141,Lledó,1,3,-2
1999,Teruel,44138,Loscos,0,2,-2
1999,Teruel,44143,Manzanera,5,6,-1
1999,Teruel,44144,Martín del Río,8,3,5
1999,Teruel,44145,Mas de las Matas,10,25,-15
1999,Teruel,44146,Mata de los Olmos (La),2,6,-4
1999,Teruel,44147,Mazaleón,6,11,-5
1999,Teruel,44149,Mirambel,0,3,-3
1999,Teruel,44151,Molinos,1,3,-2
1999,Teruel,44152,Monforte de Moyuela,0,5,-5
1999,Teruel,44153,Monreal del Campo,16,24,-8
1999,Teruel,44154,Monroyo,4,9,-5
1999,Teruel,44155,Montalbán,9,12,-3
1999,Teruel,44156,Monteagudo del Castillo,0,1,-1
1999,Teruel,44157,Monterde de Albarracín,0,2,-2
1999,Teruel,44158,Mora de Rubielos,8,18,-10
1999,Teruel,44159,Moscardón,0,0,0
1999,Teruel,44160,Mosqueruela,5,9,-4
1999,Teruel,44161,Muniesa,6,16,-10
1999,Teruel,44163,Noguera de Albarracín,0,4,-4
1999,Teruel,44164,Nogueras,0,1,-1
1999,Teruel,44165,Nogueruelas,1,7,-6
1999,Teruel,44167,Obón,0,2,-2
1999,Teruel,44168,Odón,0,2,-2
1999,Teruel,44169,Ojos Negros,1,8,-7
1999,Teruel,44171,Olba,1,4,-3
1999,Teruel,44172,Oliete,1,8,-7
1999,Teruel,44173,Olmos (Los),0,2,-2
1999,Teruel,44174,Orihuela del Tremedal,5,13,-8
1999,Teruel,44175,Orrios,1,2,-1
1999,Teruel,44176,Palomar de Arroyos,1,4,-3
1999,Teruel,44177,Pancrudo,0,4,-4
1999,Teruel,44178,Parras de Castellote (Las),0,3,-3
1999,Teruel,44180,Peracense,0,4,-4
1999,Teruel,44181,Peralejos,0,2,-2
1999,Teruel,44182,Perales del Alfambra,1,3,-2
1999,Teruel,44179,Peñarroya de Tastavins,5,12,-7
1999,Teruel,44183,Pitarque,0,3,-3
1999,Teruel,44184,Plou,0,1,-1
1999,Teruel,44185,Pobo (El),0,1,-1
1999,Teruel,44187,Portellada (La),0,4,-4
1999,Teruel,44191,Puebla de Híjar (La),4,20,-16
1999,Teruel,44192,Puebla de Valverde (La),4,13,-9
1999,Teruel,44193,Puertomingalvo,1,5,-4
1999,Teruel,44195,Rillo,1,1,0
1999,Teruel,44196,Riodeva,1,3,-2
1999,Teruel,44198,Royuela,2,4,-2
1999,Teruel,44201,Rubielos de Mora,6,12,-6
1999,Teruel,44194,Ráfales,1,3,-2
1999,Teruel,44205,Samper de Calanda,5,19,-14
1999,Teruel,44206,San Agustín,0,2,-2
1999,Teruel,44207,San Martín del Río,0,3,-3
1999,Teruel,44209,Santa Eulalia,4,22,-18
1999,Teruel,44210,Sarrión,7,12,-5
1999,Teruel,44211,Segura de los Baños,0,4,-4
1999,Teruel,44212,Seno,0,2,-2
1999,Teruel,44213,Singra,0,0,0
1999,Teruel,44215,Terriente,0,2,-2
1999,Teruel,44216,Teruel,295,348,-53
1999,Teruel,44218,Tormón,0,1,-1
1999,Teruel,44219,Tornos,0,1,-1
1999,Teruel,44220,Torralba de los Sisones,3,4,-1
1999,Teruel,44223,Torre de Arcas,0,1,-1
1999,Teruel,44225,Torre del Compte,0,1,-1
1999,Teruel,44221,Torrecilla de Alcañiz,2,9,-7
1999,Teruel,44222,Torrecilla del Rebollar,0,2,-2
1999,Teruel,44226,Torrelacárcel,1,6,-5
1999,Teruel,44228,Torremocha de Jiloca,0,2,-2
1999,Teruel,44229,Torres de Albarracín,1,2,-1
1999,Teruel,44230,Torrevelilla,3,1,2
1999,Teruel,44231,Torrijas,1,2,-1
1999,Teruel,44232,Torrijo del Campo,0,14,-14
1999,Teruel,44234,Tramacastiel,1,0,1
1999,Teruel,44235,Tramacastilla,0,1,-1
1999,Teruel,44237,Urrea de Gaén,2,8,-6
1999,Teruel,44238,Utrillas,18,22,-4
1999,Teruel,44240,Valbona,1,4,-3
1999,Teruel,44241,Valdealgorfa,2,12,-10
1999,Teruel,44244,Valdelinares,0,2,-2
1999,Teruel,44245,Valdeltormo,0,7,-7
1999,Teruel,44246,Valderrobres,12,25,-13
1999,Teruel,44247,Valjunquera,7,6,1
1999,Teruel,44249,Vallecillo (El),0,1,-1
1999,Teruel,44251,Villafranca del Campo,2,11,-9
1999,Teruel,44257,Villar del Cobo,1,2,-1
1999,Teruel,44258,Villar del Salz,1,3,-2
1999,Teruel,44260,Villarluengo,0,4,-4
1999,Teruel,44261,Villarquemado,3,18,-15
1999,Teruel,44262,Villarroya de los Pinares,2,2,0
1999,Teruel,44263,Villastar,1,6,-5
1999,Teruel,44264,Villel,1,6,-5
1999,Teruel,44265,Vinaceite,1,8,-7
1999,Teruel,44266,Visiedo,0,4,-4
1999,Teruel,44267,Vivel del Río Martín,0,2,-2
1999,Teruel,44268,Zoma (La),1,1,0
1998,Teruel,44002,Abejuela,0,1,-1
1998,Teruel,44003,Aguatón,0,1,-1
1998,Teruel,44004,Aguaviva,3,13,-10
1998,Teruel,44005,Aguilar del Alfambra,2,1,1
1998,Teruel,44006,Alacón,2,3,-1
1998,Teruel,44007,Alba,0,10,-10
1998,Teruel,44008,Albalate del Arzobispo,13,37,-24
1998,Teruel,44009,Albarracín,4,15,-11
1998,Teruel,44010,Albentosa,2,5,-3
1998,Teruel,44011,Alcaine,0,1,-1
1998,Teruel,44012,Alcalá de la Selva,1,6,-5
1998,Teruel,44013,Alcañiz,128,175,-47
1998,Teruel,44014,Alcorisa,27,30,-3
1998,Teruel,44016,Alfambra,3,8,-5
1998,Teruel,44017,Aliaga,1,9,-8
1998,Teruel,44021,Allepuz,0,1,-1
1998,Teruel,44022,Alloza,2,16,-14
1998,Teruel,44018,Almohaja,1,0,1
1998,Teruel,44020,Alpeñés,0,1,-1
1998,Teruel,44024,Anadón,0,2,-2
1998,Teruel,44025,Andorra,60,56,4
1998,Teruel,44026,Arcos de las Salinas,1,2,-1
1998,Teruel,44027,Arens de Lledó,3,6,-3
1998,Teruel,44028,Argente,0,4,-4
1998,Teruel,44029,Ariño,11,7,4
1998,Teruel,44031,Azaila,0,2,-2
1998,Teruel,44035,Barrachina,0,3,-3
1998,Teruel,44034,Bañón,1,2,-1
1998,Teruel,44036,Bea,0,2,-2
1998,Teruel,44037,Beceite,3,11,-8
1998,Teruel,44039,Bello,3,4,-1
1998,Teruel,44038,Belmonte de San José,1,4,-3
1998,Teruel,44040,Berge,1,3,-2
1998,Teruel,44041,Bezas,0,1,-1
1998,Teruel,44042,Blancas,0,3,-3
1998,Teruel,44043,Blesa,0,1,-1
1998,Teruel,44044,Bordón,2,1,1
1998,Teruel,44045,Bronchales,3,4,-1
1998,Teruel,44046,Bueña,0,1,-1
1998,Teruel,44047,Burbáguena,0,16,-16
1998,Teruel,44032,Bádenas,0,2,-2
1998,Teruel,44033,Báguena,2,9,-7
1998,Teruel,44049,Calaceite,5,24,-19
1998,Teruel,44050,Calamocha,25,48,-23
1998,Teruel,44051,Calanda,24,35,-11
1998,Teruel,44052,Calomarde,1,0,1
1998,Teruel,44054,Camarena de la Sierra,0,3,-3
1998,Teruel,44053,Camañas,0,3,-3
1998,Teruel,44056,Caminreal,3,8,-5
1998,Teruel,44059,Cantavieja,6,10,-4
1998,Teruel,44064,Cascante del Río,0,2,-2
1998,Teruel,44065,Castejón de Tornos,0,2,-2
1998,Teruel,44066,Castel de Cabra,1,1,0
1998,Teruel,44071,Castellote,7,6,1
1998,Teruel,44067,Castelnou,0,2,-2
1998,Teruel,44068,Castelserás,7,8,-1
1998,Teruel,44060,Cañada de Benatanduz,1,2,-1
1998,Teruel,44061,Cañada de Verich (La),0,3,-3
1998,Teruel,44074,Cedrillas,6,9,-3
1998,Teruel,44075,Celadas,4,2,2
1998,Teruel,44076,Cella,14,40,-26
1998,Teruel,44077,Cerollera (La),1,0,1
1998,Teruel,44080,Codoñera (La),2,5,-3
1998,Teruel,44084,Cortes de Aragón,0,1,-1
1998,Teruel,44085,Cosa,1,0,1
1998,Teruel,44086,Cretas,1,8,-7
1998,Teruel,44087,Crivillén,0,0,0
1998,Teruel,44088,Cuba (La),0,1,-1
1998,Teruel,44089,Cubla,0,2,-2
1998,Teruel,44090,Cucalón,0,2,-2
1998,Teruel,44092,Cuervo (El),0,4,-4
1998,Teruel,44093,Cuevas de Almudén,2,2,0
1998,Teruel,44094,Cuevas Labradas,1,7,-6
1998,Teruel,44096,Ejulve,4,1,3
1998,Teruel,44097,Escorihuela,0,5,-5
1998,Teruel,44099,Escucha,8,8,0
1998,Teruel,44100,Estercuel,2,7,-5
1998,Teruel,44101,Ferreruela de Huerva,0,2,-2
1998,Teruel,44103,Formiche Alto,1,4,-3
1998,Teruel,44106,Fortanete,0,4,-4
1998,Teruel,44107,Foz-Calanda,4,3,1
1998,Teruel,44108,Fresneda (La),1,10,-9
1998,Teruel,44109,Frías de Albarracín,0,3,-3
1998,Teruel,44110,Fuenferrada,0,1,-1
1998,Teruel,44111,Fuentes Calientes,0,3,-3
1998,Teruel,44112,Fuentes Claras,5,9,-4
1998,Teruel,44113,Fuentes de Rubielos,1,1,0
1998,Teruel,44114,Fuentespalda,2,8,-6
1998,Teruel,44105,Fórnoles,1,5,-4
1998,Teruel,44115,Galve,1,1,0
1998,Teruel,44116,Gargallo,0,0,0
1998,Teruel,44117,Gea de Albarracín,0,7,-7
1998,Teruel,44118,Ginebrosa (La),2,5,-3
1998,Teruel,44119,Griegos,1,2,-1
1998,Teruel,44120,Guadalaviar,4,2,2
1998,Teruel,44121,Gúdar,0,1,-1
1998,Teruel,44123,Hinojosa de Jarque,0,2,-2
1998,Teruel,44125,Huesa del Común,0,1,-1
1998,Teruel,44122,Híjar,18,31,-13
1998,Teruel,44126,Iglesuela del Cid (La),3,7,-4
1998,Teruel,44128,Jarque de la Val,0,2,-2
1998,Teruel,44130,Jorcas,0,3,-3
1998,Teruel,44131,Josa,0,1,-1
1998,Teruel,44135,Libros,2,6,-4
1998,Teruel,44136,Lidón,0,1,-1
1998,Teruel,44137,Linares de Mora,1,2,-1
1998,Teruel,44141,Lledó,1,6,-5
1998,Teruel,44138,Loscos,0,3,-3
1998,Teruel,44142,Maicas,0,1,-1
1998,Teruel,44143,Manzanera,3,13,-10
1998,Teruel,44144,Martín del Río,3,4,-1
1998,Teruel,44145,Mas de las Matas,5,21,-16
1998,Teruel,44146,Mata de los Olmos (La),2,5,-3
1998,Teruel,44147,Mazaleón,7,10,-3
1998,Teruel,44148,Mezquita de Jarque,0,6,-6
1998,Teruel,44150,Miravete de la Sierra,0,1,-1
1998,Teruel,44151,Molinos,2,5,-3
1998,Teruel,44153,Monreal del Campo,15,26,-11
1998,Teruel,44154,Monroyo,3,5,-2
1998,Teruel,44155,Montalbán,11,14,-3
1998,Teruel,44156,Monteagudo del Castillo,0,1,-1
1998,Teruel,44157,Monterde de Albarracín,0,1,-1
1998,Teruel,44158,Mora de Rubielos,7,25,-18
1998,Teruel,44160,Mosqueruela,5,16,-11
1998,Teruel,44161,Muniesa,3,13,-10
1998,Teruel,44163,Noguera de Albarracín,3,2,1
1998,Teruel,44165,Nogueruelas,0,4,-4
1998,Teruel,44168,Odón,0,2,-2
1998,Teruel,44169,Ojos Negros,1,7,-6
1998,Teruel,44171,Olba,1,2,-1
1998,Teruel,44172,Oliete,2,13,-11
1998,Teruel,44173,Olmos (Los),5,5,0
1998,Teruel,44174,Orihuela del Tremedal,5,9,-4
1998,Teruel,44176,Palomar de Arroyos,2,1,1
1998,Teruel,44177,Pancrudo,1,0,1
1998,Teruel,44178,Parras de Castellote (Las),0,1,-1
1998,Teruel,44180,Peracense,0,1,-1
1998,Teruel,44182,Perales del Alfambra,4,4,0
1998,Teruel,44179,Peñarroya de Tastavins,10,10,0
1998,Teruel,44183,Pitarque,1,1,0
1998,Teruel,44184,Plou,0,2,-2
1998,Teruel,44185,Pobo (El),0,2,-2
1998,Teruel,44187,Portellada (La),0,6,-6
1998,Teruel,44189,Pozondón,1,1,0
1998,Teruel,44190,Pozuel del Campo,0,3,-3
1998,Teruel,44191,Puebla de Híjar (La),3,19,-16
1998,Teruel,44192,Puebla de Valverde (La),4,5,-1
1998,Teruel,44195,Rillo,1,2,-1
1998,Teruel,44196,Riodeva,0,4,-4
1998,Teruel,44198,Royuela,1,3,-2
1998,Teruel,44199,Rubiales,1,0,1
1998,Teruel,44200,Rubielos de la Cérida,1,0,1
1998,Teruel,44201,Rubielos de Mora,2,11,-9
1998,Teruel,44194,Ráfales,0,4,-4
1998,Teruel,44197,Ródenas,0,2,-2
1998,Teruel,44204,Saldón,0,1,-1
1998,Teruel,44205,Samper de Calanda,4,19,-15
1998,Teruel,44206,San Agustín,0,5,-5
1998,Teruel,44207,San Martín del Río,1,6,-5
1998,Teruel,44208,Santa Cruz de Nogueras,0,1,-1
1998,Teruel,44209,Santa Eulalia,3,14,-11
1998,Teruel,44210,Sarrión,7,17,-10
1998,Teruel,44213,Singra,2,2,0
1998,Teruel,44215,Terriente,2,2,0
1998,Teruel,44216,Teruel,314,357,-43
1998,Teruel,44217,Toril y Masegoso,0,1,-1
1998,Teruel,44219,Tornos,2,4,-2
1998,Teruel,44220,Torralba de los Sisones,4,5,-1
1998,Teruel,44223,Torre de Arcas,0,3,-3
1998,Teruel,44225,Torre del Compte,0,3,-3
1998,Teruel,44227,Torre los Negros,0,2,-2
1998,Teruel,44221,Torrecilla de Alcañiz,5,5,0
1998,Teruel,44222,Torrecilla del Rebollar,0,2,-2
1998,Teruel,44226,Torrelacárcel,0,8,-8
1998,Teruel,44228,Torremocha de Jiloca,1,3,-2
1998,Teruel,44229,Torres de Albarracín,0,2,-2
1998,Teruel,44230,Torrevelilla,0,1,-1
1998,Teruel,44232,Torrijo del Campo,5,9,-4
1998,Teruel,44234,Tramacastiel,0,3,-3
1998,Teruel,44235,Tramacastilla,0,1,-1
1998,Teruel,44236,Tronchón,0,1,-1
1998,Teruel,44237,Urrea de Gaén,0,19,-19
1998,Teruel,44238,Utrillas,27,20,7
1998,Teruel,44239,Valacloche,0,3,-3
1998,Teruel,44240,Valbona,0,6,-6
1998,Teruel,44241,Valdealgorfa,4,7,-3
1998,Teruel,44243,Valdecuenca,0,3,-3
1998,Teruel,44244,Valdelinares,2,4,-2
1998,Teruel,44245,Valdeltormo,3,5,-2
1998,Teruel,44246,Valderrobres,19,25,-6
1998,Teruel,44247,Valjunquera,1,5,-4
1998,Teruel,44249,Vallecillo (El),0,1,-1
1998,Teruel,44250,Veguillas de la Sierra,0,1,-1
1998,Teruel,44251,Villafranca del Campo,3,9,-6
1998,Teruel,44252,Villahermosa del Campo,0,1,-1
1998,Teruel,44257,Villar del Cobo,1,4,-3
1998,Teruel,44260,Villarluengo,0,3,-3
1998,Teruel,44261,Villarquemado,6,9,-3
1998,Teruel,44262,Villarroya de los Pinares,2,3,-1
1998,Teruel,44263,Villastar,3,5,-2
1998,Teruel,44264,Villel,0,10,-10
1998,Teruel,44265,Vinaceite,0,3,-3
1998,Teruel,44266,Visiedo,0,5,-5
1998,Teruel,44267,Vivel del Río Martín,0,1,-1
1998,Teruel,44268,Zoma (La),0,1,-1
1997,Teruel,44001,Ababuj,1,2,-1
1997,Teruel,44002,Abejuela,0,2,-2
1997,Teruel,44004,Aguaviva,10,14,-4
1997,Teruel,44005,Aguilar del Alfambra,0,2,-2
1997,Teruel,44006,Alacón,1,9,-8
1997,Teruel,44007,Alba,0,5,-5
1997,Teruel,44008,Albalate del Arzobispo,18,36,-18
1997,Teruel,44009,Albarracín,6,18,-12
1997,Teruel,44010,Albentosa,2,5,-3
1997,Teruel,44012,Alcalá de la Selva,1,5,-4
1997,Teruel,44013,Alcañiz,138,184,-46
1997,Teruel,44014,Alcorisa,27,30,-3
1997,Teruel,44016,Alfambra,5,10,-5
1997,Teruel,44017,Aliaga,0,3,-3
1997,Teruel,44022,Alloza,0,11,-11
1997,Teruel,44018,Almohaja,0,1,-1
1997,Teruel,44019,Alobras,1,1,0
1997,Teruel,44020,Alpeñés,0,1,-1
1997,Teruel,44025,Andorra,73,53,20
1997,Teruel,44026,Arcos de las Salinas,0,3,-3
1997,Teruel,44027,Arens de Lledó,2,3,-1
1997,Teruel,44028,Argente,2,2,0
1997,Teruel,44029,Ariño,9,12,-3
1997,Teruel,44031,Azaila,0,1,-1
1997,Teruel,44035,Barrachina,0,3,-3
1997,Teruel,44034,Bañón,0,2,-2
1997,Teruel,44037,Beceite,3,13,-10
1997,Teruel,44039,Bello,4,5,-1
1997,Teruel,44038,Belmonte de San José,2,0,2
1997,Teruel,44040,Berge,1,4,-3
1997,Teruel,44041,Bezas,0,1,-1
1997,Teruel,44042,Blancas,1,3,-2
1997,Teruel,44043,Blesa,0,1,-1
1997,Teruel,44044,Bordón,1,3,-2
1997,Teruel,44045,Bronchales,2,7,-5
1997,Teruel,44046,Bueña,0,1,-1
1997,Teruel,44047,Burbáguena,0,20,-20
1997,Teruel,44033,Báguena,1,19,-18
1997,Teruel,44048,Cabra de Mora,0,2,-2
1997,Teruel,44049,Calaceite,9,9,0
1997,Teruel,44050,Calamocha,36,59,-23
1997,Teruel,44051,Calanda,31,42,-11
1997,Teruel,44052,Calomarde,0,1,-1
1997,Teruel,44054,Camarena de la Sierra,2,4,-2
1997,Teruel,44053,Camañas,0,2,-2
1997,Teruel,44056,Caminreal,7,13,-6
1997,Teruel,44059,Cantavieja,4,11,-7
1997,Teruel,44064,Cascante del Río,0,1,-1
1997,Teruel,44065,Castejón de Tornos,1,1,0
1997,Teruel,44066,Castel de Cabra,2,2,0
1997,Teruel,44070,Castellar (El),1,1,0
1997,Teruel,44071,Castellote,7,5,2
1997,Teruel,44067,Castelnou,0,1,-1
1997,Teruel,44068,Castelserás,6,15,-9
1997,Teruel,44060,Cañada de Benatanduz,0,2,-2
1997,Teruel,44061,Cañada de Verich (La),1,3,-2
1997,Teruel,44063,Cañizar del Olivar,1,0,1
1997,Teruel,44074,Cedrillas,6,6,0
1997,Teruel,44075,Celadas,3,8,-5
1997,Teruel,44076,Cella,21,37,-16
1997,Teruel,44077,Cerollera (La),0,2,-2
1997,Teruel,44080,Codoñera (La),0,3,-3
1997,Teruel,44084,Cortes de Aragón,0,2,-2
1997,Teruel,44086,Cretas,1,14,-13
1997,Teruel,44087,Crivillén,0,0,0
1997,Teruel,44088,Cuba (La),0,2,-2
1997,Teruel,44089,Cubla,0,4,-4
1997,Teruel,44090,Cucalón,0,1,-1
1997,Teruel,44092,Cuervo (El),0,5,-5
1997,Teruel,44093,Cuevas de Almudén,2,1,1
1997,Teruel,44094,Cuevas Labradas,0,2,-2
1997,Teruel,44096,Ejulve,1,4,-3
1997,Teruel,44097,Escorihuela,1,3,-2
1997,Teruel,44099,Escucha,13,7,6
1997,Teruel,44100,Estercuel,3,3,0
1997,Teruel,44101,Ferreruela de Huerva,1,2,-1
1997,Teruel,44103,Formiche Alto,4,3,1
1997,Teruel,44106,Fortanete,1,1,0
1997,Teruel,44107,Foz-Calanda,0,3,-3
1997,Teruel,44108,Fresneda (La),4,3,1
1997,Teruel,44109,Frías de Albarracín,1,0,1
1997,Teruel,44111,Fuentes Calientes,2,2,0
1997,Teruel,44112,Fuentes Claras,7,13,-6
1997,Teruel,44113,Fuentes de Rubielos,0,4,-4
1997,Teruel,44114,Fuentespalda,4,5,-1
1997,Teruel,44105,Fórnoles,0,1,-1
1997,Teruel,44115,Galve,1,1,0
1997,Teruel,44116,Gargallo,1,1,0
1997,Teruel,44117,Gea de Albarracín,6,9,-3
1997,Teruel,44118,Ginebrosa (La),0,3,-3
1997,Teruel,44119,Griegos,0,5,-5
1997,Teruel,44120,Guadalaviar,3,2,1
1997,Teruel,44121,Gúdar,0,1,-1
1997,Teruel,44123,Hinojosa de Jarque,1,4,-3
1997,Teruel,44124,Hoz de la Vieja (La),0,2,-2
1997,Teruel,44125,Huesa del Común,0,2,-2
1997,Teruel,44122,Híjar,10,36,-26
1997,Teruel,44126,Iglesuela del Cid (La),2,5,-3
1997,Teruel,44127,Jabaloyas,1,2,-1
1997,Teruel,44128,Jarque de la Val,0,2,-2
1997,Teruel,44129,Jatiel,0,1,-1
1997,Teruel,44131,Josa,0,0,0
1997,Teruel,44135,Libros,0,3,-3
1997,Teruel,44137,Linares de Mora,1,6,-5
1997,Teruel,44141,Lledó,1,5,-4
1997,Teruel,44138,Loscos,0,3,-3
1997,Teruel,44142,Maicas,0,2,-2
1997,Teruel,44143,Manzanera,6,8,-2
1997,Teruel,44144,Martín del Río,4,6,-2
1997,Teruel,44145,Mas de las Matas,11,18,-7
1997,Teruel,44146,Mata de los Olmos (La),1,4,-3
1997,Teruel,44147,Mazaleón,4,12,-8
1997,Teruel,44148,Mezquita de Jarque,1,1,0
1997,Teruel,44150,Miravete de la Sierra,0,1,-1
1997,Teruel,44151,Molinos,2,5,-3
1997,Teruel,44152,Monforte de Moyuela,0,2,-2
1997,Teruel,44153,Monreal del Campo,21,23,-2
1997,Teruel,44154,Monroyo,2,2,0
1997,Teruel,44155,Montalbán,11,24,-13
1997,Teruel,44156,Monteagudo del Castillo,0,1,-1
1997,Teruel,44157,Monterde de Albarracín,0,1,-1
1997,Teruel,44158,Mora de Rubielos,23,18,5
1997,Teruel,44159,Moscardón,0,1,-1
1997,Teruel,44160,Mosqueruela,4,9,-5
1997,Teruel,44161,Muniesa,4,15,-11
1997,Teruel,44163,Noguera de Albarracín,0,0,0
1997,Teruel,44165,Nogueruelas,1,3,-2
1997,Teruel,44167,Obón,0,1,-1
1997,Teruel,44168,Odón,1,6,-5
1997,Teruel,44169,Ojos Negros,5,10,-5
1997,Teruel,44171,Olba,0,3,-3
1997,Teruel,44172,Oliete,1,8,-7
1997,Teruel,44173,Olmos (Los),1,1,0
1997,Teruel,44174,Orihuela del Tremedal,8,5,3
1997,Teruel,44175,Orrios,0,3,-3
1997,Teruel,44176,Palomar de Arroyos,2,2,0
1997,Teruel,44177,Pancrudo,0,4,-4
1997,Teruel,44178,Parras de Castellote (Las),0,4,-4
1997,Teruel,44181,Peralejos,1,1,0
1997,Teruel,44182,Perales del Alfambra,4,4,0
1997,Teruel,44179,Peñarroya de Tastavins,4,16,-12
1997,Teruel,44183,Pitarque,1,4,-3
1997,Teruel,44185,Pobo (El),0,4,-4
1997,Teruel,44187,Portellada (La),1,8,-7
1997,Teruel,44189,Pozondón,0,1,-1
1997,Teruel,44190,Pozuel del Campo,0,2,-2
1997,Teruel,44191,Puebla de Híjar (La),11,20,-9
1997,Teruel,44192,Puebla de Valverde (La),5,4,1
1997,Teruel,44193,Puertomingalvo,0,1,-1
1997,Teruel,44195,Rillo,0,2,-2
1997,Teruel,44196,Riodeva,1,7,-6
1997,Teruel,44198,Royuela,3,3,0
1997,Teruel,44199,Rubiales,0,1,-1
1997,Teruel,44200,Rubielos de la Cérida,1,0,1
1997,Teruel,44201,Rubielos de Mora,5,13,-8
1997,Teruel,44194,Ráfales,0,4,-4
1997,Teruel,44197,Ródenas,2,3,-1
1997,Teruel,44205,Samper de Calanda,7,17,-10
1997,Teruel,44206,San Agustín,1,4,-3
1997,Teruel,44207,San Martín del Río,0,2,-2
1997,Teruel,44208,Santa Cruz de Nogueras,0,1,-1
1997,Teruel,44209,Santa Eulalia,5,23,-18
1997,Teruel,44210,Sarrión,10,24,-14
1997,Teruel,44211,Segura de los Baños,0,1,-1
1997,Teruel,44212,Seno,0,2,-2
1997,Teruel,44213,Singra,1,2,-1
1997,Teruel,44215,Terriente,1,3,-2
1997,Teruel,44216,Teruel,287,332,-45
1997,Teruel,44217,Toril y Masegoso,0,1,-1
1997,Teruel,44218,Tormón,0,1,-1
1997,Teruel,44219,Tornos,1,4,-3
1997,Teruel,44220,Torralba de los Sisones,7,2,5
1997,Teruel,44223,Torre de Arcas,0,2,-2
1997,Teruel,44225,Torre del Compte,0,6,-6
1997,Teruel,44227,Torre los Negros,1,2,-1
1997,Teruel,44221,Torrecilla de Alcañiz,1,8,-7
1997,Teruel,44222,Torrecilla del Rebollar,0,2,-2
1997,Teruel,44226,Torrelacárcel,0,3,-3
1997,Teruel,44228,Torremocha de Jiloca,0,5,-5
1997,Teruel,44229,Torres de Albarracín,1,3,-2
1997,Teruel,44230,Torrevelilla,2,4,-2
1997,Teruel,44231,Torrijas,0,1,-1
1997,Teruel,44232,Torrijo del Campo,2,8,-6
1997,Teruel,44234,Tramacastiel,0,1,-1
1997,Teruel,44235,Tramacastilla,0,2,-2
1997,Teruel,44236,Tronchón,1,2,-1
1997,Teruel,44237,Urrea de Gaén,1,10,-9
1997,Teruel,44238,Utrillas,20,32,-12
1997,Teruel,44240,Valbona,0,3,-3
1997,Teruel,44241,Valdealgorfa,4,13,-9
1997,Teruel,44244,Valdelinares,3,0,3
1997,Teruel,44245,Valdeltormo,1,6,-5
1997,Teruel,44246,Valderrobres,14,28,-14
1997,Teruel,44247,Valjunquera,3,12,-9
1997,Teruel,44249,Vallecillo (El),0,2,-2
1997,Teruel,44250,Veguillas de la Sierra,0,1,-1
1997,Teruel,44251,Villafranca del Campo,3,9,-6
1997,Teruel,44252,Villahermosa del Campo,0,0,0
1997,Teruel,44256,Villanueva del Rebollar de la Sierra,1,1,0
1997,Teruel,44257,Villar del Cobo,1,3,-2
1997,Teruel,44260,Villarluengo,1,1,0
1997,Teruel,44261,Villarquemado,8,8,0
1997,Teruel,44262,Villarroya de los Pinares,1,3,-2
1997,Teruel,44263,Villastar,4,5,-1
1997,Teruel,44264,Villel,0,7,-7
1997,Teruel,44265,Vinaceite,1,2,-1
1997,Teruel,44266,Visiedo,0,5,-5
1997,Teruel,44267,Vivel del Río Martín,0,3,-3
1996,Teruel,44001,Ababuj,1,2,-1
1996,Teruel,44002,Abejuela,0,1,-1
1996,Teruel,44003,Aguatón,0,1,-1
1996,Teruel,44004,Aguaviva,4,11,-7
1996,Teruel,44005,Aguilar del Alfambra,1,0,1
1996,Teruel,44006,Alacón,1,10,-9
1996,Teruel,44007,Alba,0,2,-2
1996,Teruel,44008,Albalate del Arzobispo,15,42,-27
1996,Teruel,44009,Albarracín,10,16,-6
1996,Teruel,44010,Albentosa,6,4,2
1996,Teruel,44011,Alcaine,1,1,0
1996,Teruel,44012,Alcalá de la Selva,3,2,1
1996,Teruel,44013,Alcañiz,109,135,-26
1996,Teruel,44014,Alcorisa,33,37,-4
1996,Teruel,44016,Alfambra,4,14,-10
1996,Teruel,44017,Aliaga,3,8,-5
1996,Teruel,44021,Allepuz,1,1,0
1996,Teruel,44022,Alloza,5,17,-12
1996,Teruel,44019,Alobras,1,2,-1
1996,Teruel,44025,Andorra,75,52,23
1996,Teruel,44027,Arens de Lledó,2,3,-1
1996,Teruel,44028,Argente,0,6,-6
1996,Teruel,44029,Ariño,5,14,-9
1996,Teruel,44031,Azaila,0,4,-4
1996,Teruel,44035,Barrachina,2,1,1
1996,Teruel,44034,Bañón,1,5,-4
1996,Teruel,44037,Beceite,8,8,0
1996,Teruel,44039,Bello,1,5,-4
1996,Teruel,44038,Belmonte de San José,1,1,0
1996,Teruel,44040,Berge,2,5,-3
1996,Teruel,44041,Bezas,0,1,-1
1996,Teruel,44042,Blancas,0,4,-4
1996,Teruel,44043,Blesa,1,1,0
1996,Teruel,44044,Bordón,0,1,-1
1996,Teruel,44045,Bronchales,3,2,1
1996,Teruel,44046,Bueña,0,1,-1
1996,Teruel,44047,Burbáguena,0,12,-12
1996,Teruel,44033,Báguena,2,6,-4
1996,Teruel,44048,Cabra de Mora,1,4,-3
1996,Teruel,44049,Calaceite,6,26,-20
1996,Teruel,44050,Calamocha,26,52,-26
1996,Teruel,44051,Calanda,33,42,-9
1996,Teruel,44052,Calomarde,0,3,-3
1996,Teruel,44054,Camarena de la Sierra,0,2,-2
1996,Teruel,44055,Camarillas,2,2,0
1996,Teruel,44053,Camañas,1,3,-2
1996,Teruel,44056,Caminreal,4,9,-5
1996,Teruel,44059,Cantavieja,4,4,0
1996,Teruel,44064,Cascante del Río,0,3,-3
1996,Teruel,44065,Castejón de Tornos,0,4,-4
1996,Teruel,44066,Castel de Cabra,2,2,0
1996,Teruel,44070,Castellar (El),0,1,-1
1996,Teruel,44071,Castellote,6,17,-11
1996,Teruel,44067,Castelnou,0,6,-6
1996,Teruel,44068,Castelserás,7,5,2
1996,Teruel,44060,Cañada de Benatanduz,0,2,-2
1996,Teruel,44061,Cañada de Verich (La),1,0,1
1996,Teruel,44062,Cañada Vellida,0,1,-1
1996,Teruel,44063,Cañizar del Olivar,1,1,0
1996,Teruel,44074,Cedrillas,3,5,-2
1996,Teruel,44075,Celadas,4,9,-5
1996,Teruel,44076,Cella,13,32,-19
1996,Teruel,44077,Cerollera (La),1,1,0
1996,Teruel,44080,Codoñera (La),1,5,-4
1996,Teruel,44082,Corbalán,0,3,-3
1996,Teruel,44084,Cortes de Aragón,0,3,-3
1996,Teruel,44085,Cosa,1,0,1
1996,Teruel,44086,Cretas,0,5,-5
1996,Teruel,44087,Crivillén,0,1,-1
1996,Teruel,44088,Cuba (La),0,2,-2
1996,Teruel,44089,Cubla,0,1,-1
1996,Teruel,44092,Cuervo (El),0,3,-3
1996,Teruel,44093,Cuevas de Almudén,0,1,-1
1996,Teruel,44094,Cuevas Labradas,0,2,-2
1996,Teruel,44096,Ejulve,2,4,-2
1996,Teruel,44097,Escorihuela,1,4,-3
1996,Teruel,44099,Escucha,9,6,3
1996,Teruel,44100,Estercuel,1,3,-2
1996,Teruel,44103,Formiche Alto,4,3,1
1996,Teruel,44106,Fortanete,0,3,-3
1996,Teruel,44107,Foz-Calanda,1,5,-4
1996,Teruel,44108,Fresneda (La),3,5,-2
1996,Teruel,44109,Frías de Albarracín,0,1,-1
1996,Teruel,44111,Fuentes Calientes,0,2,-2
1996,Teruel,44112,Fuentes Claras,1,19,-18
1996,Teruel,44113,Fuentes de Rubielos,2,2,0
1996,Teruel,44114,Fuentespalda,6,0,6
1996,Teruel,44105,Fórnoles,0,2,-2
1996,Teruel,44115,Galve,0,1,-1
1996,Teruel,44116,Gargallo,1,0,1
1996,Teruel,44117,Gea de Albarracín,2,7,-5
1996,Teruel,44118,Ginebrosa (La),1,9,-8
1996,Teruel,44119,Griegos,0,2,-2
1996,Teruel,44120,Guadalaviar,2,6,-4
1996,Teruel,44121,Gúdar,1,0,1
1996,Teruel,44123,Hinojosa de Jarque,0,5,-5
1996,Teruel,44124,Hoz de la Vieja (La),0,3,-3
1996,Teruel,44125,Huesa del Común,0,2,-2
1996,Teruel,44122,Híjar,18,32,-14
1996,Teruel,44126,Iglesuela del Cid (La),3,5,-2
1996,Teruel,44127,Jabaloyas,0,1,-1
1996,Teruel,44128,Jarque de la Val,0,2,-2
1996,Teruel,44130,Jorcas,0,2,-2
1996,Teruel,44131,Josa,0,1,-1
1996,Teruel,44132,Lagueruela,0,1,-1
1996,Teruel,44133,Lanzuela,0,1,-1
1996,Teruel,44135,Libros,1,2,-1
1996,Teruel,44137,Linares de Mora,3,4,-1
1996,Teruel,44141,Lledó,0,5,-5
1996,Teruel,44138,Loscos,1,4,-3
1996,Teruel,44142,Maicas,1,1,0
1996,Teruel,44143,Manzanera,2,5,-3
1996,Teruel,44144,Martín del Río,3,8,-5
1996,Teruel,44145,Mas de las Matas,9,16,-7
1996,Teruel,44146,Mata de los Olmos (La),1,3,-2
1996,Teruel,44147,Mazaleón,6,9,-3
1996,Teruel,44148,Mezquita de Jarque,2,0,2
1996,Teruel,44151,Molinos,1,6,-5
1996,Teruel,44152,Monforte de Moyuela,0,1,-1
1996,Teruel,44153,Monreal del Campo,18,22,-4
1996,Teruel,44154,Monroyo,2,4,-2
1996,Teruel,44155,Montalbán,6,15,-9
1996,Teruel,44157,Monterde de Albarracín,0,2,-2
1996,Teruel,44158,Mora de Rubielos,14,11,3
1996,Teruel,44159,Moscardón,0,1,-1
1996,Teruel,44160,Mosqueruela,5,10,-5
1996,Teruel,44161,Muniesa,5,13,-8
1996,Teruel,44163,Noguera de Albarracín,1,0,1
1996,Teruel,44164,Nogueras,0,1,-1
1996,Teruel,44165,Nogueruelas,1,6,-5
1996,Teruel,44167,Obón,0,1,-1
1996,Teruel,44168,Odón,1,1,0
1996,Teruel,44169,Ojos Negros,3,6,-3
1996,Teruel,44171,Olba,0,4,-4
1996,Teruel,44172,Oliete,5,10,-5
1996,Teruel,44173,Olmos (Los),1,1,0
1996,Teruel,44174,Orihuela del Tremedal,4,9,-5
1996,Teruel,44175,Orrios,3,5,-2
1996,Teruel,44176,Palomar de Arroyos,1,4,-3
1996,Teruel,44177,Pancrudo,0,5,-5
1996,Teruel,44178,Parras de Castellote (Las),1,8,-7
1996,Teruel,44180,Peracense,1,0,1
1996,Teruel,44181,Peralejos,0,1,-1
1996,Teruel,44182,Perales del Alfambra,2,1,1
1996,Teruel,44179,Peñarroya de Tastavins,4,7,-3
1996,Teruel,44183,Pitarque,1,3,-2
1996,Teruel,44185,Pobo (El),1,1,0
1996,Teruel,44187,Portellada (La),0,5,-5
1996,Teruel,44189,Pozondón,0,3,-3
1996,Teruel,44190,Pozuel del Campo,1,1,0
1996,Teruel,44191,Puebla de Híjar (La),9,17,-8
1996,Teruel,44192,Puebla de Valverde (La),1,3,-2
1996,Teruel,44195,Rillo,2,1,1
1996,Teruel,44196,Riodeva,0,4,-4
1996,Teruel,44198,Royuela,1,2,-1
1996,Teruel,44199,Rubiales,0,2,-2
1996,Teruel,44201,Rubielos de Mora,7,3,4
1996,Teruel,44194,Ráfales,2,4,-2
1996,Teruel,44204,Saldón,0,1,-1
1996,Teruel,44205,Samper de Calanda,5,19,-14
1996,Teruel,44206,San Agustín,0,2,-2
1996,Teruel,44207,San Martín del Río,2,1,1
1996,Teruel,44209,Santa Eulalia,5,22,-17
1996,Teruel,44210,Sarrión,7,17,-10
1996,Teruel,44212,Seno,0,1,-1
1996,Teruel,44213,Singra,0,1,-1
1996,Teruel,44215,Terriente,0,1,-1
1996,Teruel,44216,Teruel,306,315,-9
1996,Teruel,44218,Tormón,0,2,-2
1996,Teruel,44219,Tornos,0,3,-3
1996,Teruel,44220,Torralba de los Sisones,1,6,-5
1996,Teruel,44223,Torre de Arcas,1,2,-1
1996,Teruel,44224,Torre de las Arcas,0,1,-1
1996,Teruel,44225,Torre del Compte,0,4,-4
1996,Teruel,44227,Torre los Negros,0,3,-3
1996,Teruel,44221,Torrecilla de Alcañiz,2,6,-4
1996,Teruel,44222,Torrecilla del Rebollar,1,3,-2
1996,Teruel,44226,Torrelacárcel,0,3,-3
1996,Teruel,44228,Torremocha de Jiloca,0,2,-2
1996,Teruel,44229,Torres de Albarracín,0,3,-3
1996,Teruel,44230,Torrevelilla,1,3,-2
1996,Teruel,44231,Torrijas,0,2,-2
1996,Teruel,44232,Torrijo del Campo,2,5,-3
1996,Teruel,44234,Tramacastiel,0,5,-5
1996,Teruel,44235,Tramacastilla,0,3,-3
1996,Teruel,44237,Urrea de Gaén,4,3,1
1996,Teruel,44238,Utrillas,19,28,-9
1996,Teruel,44239,Valacloche,1,0,1
1996,Teruel,44240,Valbona,0,4,-4
1996,Teruel,44241,Valdealgorfa,5,11,-6
1996,Teruel,44243,Valdecuenca,0,2,-2
1996,Teruel,44245,Valdeltormo,2,9,-7
1996,Teruel,44246,Valderrobres,16,23,-7
1996,Teruel,44247,Valjunquera,1,3,-2
1996,Teruel,44251,Villafranca del Campo,2,2,0
1996,Teruel,44252,Villahermosa del Campo,0,1,-1
1996,Teruel,44257,Villar del Cobo,3,0,3
1996,Teruel,44258,Villar del Salz,0,2,-2
1996,Teruel,44260,Villarluengo,0,3,-3
1996,Teruel,44261,Villarquemado,3,17,-14
1996,Teruel,44262,Villarroya de los Pinares,1,4,-3
1996,Teruel,44263,Villastar,2,8,-6
1996,Teruel,44264,Villel,1,6,-5
1996,Teruel,44265,Vinaceite,2,1,1
1996,Teruel,44266,Visiedo,1,4,-3
1996,Teruel,44267,Vivel del Río Martín,0,1,-1
