year,province,cp,cities,nacidos,defunciones,saldo
2017,Zaragoza,50001,Abanto,0,3,-3
2017,Zaragoza,50002,Acered,0,4,-4
2017,Zaragoza,50004,Aguarón,4,15,-11
2017,Zaragoza,50005,Aguilón,1,2,-1
2017,Zaragoza,50003,Agón,1,7,-6
2017,Zaragoza,50006,Ainzón,6,26,-20
2017,Zaragoza,50008,Alagón,53,60,-7
2017,Zaragoza,50009,Alarba,0,4,-4
2017,Zaragoza,50011,Albeta,1,2,-1
2017,Zaragoza,50013,Alcalá de Ebro,0,4,-4
2017,Zaragoza,50014,Alcalá de Moncayo,0,4,-4
2017,Zaragoza,50015,Alconchel de Ariza,1,0,1
2017,Zaragoza,50017,Alfajarín,22,26,-4
2017,Zaragoza,50018,Alfamén,11,13,-2
2017,Zaragoza,50019,Alforque,0,1,-1
2017,Zaragoza,50020,Alhama de Aragón,7,11,-4
2017,Zaragoza,50022,Almolda (La),3,9,-6
2017,Zaragoza,50023,Almonacid de la Cuba,1,10,-9
2017,Zaragoza,50024,Almonacid de la Sierra,7,20,-13
2017,Zaragoza,50025,Almunia de Doña Godina (La),81,94,-13
2017,Zaragoza,50026,Alpartir,2,5,-3
2017,Zaragoza,50027,Ambel,1,3,-2
2017,Zaragoza,50029,Aniñón,1,13,-12
2017,Zaragoza,50031,Aranda de Moncayo,0,3,-3
2017,Zaragoza,50034,Ariza,10,19,-9
2017,Zaragoza,50035,Artieda,0,1,-1
2017,Zaragoza,50032,Arándiga,1,6,-5
2017,Zaragoza,50036,Asín,0,2,-2
2017,Zaragoza,50037,Atea,2,4,-2
2017,Zaragoza,50038,Ateca,8,23,-15
2017,Zaragoza,50039,Azuara,3,6,-3
2017,Zaragoza,50030,Añón de Moncayo,1,4,-3
2017,Zaragoza,50044,Bardallur,2,7,-5
2017,Zaragoza,50045,Belchite,9,27,-18
2017,Zaragoza,50046,Belmonte de Gracián,1,8,-7
2017,Zaragoza,50901,Biel,0,5,-5
2017,Zaragoza,50050,Bijuesca,0,3,-3
2017,Zaragoza,50051,Biota,0,24,-24
2017,Zaragoza,50052,Bisimbre,0,2,-2
2017,Zaragoza,50053,Boquiñeni,4,16,-12
2017,Zaragoza,50054,Bordalba,0,1,-1
2017,Zaragoza,50055,Borja,37,66,-29
2017,Zaragoza,50056,Botorrita,4,5,-1
2017,Zaragoza,50057,Brea de Aragón,8,13,-5
2017,Zaragoza,50058,Bubierca,0,1,-1
2017,Zaragoza,50059,Bujaraloz,13,15,-2
2017,Zaragoza,50060,Bulbuente,1,4,-3
2017,Zaragoza,50061,Bureta,1,3,-2
2017,Zaragoza,50062,Burgo de Ebro (El),16,21,-5
2017,Zaragoza,50043,Bárboles,0,2,-2
2017,Zaragoza,50064,Cabañas de Ebro,1,8,-7
2017,Zaragoza,50066,Cadrete,47,14,33
2017,Zaragoza,50067,Calatayud,126,227,-101
2017,Zaragoza,50068,Calatorao,24,39,-15
2017,Zaragoza,50070,Calmarza,0,1,-1
2017,Zaragoza,50071,Campillo de Aragón,0,3,-3
2017,Zaragoza,50072,Carenas,0,5,-5
2017,Zaragoza,50073,Cariñena,26,40,-14
2017,Zaragoza,50074,Caspe,114,102,12
2017,Zaragoza,50075,Castejón de Alarba,0,2,-2
2017,Zaragoza,50076,Castejón de las Armas,0,2,-2
2017,Zaragoza,50077,Castejón de Valdejasa,2,2,0
2017,Zaragoza,50078,Castiliscar,0,2,-2
2017,Zaragoza,50079,Cervera de la Cañada,0,5,-5
2017,Zaragoza,50080,Cerveruela,0,1,-1
2017,Zaragoza,50081,Cetina,1,8,-7
2017,Zaragoza,50092,Chiprana,3,4,-1
2017,Zaragoza,50093,Chodes,0,4,-4
2017,Zaragoza,50082,Cimballa,0,2,-2
2017,Zaragoza,50083,Cinco Olivas,0,2,-2
2017,Zaragoza,50084,Clarés de Ribota,0,2,-2
2017,Zaragoza,50085,Codo,0,3,-3
2017,Zaragoza,50086,Codos,0,2,-2
2017,Zaragoza,50087,Contamina,0,1,-1
2017,Zaragoza,50088,Cosuenda,1,5,-4
2017,Zaragoza,50089,Cuarte de Huerva,204,31,173
2017,Zaragoza,50090,Cubel,0,6,-6
2017,Zaragoza,50091,Cuerlas (Las),0,2,-2
2017,Zaragoza,50094,Daroca,12,39,-27
2017,Zaragoza,50095,Ejea de los Caballeros,135,187,-52
2017,Zaragoza,50098,Encinacorba,1,4,-3
2017,Zaragoza,50100,Erla,0,3,-3
2017,Zaragoza,50101,Escatrón,4,18,-14
2017,Zaragoza,50102,Fabara,3,19,-16
2017,Zaragoza,50104,Farlete,1,3,-2
2017,Zaragoza,50106,Fayos (Los),0,3,-3
2017,Zaragoza,50105,Fayón,6,9,-3
2017,Zaragoza,50107,Figueruelas,9,12,-3
2017,Zaragoza,50108,Fombuena,0,1,-1
2017,Zaragoza,50109,Frago (El),0,2,-2
2017,Zaragoza,50110,Frasno (El),1,5,-4
2017,Zaragoza,50111,Fréscano,2,4,-2
2017,Zaragoza,50113,Fuendejalón,7,7,0
2017,Zaragoza,50114,Fuendetodos,1,3,-2
2017,Zaragoza,50115,Fuentes de Ebro,41,45,-4
2017,Zaragoza,50116,Fuentes de Jiloca,1,6,-5
2017,Zaragoza,50117,Gallocanta,1,0,1
2017,Zaragoza,50118,Gallur,23,36,-13
2017,Zaragoza,50119,Gelsa,8,26,-18
2017,Zaragoza,50121,Gotor,0,6,-6
2017,Zaragoza,50123,Grisén,5,10,-5
2017,Zaragoza,50124,Herrera de los Navarros,4,7,-3
2017,Zaragoza,50125,Ibdes,1,5,-4
2017,Zaragoza,50126,Illueca,8,34,-26
2017,Zaragoza,50128,Isuerre,0,1,-1
2017,Zaragoza,50129,Jaraba,0,9,-9
2017,Zaragoza,50130,Jarque de Moncayo,4,8,-4
2017,Zaragoza,50131,Jaulín,1,5,-4
2017,Zaragoza,50132,Joyosa (La),12,8,4
2017,Zaragoza,50133,Lagata,0,2,-2
2017,Zaragoza,50134,Langa del Castillo,1,2,-1
2017,Zaragoza,50135,Layana,1,4,-3
2017,Zaragoza,50137,Leciñena,3,28,-25
2017,Zaragoza,50139,Letux,1,10,-9
2017,Zaragoza,50141,Lituénigo,2,2,0
2017,Zaragoza,50142,Lobera de Onsella,1,1,0
2017,Zaragoza,50143,Longares,2,16,-14
2017,Zaragoza,50146,Lucena de Jalón,1,3,-2
2017,Zaragoza,50147,Luceni,10,12,-2
2017,Zaragoza,50148,Luesia,0,6,-6
2017,Zaragoza,50150,Lumpiaque,11,12,-1
2017,Zaragoza,50151,Luna,3,19,-16
2017,Zaragoza,50136,Lécera,2,15,-13
2017,Zaragoza,50152,Maella,18,31,-13
2017,Zaragoza,50153,Magallón,6,20,-14
2017,Zaragoza,50154,Mainar,0,3,-3
2017,Zaragoza,50155,Malanquilla,0,1,-1
2017,Zaragoza,50156,Maleján,0,2,-2
2017,Zaragoza,50160,Mallén,22,38,-16
2017,Zaragoza,50159,Maluenda,1,13,-12
2017,Zaragoza,50157,Malón,3,10,-7
2017,Zaragoza,50161,Manchones,3,4,-1
2017,Zaragoza,50162,Mara,1,4,-3
2017,Zaragoza,50163,María de Huerva,73,27,46
2017,Zaragoza,50164,Mediana de Aragón,0,3,-3
2017,Zaragoza,50165,Mequinenza,7,31,-24
2017,Zaragoza,50166,Mesones de Isuela,1,1,0
2017,Zaragoza,50167,Mezalocha,0,5,-5
2017,Zaragoza,50169,Miedes de Aragón,3,5,-2
2017,Zaragoza,50170,Monegrillo,1,4,-3
2017,Zaragoza,50171,Moneva,0,1,-1
2017,Zaragoza,50172,Monreal de Ariza,1,2,-1
2017,Zaragoza,50173,Monterde,0,2,-2
2017,Zaragoza,50174,Montón,0,1,-1
2017,Zaragoza,50175,Morata de Jalón,3,25,-22
2017,Zaragoza,50176,Morata de Jiloca,2,3,-1
2017,Zaragoza,50178,Moros,0,9,-9
2017,Zaragoza,50177,Morés,0,7,-7
2017,Zaragoza,50179,Moyuela,0,9,-9
2017,Zaragoza,50180,Mozota,0,3,-3
2017,Zaragoza,50181,Muel,2,11,-9
2017,Zaragoza,50182,Muela (La),60,25,35
2017,Zaragoza,50183,Munébrega,0,2,-2
2017,Zaragoza,50184,Murero,0,1,-1
2017,Zaragoza,50185,Murillo de Gállego,0,0,0
2017,Zaragoza,50187,Nigüella,0,2,-2
2017,Zaragoza,50189,Nonaspe,7,18,-11
2017,Zaragoza,50190,Novallas,7,18,-11
2017,Zaragoza,50191,Novillas,5,10,-5
2017,Zaragoza,50193,Nuez de Ebro,8,8,0
2017,Zaragoza,50192,Nuévalos,4,6,-2
2017,Zaragoza,50194,Olvés,0,4,-4
2017,Zaragoza,50195,Orcajo,0,1,-1
2017,Zaragoza,50196,Orera,0,4,-4
2017,Zaragoza,50197,Orés,0,2,-2
2017,Zaragoza,50199,Osera de Ebro,4,12,-8
2017,Zaragoza,50200,Paniza,2,9,-7
2017,Zaragoza,50201,Paracuellos de Jiloca,5,7,-2
2017,Zaragoza,50202,Paracuellos de la Ribera,0,2,-2
2017,Zaragoza,50203,Pastriz,9,13,-4
2017,Zaragoza,50204,Pedrola,32,25,7
2017,Zaragoza,50205,Pedrosas (Las),0,3,-3
2017,Zaragoza,50206,Perdiguera,0,6,-6
2017,Zaragoza,50207,Piedratajada,0,3,-3
2017,Zaragoza,50208,Pina de Ebro,13,35,-22
2017,Zaragoza,50209,Pinseque,50,54,-4
2017,Zaragoza,50210,Pintanos (Los),0,1,-1
2017,Zaragoza,50211,Plasencia de Jalón,3,9,-6
2017,Zaragoza,50212,Pleitas,0,0,0
2017,Zaragoza,50213,Plenas,0,2,-2
2017,Zaragoza,50215,Pozuel de Ariza,0,1,-1
2017,Zaragoza,50216,Pozuelo de Aragón,2,0,2
2017,Zaragoza,50217,Pradilla de Ebro,3,5,-2
2017,Zaragoza,50218,Puebla de Albortón,1,2,-1
2017,Zaragoza,50219,Puebla de Alfindén (La),57,23,34
2017,Zaragoza,50220,Puendeluna,0,1,-1
2017,Zaragoza,50222,Quinto,15,23,-8
2017,Zaragoza,50223,Remolinos,5,17,-12
2017,Zaragoza,50224,Retascón,1,1,0
2017,Zaragoza,50225,Ricla,23,35,-12
2017,Zaragoza,50227,Romanos,1,6,-5
2017,Zaragoza,50228,Rueda de Jalón,5,3,2
2017,Zaragoza,50229,Ruesca,0,2,-2
2017,Zaragoza,50231,Salillas de Jalón,3,6,-3
2017,Zaragoza,50232,Salvatierra de Esca,1,3,-2
2017,Zaragoza,50233,Samper del Salz,0,1,-1
2017,Zaragoza,50234,San Martín de la Virgen de Moncayo,2,5,-3
2017,Zaragoza,50235,San Mateo de Gállego,32,31,1
2017,Zaragoza,50236,Santa Cruz de Grío,0,3,-3
2017,Zaragoza,50237,Santa Cruz de Moncayo,0,3,-3
2017,Zaragoza,50238,Santa Eulalia de Gállego,1,1,0
2017,Zaragoza,50239,Santed,0,3,-3
2017,Zaragoza,50241,Saviñán,3,9,-6
2017,Zaragoza,50242,Sediles,0,4,-4
2017,Zaragoza,50243,Sestrica,0,6,-6
2017,Zaragoza,50244,Sierra de Luna,3,3,0
2017,Zaragoza,50245,Sigüés,1,3,-2
2017,Zaragoza,50246,Sisamón,0,1,-1
2017,Zaragoza,50247,Sobradiel,10,12,-2
2017,Zaragoza,50248,Sos del Rey Católico,5,8,-3
2017,Zaragoza,50230,Sádaba,6,32,-26
2017,Zaragoza,50240,Sástago,7,27,-20
2017,Zaragoza,50249,Tabuenca,0,8,-8
2017,Zaragoza,50250,Talamantes,0,0,0
2017,Zaragoza,50251,Tarazona,67,110,-43
2017,Zaragoza,50252,Tauste,51,93,-42
2017,Zaragoza,50253,Terrer,0,11,-11
2017,Zaragoza,50254,Tierga,0,1,-1
2017,Zaragoza,50255,Tobed,0,7,-7
2017,Zaragoza,50256,Torralba de los Frailes,0,2,-2
2017,Zaragoza,50257,Torralba de Ribota,0,3,-3
2017,Zaragoza,50259,Torrehermosa,0,1,-1
2017,Zaragoza,50260,Torrelapaja,0,1,-1
2017,Zaragoza,50261,Torrellas,0,8,-8
2017,Zaragoza,50262,Torres de Berrellén,8,15,-7
2017,Zaragoza,50263,Torrijo de la Cañada,2,4,-2
2017,Zaragoza,50264,Tosos,0,3,-3
2017,Zaragoza,50266,Trasobares,0,5,-5
2017,Zaragoza,50267,Uncastillo,2,15,-13
2017,Zaragoza,50269,Urrea de Jalón,4,17,-13
2017,Zaragoza,50270,Urriés,0,1,-1
2017,Zaragoza,50271,Used,0,8,-8
2017,Zaragoza,50272,Utebo,167,107,60
2017,Zaragoza,50274,Val de San Martín,0,2,-2
2017,Zaragoza,50275,Valmadrid,1,7,-6
2017,Zaragoza,50276,Valpalmas,0,2,-2
2017,Zaragoza,50278,Velilla de Ebro,1,2,-1
2017,Zaragoza,50280,Vera de Moncayo,2,8,-6
2017,Zaragoza,50281,Vierlas,1,1,0
2017,Zaragoza,50283,Villadoz,2,2,0
2017,Zaragoza,50284,Villafeliche,0,2,-2
2017,Zaragoza,50285,Villafranca de Ebro,12,14,-2
2017,Zaragoza,50286,Villalba de Perejil,0,2,-2
2017,Zaragoza,50287,Villalengua,1,6,-5
2017,Zaragoza,50903,Villamayor de Gállego,15,21,-6
2017,Zaragoza,50288,Villanueva de Gállego,30,50,-20
2017,Zaragoza,50290,Villanueva de Huerva,2,6,-4
2017,Zaragoza,50289,Villanueva de Jiloca,0,3,-3
2017,Zaragoza,50291,Villar de los Navarros,1,2,-1
2017,Zaragoza,50292,Villarreal de Huerva,4,2,2
2017,Zaragoza,50293,Villarroya de la Sierra,1,11,-10
2017,Zaragoza,50294,Villarroya del Campo,2,0,2
2017,Zaragoza,50282,Vilueña (La),0,2,-2
2017,Zaragoza,50296,Zaida (La),2,8,-6
2017,Zaragoza,50297,Zaragoza,5619,6558,-939
2017,Zaragoza,50298,Zuera,70,70,0
2017,Zaragoza,50099,Épila,50,58,-8
2016,Zaragoza,50001,Abanto,0,4,-4
2016,Zaragoza,50002,Acered,1,5,-4
2016,Zaragoza,50004,Aguarón,2,13,-11
2016,Zaragoza,50005,Aguilón,1,5,-4
2016,Zaragoza,50003,Agón,1,2,-1
2016,Zaragoza,50006,Ainzón,5,18,-13
2016,Zaragoza,50007,Aladrén,0,1,-1
2016,Zaragoza,50008,Alagón,67,61,6
2016,Zaragoza,50009,Alarba,0,1,-1
2016,Zaragoza,50011,Albeta,1,2,-1
2016,Zaragoza,50012,Alborge,1,1,0
2016,Zaragoza,50013,Alcalá de Ebro,3,0,3
2016,Zaragoza,50014,Alcalá de Moncayo,1,4,-3
2016,Zaragoza,50015,Alconchel de Ariza,0,5,-5
2016,Zaragoza,50016,Aldehuela de Liestos,0,1,-1
2016,Zaragoza,50017,Alfajarín,22,13,9
2016,Zaragoza,50018,Alfamén,18,23,-5
2016,Zaragoza,50019,Alforque,0,1,-1
2016,Zaragoza,50020,Alhama de Aragón,11,13,-2
2016,Zaragoza,50022,Almolda (La),0,9,-9
2016,Zaragoza,50023,Almonacid de la Cuba,1,8,-7
2016,Zaragoza,50024,Almonacid de la Sierra,2,15,-13
2016,Zaragoza,50025,Almunia de Doña Godina (La),67,72,-5
2016,Zaragoza,50026,Alpartir,2,4,-2
2016,Zaragoza,50027,Ambel,1,4,-3
2016,Zaragoza,50028,Anento,0,2,-2
2016,Zaragoza,50029,Aniñón,1,7,-6
2016,Zaragoza,50031,Aranda de Moncayo,0,4,-4
2016,Zaragoza,50034,Ariza,9,20,-11
2016,Zaragoza,50032,Arándiga,0,8,-8
2016,Zaragoza,50036,Asín,0,2,-2
2016,Zaragoza,50037,Atea,0,3,-3
2016,Zaragoza,50038,Ateca,6,20,-14
2016,Zaragoza,50039,Azuara,2,5,-3
2016,Zaragoza,50030,Añón de Moncayo,0,4,-4
2016,Zaragoza,50040,Badules,1,1,0
2016,Zaragoza,50044,Bardallur,1,4,-3
2016,Zaragoza,50045,Belchite,5,26,-21
2016,Zaragoza,50046,Belmonte de Gracián,0,2,-2
2016,Zaragoza,50048,Berrueco,1,0,1
2016,Zaragoza,50901,Biel,1,4,-3
2016,Zaragoza,50050,Bijuesca,0,1,-1
2016,Zaragoza,50051,Biota,5,12,-7
2016,Zaragoza,50052,Bisimbre,0,2,-2
2016,Zaragoza,50053,Boquiñeni,2,9,-7
2016,Zaragoza,50054,Bordalba,0,2,-2
2016,Zaragoza,50055,Borja,41,56,-15
2016,Zaragoza,50056,Botorrita,3,4,-1
2016,Zaragoza,50057,Brea de Aragón,8,11,-3
2016,Zaragoza,50058,Bubierca,0,2,-2
2016,Zaragoza,50059,Bujaraloz,10,19,-9
2016,Zaragoza,50060,Bulbuente,0,4,-4
2016,Zaragoza,50061,Bureta,1,4,-3
2016,Zaragoza,50062,Burgo de Ebro (El),36,13,23
2016,Zaragoza,50063,Buste (El),1,0,1
2016,Zaragoza,50043,Bárboles,1,9,-8
2016,Zaragoza,50064,Cabañas de Ebro,2,10,-8
2016,Zaragoza,50065,Cabolafuente,1,0,1
2016,Zaragoza,50066,Cadrete,28,29,-1
2016,Zaragoza,50067,Calatayud,158,205,-47
2016,Zaragoza,50068,Calatorao,21,26,-5
2016,Zaragoza,50070,Calmarza,0,2,-2
2016,Zaragoza,50071,Campillo de Aragón,0,3,-3
2016,Zaragoza,50072,Carenas,1,5,-4
2016,Zaragoza,50073,Cariñena,24,44,-20
2016,Zaragoza,50074,Caspe,100,102,-2
2016,Zaragoza,50075,Castejón de Alarba,0,2,-2
2016,Zaragoza,50076,Castejón de las Armas,0,6,-6
2016,Zaragoza,50077,Castejón de Valdejasa,0,5,-5
2016,Zaragoza,50078,Castiliscar,1,2,-1
2016,Zaragoza,50079,Cervera de la Cañada,1,6,-5
2016,Zaragoza,50080,Cerveruela,0,0,0
2016,Zaragoza,50081,Cetina,1,12,-11
2016,Zaragoza,50092,Chiprana,7,3,4
2016,Zaragoza,50093,Chodes,1,3,-2
2016,Zaragoza,50082,Cimballa,0,3,-3
2016,Zaragoza,50083,Cinco Olivas,0,2,-2
2016,Zaragoza,50084,Clarés de Ribota,0,3,-3
2016,Zaragoza,50085,Codo,0,3,-3
2016,Zaragoza,50086,Codos,0,4,-4
2016,Zaragoza,50087,Contamina,1,2,-1
2016,Zaragoza,50088,Cosuenda,2,4,-2
2016,Zaragoza,50089,Cuarte de Huerva,206,22,184
2016,Zaragoza,50090,Cubel,3,2,1
2016,Zaragoza,50094,Daroca,22,17,5
2016,Zaragoza,50095,Ejea de los Caballeros,126,176,-50
2016,Zaragoza,50096,Embid de Ariza,0,1,-1
2016,Zaragoza,50098,Encinacorba,0,4,-4
2016,Zaragoza,50100,Erla,3,6,-3
2016,Zaragoza,50101,Escatrón,7,24,-17
2016,Zaragoza,50102,Fabara,3,13,-10
2016,Zaragoza,50104,Farlete,2,7,-5
2016,Zaragoza,50106,Fayos (Los),0,5,-5
2016,Zaragoza,50105,Fayón,1,6,-5
2016,Zaragoza,50107,Figueruelas,9,15,-6
2016,Zaragoza,50108,Fombuena,0,1,-1
2016,Zaragoza,50110,Frasno (El),1,5,-4
2016,Zaragoza,50111,Fréscano,0,5,-5
2016,Zaragoza,50113,Fuendejalón,5,7,-2
2016,Zaragoza,50114,Fuendetodos,0,1,-1
2016,Zaragoza,50115,Fuentes de Ebro,40,50,-10
2016,Zaragoza,50116,Fuentes de Jiloca,0,9,-9
2016,Zaragoza,50117,Gallocanta,0,1,-1
2016,Zaragoza,50118,Gallur,13,25,-12
2016,Zaragoza,50119,Gelsa,5,13,-8
2016,Zaragoza,50120,Godojos,0,1,-1
2016,Zaragoza,50121,Gotor,0,1,-1
2016,Zaragoza,50122,Grisel,1,2,-1
2016,Zaragoza,50123,Grisén,9,10,-1
2016,Zaragoza,50124,Herrera de los Navarros,1,3,-2
2016,Zaragoza,50125,Ibdes,3,8,-5
2016,Zaragoza,50126,Illueca,18,27,-9
2016,Zaragoza,50129,Jaraba,1,3,-2
2016,Zaragoza,50130,Jarque de Moncayo,2,11,-9
2016,Zaragoza,50131,Jaulín,2,7,-5
2016,Zaragoza,50132,Joyosa (La),7,8,-1
2016,Zaragoza,50133,Lagata,0,1,-1
2016,Zaragoza,50134,Langa del Castillo,1,1,0
2016,Zaragoza,50135,Layana,0,2,-2
2016,Zaragoza,50138,Lechón,0,1,-1
2016,Zaragoza,50137,Leciñena,3,18,-15
2016,Zaragoza,50139,Letux,0,8,-8
2016,Zaragoza,50140,Litago,0,3,-3
2016,Zaragoza,50141,Lituénigo,1,3,-2
2016,Zaragoza,50142,Lobera de Onsella,0,1,-1
2016,Zaragoza,50143,Longares,5,9,-4
2016,Zaragoza,50146,Lucena de Jalón,2,3,-1
2016,Zaragoza,50147,Luceni,3,12,-9
2016,Zaragoza,50148,Luesia,1,8,-7
2016,Zaragoza,50150,Lumpiaque,4,20,-16
2016,Zaragoza,50151,Luna,0,10,-10
2016,Zaragoza,50136,Lécera,2,12,-10
2016,Zaragoza,50152,Maella,17,26,-9
2016,Zaragoza,50153,Magallón,9,18,-9
2016,Zaragoza,50154,Mainar,0,1,-1
2016,Zaragoza,50156,Maleján,1,3,-2
2016,Zaragoza,50160,Mallén,26,31,-5
2016,Zaragoza,50159,Maluenda,6,16,-10
2016,Zaragoza,50157,Malón,2,5,-3
2016,Zaragoza,50161,Manchones,1,2,-1
2016,Zaragoza,50162,Mara,0,4,-4
2016,Zaragoza,50902,Marracos,0,3,-3
2016,Zaragoza,50163,María de Huerva,98,14,84
2016,Zaragoza,50164,Mediana de Aragón,5,3,2
2016,Zaragoza,50165,Mequinenza,14,25,-11
2016,Zaragoza,50166,Mesones de Isuela,1,6,-5
2016,Zaragoza,50167,Mezalocha,2,1,1
2016,Zaragoza,50169,Miedes de Aragón,1,1,0
2016,Zaragoza,50170,Monegrillo,1,2,-1
2016,Zaragoza,50171,Moneva,0,3,-3
2016,Zaragoza,50172,Monreal de Ariza,0,4,-4
2016,Zaragoza,50173,Monterde,0,2,-2
2016,Zaragoza,50174,Montón,0,2,-2
2016,Zaragoza,50175,Morata de Jalón,3,20,-17
2016,Zaragoza,50176,Morata de Jiloca,0,3,-3
2016,Zaragoza,50178,Moros,1,11,-10
2016,Zaragoza,50177,Morés,1,6,-5
2016,Zaragoza,50179,Moyuela,0,5,-5
2016,Zaragoza,50180,Mozota,1,0,1
2016,Zaragoza,50181,Muel,10,20,-10
2016,Zaragoza,50182,Muela (La),69,21,48
2016,Zaragoza,50183,Munébrega,1,8,-7
2016,Zaragoza,50184,Murero,1,6,-5
2016,Zaragoza,50185,Murillo de Gállego,1,0,1
2016,Zaragoza,50187,Nigüella,0,3,-3
2016,Zaragoza,50189,Nonaspe,8,10,-2
2016,Zaragoza,50190,Novallas,7,15,-8
2016,Zaragoza,50191,Novillas,1,12,-11
2016,Zaragoza,50193,Nuez de Ebro,7,5,2
2016,Zaragoza,50192,Nuévalos,0,4,-4
2016,Zaragoza,50194,Olvés,0,2,-2
2016,Zaragoza,50195,Orcajo,1,0,1
2016,Zaragoza,50196,Orera,0,4,-4
2016,Zaragoza,50197,Orés,0,3,-3
2016,Zaragoza,50199,Osera de Ebro,2,8,-6
2016,Zaragoza,50200,Paniza,6,14,-8
2016,Zaragoza,50201,Paracuellos de Jiloca,1,6,-5
2016,Zaragoza,50202,Paracuellos de la Ribera,0,8,-8
2016,Zaragoza,50203,Pastriz,6,12,-6
2016,Zaragoza,50204,Pedrola,24,37,-13
2016,Zaragoza,50205,Pedrosas (Las),1,4,-3
2016,Zaragoza,50206,Perdiguera,2,6,-4
2016,Zaragoza,50208,Pina de Ebro,28,26,2
2016,Zaragoza,50209,Pinseque,48,41,7
2016,Zaragoza,50210,Pintanos (Los),0,1,-1
2016,Zaragoza,50211,Plasencia de Jalón,1,4,-3
2016,Zaragoza,50212,Pleitas,0,3,-3
2016,Zaragoza,50214,Pomer,0,1,-1
2016,Zaragoza,50215,Pozuel de Ariza,0,1,-1
2016,Zaragoza,50216,Pozuelo de Aragón,1,3,-2
2016,Zaragoza,50217,Pradilla de Ebro,5,12,-7
2016,Zaragoza,50218,Puebla de Albortón,1,1,0
2016,Zaragoza,50219,Puebla de Alfindén (La),75,22,53
2016,Zaragoza,50220,Puendeluna,0,3,-3
2016,Zaragoza,50222,Quinto,13,21,-8
2016,Zaragoza,50223,Remolinos,5,19,-14
2016,Zaragoza,50224,Retascón,0,1,-1
2016,Zaragoza,50225,Ricla,23,25,-2
2016,Zaragoza,50227,Romanos,0,6,-6
2016,Zaragoza,50228,Rueda de Jalón,5,6,-1
2016,Zaragoza,50229,Ruesca,0,1,-1
2016,Zaragoza,50231,Salillas de Jalón,1,13,-12
2016,Zaragoza,50232,Salvatierra de Esca,1,2,-1
2016,Zaragoza,50233,Samper del Salz,0,1,-1
2016,Zaragoza,50234,San Martín de la Virgen de Moncayo,4,4,0
2016,Zaragoza,50235,San Mateo de Gállego,25,35,-10
2016,Zaragoza,50236,Santa Cruz de Grío,0,1,-1
2016,Zaragoza,50237,Santa Cruz de Moncayo,2,3,-1
2016,Zaragoza,50238,Santa Eulalia de Gállego,1,4,-3
2016,Zaragoza,50241,Saviñán,3,12,-9
2016,Zaragoza,50243,Sestrica,0,7,-7
2016,Zaragoza,50244,Sierra de Luna,2,9,-7
2016,Zaragoza,50246,Sisamón,0,1,-1
2016,Zaragoza,50247,Sobradiel,10,13,-3
2016,Zaragoza,50248,Sos del Rey Católico,7,10,-3
2016,Zaragoza,50230,Sádaba,6,38,-32
2016,Zaragoza,50240,Sástago,10,12,-2
2016,Zaragoza,50249,Tabuenca,0,9,-9
2016,Zaragoza,50251,Tarazona,74,126,-52
2016,Zaragoza,50252,Tauste,61,89,-28
2016,Zaragoza,50253,Terrer,0,13,-13
2016,Zaragoza,50254,Tierga,1,3,-2
2016,Zaragoza,50255,Tobed,1,4,-3
2016,Zaragoza,50256,Torralba de los Frailes,0,1,-1
2016,Zaragoza,50257,Torralba de Ribota,0,2,-2
2016,Zaragoza,50258,Torralbilla,0,2,-2
2016,Zaragoza,50259,Torrehermosa,0,3,-3
2016,Zaragoza,50261,Torrellas,2,3,-1
2016,Zaragoza,50262,Torres de Berrellén,6,14,-8
2016,Zaragoza,50263,Torrijo de la Cañada,1,6,-5
2016,Zaragoza,50264,Tosos,0,3,-3
2016,Zaragoza,50265,Trasmoz,0,2,-2
2016,Zaragoza,50266,Trasobares,0,4,-4
2016,Zaragoza,50267,Uncastillo,2,10,-8
2016,Zaragoza,50269,Urrea de Jalón,2,6,-4
2016,Zaragoza,50270,Urriés,0,1,-1
2016,Zaragoza,50271,Used,1,3,-2
2016,Zaragoza,50272,Utebo,148,94,54
2016,Zaragoza,50274,Val de San Martín,0,1,-1
2016,Zaragoza,50275,Valmadrid,0,1,-1
2016,Zaragoza,50276,Valpalmas,0,2,-2
2016,Zaragoza,50277,Valtorres,1,6,-5
2016,Zaragoza,50278,Velilla de Ebro,0,2,-2
2016,Zaragoza,50279,Velilla de Jiloca,0,3,-3
2016,Zaragoza,50280,Vera de Moncayo,1,10,-9
2016,Zaragoza,50281,Vierlas,0,3,-3
2016,Zaragoza,50283,Villadoz,1,0,1
2016,Zaragoza,50284,Villafeliche,0,3,-3
2016,Zaragoza,50285,Villafranca de Ebro,8,10,-2
2016,Zaragoza,50286,Villalba de Perejil,0,2,-2
2016,Zaragoza,50287,Villalengua,0,4,-4
2016,Zaragoza,50903,Villamayor de Gállego,14,29,-15
2016,Zaragoza,50288,Villanueva de Gállego,18,40,-22
2016,Zaragoza,50290,Villanueva de Huerva,2,8,-6
2016,Zaragoza,50289,Villanueva de Jiloca,0,1,-1
2016,Zaragoza,50292,Villarreal de Huerva,5,0,5
2016,Zaragoza,50293,Villarroya de la Sierra,3,12,-9
2016,Zaragoza,50294,Villarroya del Campo,0,1,-1
2016,Zaragoza,50295,Vistabella,0,0,0
2016,Zaragoza,50296,Zaida (La),2,7,-5
2016,Zaragoza,50297,Zaragoza,5837,6241,-404
2016,Zaragoza,50298,Zuera,94,65,29
2016,Zaragoza,50099,Épila,46,48,-2
2015,Zaragoza,50001,Abanto,0,3,-3
2015,Zaragoza,50002,Acered,0,4,-4
2015,Zaragoza,50004,Aguarón,4,18,-14
2015,Zaragoza,50005,Aguilón,0,2,-2
2015,Zaragoza,50003,Agón,1,3,-2
2015,Zaragoza,50006,Ainzón,5,15,-10
2015,Zaragoza,50008,Alagón,58,75,-17
2015,Zaragoza,50009,Alarba,0,1,-1
2015,Zaragoza,50010,Alberite de San Juan,0,2,-2
2015,Zaragoza,50011,Albeta,0,1,-1
2015,Zaragoza,50012,Alborge,0,2,-2
2015,Zaragoza,50013,Alcalá de Ebro,1,5,-4
2015,Zaragoza,50014,Alcalá de Moncayo,0,2,-2
2015,Zaragoza,50015,Alconchel de Ariza,1,1,0
2015,Zaragoza,50016,Aldehuela de Liestos,0,2,-2
2015,Zaragoza,50017,Alfajarín,18,14,4
2015,Zaragoza,50018,Alfamén,15,17,-2
2015,Zaragoza,50020,Alhama de Aragón,5,17,-12
2015,Zaragoza,50021,Almochuel,0,1,-1
2015,Zaragoza,50022,Almolda (La),2,14,-12
2015,Zaragoza,50023,Almonacid de la Cuba,2,1,1
2015,Zaragoza,50024,Almonacid de la Sierra,1,15,-14
2015,Zaragoza,50025,Almunia de Doña Godina (La),77,85,-8
2015,Zaragoza,50026,Alpartir,3,6,-3
2015,Zaragoza,50027,Ambel,4,5,-1
2015,Zaragoza,50029,Aniñón,4,14,-10
2015,Zaragoza,50031,Aranda de Moncayo,1,6,-5
2015,Zaragoza,50034,Ariza,4,17,-13
2015,Zaragoza,50035,Artieda,0,1,-1
2015,Zaragoza,50032,Arándiga,2,6,-4
2015,Zaragoza,50036,Asín,0,3,-3
2015,Zaragoza,50037,Atea,0,2,-2
2015,Zaragoza,50038,Ateca,9,31,-22
2015,Zaragoza,50039,Azuara,0,9,-9
2015,Zaragoza,50030,Añón de Moncayo,0,7,-7
2015,Zaragoza,50040,Badules,0,2,-2
2015,Zaragoza,50042,Balconchán,0,1,-1
2015,Zaragoza,50044,Bardallur,1,1,0
2015,Zaragoza,50045,Belchite,7,31,-24
2015,Zaragoza,50046,Belmonte de Gracián,0,1,-1
2015,Zaragoza,50047,Berdejo,0,0,0
2015,Zaragoza,50048,Berrueco,0,0,0
2015,Zaragoza,50901,Biel,0,2,-2
2015,Zaragoza,50050,Bijuesca,1,0,1
2015,Zaragoza,50051,Biota,2,17,-15
2015,Zaragoza,50053,Boquiñeni,3,15,-12
2015,Zaragoza,50054,Bordalba,0,1,-1
2015,Zaragoza,50055,Borja,57,59,-2
2015,Zaragoza,50056,Botorrita,5,5,0
2015,Zaragoza,50057,Brea de Aragón,11,19,-8
2015,Zaragoza,50058,Bubierca,0,3,-3
2015,Zaragoza,50059,Bujaraloz,2,9,-7
2015,Zaragoza,50060,Bulbuente,1,3,-2
2015,Zaragoza,50061,Bureta,0,6,-6
2015,Zaragoza,50062,Burgo de Ebro (El),15,13,2
2015,Zaragoza,50063,Buste (El),1,0,1
2015,Zaragoza,50043,Bárboles,0,1,-1
2015,Zaragoza,50064,Cabañas de Ebro,3,11,-8
2015,Zaragoza,50065,Cabolafuente,0,4,-4
2015,Zaragoza,50066,Cadrete,42,25,17
2015,Zaragoza,50067,Calatayud,149,231,-82
2015,Zaragoza,50068,Calatorao,31,33,-2
2015,Zaragoza,50069,Calcena,0,4,-4
2015,Zaragoza,50070,Calmarza,1,4,-3
2015,Zaragoza,50071,Campillo de Aragón,1,1,0
2015,Zaragoza,50072,Carenas,1,3,-2
2015,Zaragoza,50073,Cariñena,30,35,-5
2015,Zaragoza,50074,Caspe,112,101,11
2015,Zaragoza,50075,Castejón de Alarba,0,3,-3
2015,Zaragoza,50076,Castejón de las Armas,0,2,-2
2015,Zaragoza,50077,Castejón de Valdejasa,0,4,-4
2015,Zaragoza,50078,Castiliscar,1,3,-2
2015,Zaragoza,50079,Cervera de la Cañada,1,2,-1
2015,Zaragoza,50081,Cetina,4,16,-12
2015,Zaragoza,50092,Chiprana,9,10,-1
2015,Zaragoza,50093,Chodes,1,3,-2
2015,Zaragoza,50082,Cimballa,0,2,-2
2015,Zaragoza,50084,Clarés de Ribota,0,4,-4
2015,Zaragoza,50085,Codo,0,3,-3
2015,Zaragoza,50086,Codos,0,12,-12
2015,Zaragoza,50088,Cosuenda,1,8,-7
2015,Zaragoza,50089,Cuarte de Huerva,237,33,204
2015,Zaragoza,50090,Cubel,0,6,-6
2015,Zaragoza,50091,Cuerlas (Las),0,2,-2
2015,Zaragoza,50094,Daroca,12,42,-30
2015,Zaragoza,50095,Ejea de los Caballeros,118,164,-46
2015,Zaragoza,50098,Encinacorba,0,4,-4
2015,Zaragoza,50100,Erla,0,7,-7
2015,Zaragoza,50101,Escatrón,10,23,-13
2015,Zaragoza,50102,Fabara,2,12,-10
2015,Zaragoza,50104,Farlete,0,5,-5
2015,Zaragoza,50106,Fayos (Los),0,4,-4
2015,Zaragoza,50105,Fayón,6,6,0
2015,Zaragoza,50107,Figueruelas,10,24,-14
2015,Zaragoza,50110,Frasno (El),0,7,-7
2015,Zaragoza,50111,Fréscano,3,3,0
2015,Zaragoza,50113,Fuendejalón,5,11,-6
2015,Zaragoza,50114,Fuendetodos,0,5,-5
2015,Zaragoza,50115,Fuentes de Ebro,43,50,-7
2015,Zaragoza,50116,Fuentes de Jiloca,0,7,-7
2015,Zaragoza,50117,Gallocanta,0,3,-3
2015,Zaragoza,50118,Gallur,14,45,-31
2015,Zaragoza,50119,Gelsa,5,17,-12
2015,Zaragoza,50120,Godojos,0,3,-3
2015,Zaragoza,50121,Gotor,0,1,-1
2015,Zaragoza,50122,Grisel,1,2,-1
2015,Zaragoza,50123,Grisén,3,9,-6
2015,Zaragoza,50124,Herrera de los Navarros,1,11,-10
2015,Zaragoza,50125,Ibdes,1,8,-7
2015,Zaragoza,50126,Illueca,14,35,-21
2015,Zaragoza,50128,Isuerre,0,2,-2
2015,Zaragoza,50129,Jaraba,2,4,-2
2015,Zaragoza,50130,Jarque de Moncayo,2,10,-8
2015,Zaragoza,50131,Jaulín,0,8,-8
2015,Zaragoza,50132,Joyosa (La),17,6,11
2015,Zaragoza,50133,Lagata,2,3,-1
2015,Zaragoza,50134,Langa del Castillo,0,1,-1
2015,Zaragoza,50135,Layana,0,1,-1
2015,Zaragoza,50138,Lechón,0,2,-2
2015,Zaragoza,50137,Leciñena,13,17,-4
2015,Zaragoza,50139,Letux,0,3,-3
2015,Zaragoza,50140,Litago,0,2,-2
2015,Zaragoza,50141,Lituénigo,1,2,-1
2015,Zaragoza,50142,Lobera de Onsella,0,2,-2
2015,Zaragoza,50143,Longares,4,10,-6
2015,Zaragoza,50146,Lucena de Jalón,3,8,-5
2015,Zaragoza,50147,Luceni,10,23,-13
2015,Zaragoza,50148,Luesia,0,11,-11
2015,Zaragoza,50150,Lumpiaque,6,16,-10
2015,Zaragoza,50151,Luna,2,16,-14
2015,Zaragoza,50136,Lécera,6,11,-5
2015,Zaragoza,50152,Maella,16,40,-24
2015,Zaragoza,50153,Magallón,1,12,-11
2015,Zaragoza,50154,Mainar,0,3,-3
2015,Zaragoza,50155,Malanquilla,0,2,-2
2015,Zaragoza,50156,Maleján,1,6,-5
2015,Zaragoza,50160,Mallén,27,26,1
2015,Zaragoza,50159,Maluenda,3,19,-16
2015,Zaragoza,50157,Malón,1,13,-12
2015,Zaragoza,50161,Manchones,0,1,-1
2015,Zaragoza,50162,Mara,1,3,-2
2015,Zaragoza,50902,Marracos,0,2,-2
2015,Zaragoza,50163,María de Huerva,87,21,66
2015,Zaragoza,50164,Mediana de Aragón,1,7,-6
2015,Zaragoza,50165,Mequinenza,22,27,-5
2015,Zaragoza,50166,Mesones de Isuela,0,5,-5
2015,Zaragoza,50167,Mezalocha,0,4,-4
2015,Zaragoza,50169,Miedes de Aragón,2,13,-11
2015,Zaragoza,50170,Monegrillo,2,12,-10
2015,Zaragoza,50171,Moneva,0,1,-1
2015,Zaragoza,50172,Monreal de Ariza,1,8,-7
2015,Zaragoza,50173,Monterde,0,2,-2
2015,Zaragoza,50175,Morata de Jalón,5,19,-14
2015,Zaragoza,50176,Morata de Jiloca,1,4,-3
2015,Zaragoza,50178,Moros,1,8,-7
2015,Zaragoza,50177,Morés,3,8,-5
2015,Zaragoza,50179,Moyuela,0,5,-5
2015,Zaragoza,50180,Mozota,0,1,-1
2015,Zaragoza,50181,Muel,10,21,-11
2015,Zaragoza,50182,Muela (La),74,24,50
2015,Zaragoza,50183,Munébrega,2,9,-7
2015,Zaragoza,50184,Murero,0,0,0
2015,Zaragoza,50185,Murillo de Gállego,0,0,0
2015,Zaragoza,50187,Nigüella,0,3,-3
2015,Zaragoza,50189,Nonaspe,2,17,-15
2015,Zaragoza,50190,Novallas,1,12,-11
2015,Zaragoza,50191,Novillas,1,10,-9
2015,Zaragoza,50193,Nuez de Ebro,12,3,9
2015,Zaragoza,50192,Nuévalos,5,3,2
2015,Zaragoza,50196,Orera,0,2,-2
2015,Zaragoza,50197,Orés,0,2,-2
2015,Zaragoza,50199,Osera de Ebro,1,10,-9
2015,Zaragoza,50200,Paniza,0,8,-8
2015,Zaragoza,50201,Paracuellos de Jiloca,8,12,-4
2015,Zaragoza,50202,Paracuellos de la Ribera,0,3,-3
2015,Zaragoza,50203,Pastriz,11,19,-8
2015,Zaragoza,50204,Pedrola,28,27,1
2015,Zaragoza,50205,Pedrosas (Las),0,2,-2
2015,Zaragoza,50206,Perdiguera,5,6,-1
2015,Zaragoza,50207,Piedratajada,0,1,-1
2015,Zaragoza,50208,Pina de Ebro,10,15,-5
2015,Zaragoza,50209,Pinseque,60,69,-9
2015,Zaragoza,50210,Pintanos (Los),0,1,-1
2015,Zaragoza,50211,Plasencia de Jalón,1,3,-2
2015,Zaragoza,50212,Pleitas,0,1,-1
2015,Zaragoza,50213,Plenas,0,3,-3
2015,Zaragoza,50214,Pomer,0,1,-1
2015,Zaragoza,50215,Pozuel de Ariza,0,2,-2
2015,Zaragoza,50216,Pozuelo de Aragón,1,6,-5
2015,Zaragoza,50217,Pradilla de Ebro,3,9,-6
2015,Zaragoza,50218,Puebla de Albortón,0,3,-3
2015,Zaragoza,50219,Puebla de Alfindén (La),90,28,62
2015,Zaragoza,50220,Puendeluna,0,2,-2
2015,Zaragoza,50222,Quinto,13,25,-12
2015,Zaragoza,50223,Remolinos,1,17,-16
2015,Zaragoza,50224,Retascón,0,1,-1
2015,Zaragoza,50225,Ricla,20,28,-8
2015,Zaragoza,50227,Romanos,0,2,-2
2015,Zaragoza,50228,Rueda de Jalón,1,2,-1
2015,Zaragoza,50229,Ruesca,0,1,-1
2015,Zaragoza,50231,Salillas de Jalón,2,7,-5
2015,Zaragoza,50232,Salvatierra de Esca,1,2,-1
2015,Zaragoza,50233,Samper del Salz,0,2,-2
2015,Zaragoza,50234,San Martín de la Virgen de Moncayo,2,4,-2
2015,Zaragoza,50235,San Mateo de Gállego,29,29,0
2015,Zaragoza,50236,Santa Cruz de Grío,0,3,-3
2015,Zaragoza,50237,Santa Cruz de Moncayo,0,1,-1
2015,Zaragoza,50238,Santa Eulalia de Gállego,0,2,-2
2015,Zaragoza,50239,Santed,0,1,-1
2015,Zaragoza,50241,Saviñán,1,21,-20
2015,Zaragoza,50243,Sestrica,0,8,-8
2015,Zaragoza,50244,Sierra de Luna,0,1,-1
2015,Zaragoza,50245,Sigüés,0,3,-3
2015,Zaragoza,50246,Sisamón,0,1,-1
2015,Zaragoza,50247,Sobradiel,10,12,-2
2015,Zaragoza,50248,Sos del Rey Católico,3,4,-1
2015,Zaragoza,50230,Sádaba,2,32,-30
2015,Zaragoza,50240,Sástago,9,28,-19
2015,Zaragoza,50249,Tabuenca,2,3,-1
2015,Zaragoza,50250,Talamantes,0,2,-2
2015,Zaragoza,50251,Tarazona,72,107,-35
2015,Zaragoza,50252,Tauste,46,90,-44
2015,Zaragoza,50253,Terrer,1,13,-12
2015,Zaragoza,50254,Tierga,1,3,-2
2015,Zaragoza,50255,Tobed,0,6,-6
2015,Zaragoza,50256,Torralba de los Frailes,0,2,-2
2015,Zaragoza,50257,Torralba de Ribota,0,3,-3
2015,Zaragoza,50258,Torralbilla,0,2,-2
2015,Zaragoza,50259,Torrehermosa,0,2,-2
2015,Zaragoza,50261,Torrellas,1,10,-9
2015,Zaragoza,50262,Torres de Berrellén,12,16,-4
2015,Zaragoza,50263,Torrijo de la Cañada,0,5,-5
2015,Zaragoza,50264,Tosos,1,10,-9
2015,Zaragoza,50265,Trasmoz,0,3,-3
2015,Zaragoza,50266,Trasobares,0,2,-2
2015,Zaragoza,50267,Uncastillo,0,17,-17
2015,Zaragoza,50268,Undués de Lerda,2,0,2
2015,Zaragoza,50269,Urrea de Jalón,3,7,-4
2015,Zaragoza,50270,Urriés,1,2,-1
2015,Zaragoza,50271,Used,0,5,-5
2015,Zaragoza,50272,Utebo,171,80,91
2015,Zaragoza,50274,Val de San Martín,0,2,-2
2015,Zaragoza,50273,Valdehorna,0,1,-1
2015,Zaragoza,50275,Valmadrid,0,3,-3
2015,Zaragoza,50276,Valpalmas,0,2,-2
2015,Zaragoza,50277,Valtorres,0,3,-3
2015,Zaragoza,50278,Velilla de Ebro,0,4,-4
2015,Zaragoza,50279,Velilla de Jiloca,1,4,-3
2015,Zaragoza,50280,Vera de Moncayo,3,3,0
2015,Zaragoza,50281,Vierlas,3,2,1
2015,Zaragoza,50283,Villadoz,0,1,-1
2015,Zaragoza,50284,Villafeliche,0,7,-7
2015,Zaragoza,50285,Villafranca de Ebro,7,10,-3
2015,Zaragoza,50286,Villalba de Perejil,1,0,1
2015,Zaragoza,50287,Villalengua,1,4,-3
2015,Zaragoza,50903,Villamayor de Gállego,11,27,-16
2015,Zaragoza,50288,Villanueva de Gállego,43,38,5
2015,Zaragoza,50290,Villanueva de Huerva,1,11,-10
2015,Zaragoza,50289,Villanueva de Jiloca,0,2,-2
2015,Zaragoza,50291,Villar de los Navarros,0,3,-3
2015,Zaragoza,50292,Villarreal de Huerva,2,3,-1
2015,Zaragoza,50293,Villarroya de la Sierra,0,17,-17
2015,Zaragoza,50294,Villarroya del Campo,0,3,-3
2015,Zaragoza,50282,Vilueña (La),0,1,-1
2015,Zaragoza,50295,Vistabella,0,2,-2
2015,Zaragoza,50296,Zaida (La),1,3,-2
2015,Zaragoza,50297,Zaragoza,6107,6448,-341
2015,Zaragoza,50298,Zuera,88,82,6
2015,Zaragoza,50099,Épila,57,53,4
2014,Zaragoza,50001,Abanto,0,1,-1
2014,Zaragoza,50002,Acered,0,1,-1
2014,Zaragoza,50004,Aguarón,2,9,-7
2014,Zaragoza,50005,Aguilón,0,3,-3
2014,Zaragoza,50003,Agón,0,3,-3
2014,Zaragoza,50006,Ainzón,7,21,-14
2014,Zaragoza,50008,Alagón,58,69,-11
2014,Zaragoza,50010,Alberite de San Juan,0,1,-1
2014,Zaragoza,50011,Albeta,1,0,1
2014,Zaragoza,50012,Alborge,0,1,-1
2014,Zaragoza,50013,Alcalá de Ebro,2,4,-2
2014,Zaragoza,50014,Alcalá de Moncayo,0,1,-1
2014,Zaragoza,50015,Alconchel de Ariza,0,4,-4
2014,Zaragoza,50017,Alfajarín,17,17,0
2014,Zaragoza,50018,Alfamén,14,19,-5
2014,Zaragoza,50019,Alforque,0,1,-1
2014,Zaragoza,50020,Alhama de Aragón,11,13,-2
2014,Zaragoza,50022,Almolda (La),5,9,-4
2014,Zaragoza,50023,Almonacid de la Cuba,0,7,-7
2014,Zaragoza,50024,Almonacid de la Sierra,3,14,-11
2014,Zaragoza,50025,Almunia de Doña Godina (La),91,77,14
2014,Zaragoza,50026,Alpartir,2,3,-1
2014,Zaragoza,50027,Ambel,0,3,-3
2014,Zaragoza,50029,Aniñón,1,7,-6
2014,Zaragoza,50031,Aranda de Moncayo,1,4,-3
2014,Zaragoza,50034,Ariza,8,14,-6
2014,Zaragoza,50035,Artieda,0,1,-1
2014,Zaragoza,50032,Arándiga,1,9,-8
2014,Zaragoza,50036,Asín,0,6,-6
2014,Zaragoza,50037,Atea,0,4,-4
2014,Zaragoza,50038,Ateca,1,27,-26
2014,Zaragoza,50039,Azuara,0,12,-12
2014,Zaragoza,50030,Añón de Moncayo,0,6,-6
2014,Zaragoza,50044,Bardallur,1,3,-2
2014,Zaragoza,50045,Belchite,6,25,-19
2014,Zaragoza,50046,Belmonte de Gracián,0,2,-2
2014,Zaragoza,50047,Berdejo,0,1,-1
2014,Zaragoza,50901,Biel,0,1,-1
2014,Zaragoza,50050,Bijuesca,0,2,-2
2014,Zaragoza,50051,Biota,3,14,-11
2014,Zaragoza,50052,Bisimbre,0,2,-2
2014,Zaragoza,50053,Boquiñeni,2,9,-7
2014,Zaragoza,50054,Bordalba,0,1,-1
2014,Zaragoza,50055,Borja,55,56,-1
2014,Zaragoza,50056,Botorrita,6,7,-1
2014,Zaragoza,50057,Brea de Aragón,11,22,-11
2014,Zaragoza,50058,Bubierca,0,0,0
2014,Zaragoza,50059,Bujaraloz,6,9,-3
2014,Zaragoza,50060,Bulbuente,0,5,-5
2014,Zaragoza,50061,Bureta,2,5,-3
2014,Zaragoza,50062,Burgo de Ebro (El),26,20,6
2014,Zaragoza,50063,Buste (El),0,1,-1
2014,Zaragoza,50043,Bárboles,3,3,0
2014,Zaragoza,50064,Cabañas de Ebro,1,5,-4
2014,Zaragoza,50066,Cadrete,44,13,31
2014,Zaragoza,50067,Calatayud,171,213,-42
2014,Zaragoza,50068,Calatorao,21,31,-10
2014,Zaragoza,50071,Campillo de Aragón,0,4,-4
2014,Zaragoza,50072,Carenas,1,4,-3
2014,Zaragoza,50073,Cariñena,22,54,-32
2014,Zaragoza,50074,Caspe,117,103,14
2014,Zaragoza,50075,Castejón de Alarba,1,1,0
2014,Zaragoza,50076,Castejón de las Armas,0,2,-2
2014,Zaragoza,50077,Castejón de Valdejasa,1,2,-1
2014,Zaragoza,50078,Castiliscar,1,5,-4
2014,Zaragoza,50079,Cervera de la Cañada,0,9,-9
2014,Zaragoza,50081,Cetina,3,13,-10
2014,Zaragoza,50092,Chiprana,3,4,-1
2014,Zaragoza,50093,Chodes,1,1,0
2014,Zaragoza,50082,Cimballa,0,2,-2
2014,Zaragoza,50083,Cinco Olivas,1,3,-2
2014,Zaragoza,50084,Clarés de Ribota,0,1,-1
2014,Zaragoza,50085,Codo,1,6,-5
2014,Zaragoza,50086,Codos,1,4,-3
2014,Zaragoza,50088,Cosuenda,0,4,-4
2014,Zaragoza,50089,Cuarte de Huerva,239,30,209
2014,Zaragoza,50090,Cubel,0,1,-1
2014,Zaragoza,50091,Cuerlas (Las),0,2,-2
2014,Zaragoza,50094,Daroca,14,48,-34
2014,Zaragoza,50095,Ejea de los Caballeros,135,172,-37
2014,Zaragoza,50096,Embid de Ariza,0,3,-3
2014,Zaragoza,50098,Encinacorba,0,5,-5
2014,Zaragoza,50100,Erla,2,6,-4
2014,Zaragoza,50101,Escatrón,5,21,-16
2014,Zaragoza,50102,Fabara,9,15,-6
2014,Zaragoza,50104,Farlete,1,4,-3
2014,Zaragoza,50106,Fayos (Los),0,1,-1
2014,Zaragoza,50105,Fayón,4,2,2
2014,Zaragoza,50107,Figueruelas,5,15,-10
2014,Zaragoza,50109,Frago (El),0,4,-4
2014,Zaragoza,50110,Frasno (El),0,10,-10
2014,Zaragoza,50111,Fréscano,1,3,-2
2014,Zaragoza,50113,Fuendejalón,6,15,-9
2014,Zaragoza,50114,Fuendetodos,0,1,-1
2014,Zaragoza,50115,Fuentes de Ebro,43,43,0
2014,Zaragoza,50116,Fuentes de Jiloca,1,4,-3
2014,Zaragoza,50117,Gallocanta,0,3,-3
2014,Zaragoza,50118,Gallur,21,28,-7
2014,Zaragoza,50119,Gelsa,7,14,-7
2014,Zaragoza,50121,Gotor,0,2,-2
2014,Zaragoza,50122,Grisel,0,1,-1
2014,Zaragoza,50123,Grisén,9,8,1
2014,Zaragoza,50124,Herrera de los Navarros,3,13,-10
2014,Zaragoza,50125,Ibdes,1,12,-11
2014,Zaragoza,50126,Illueca,13,26,-13
2014,Zaragoza,50129,Jaraba,3,2,1
2014,Zaragoza,50130,Jarque de Moncayo,1,7,-6
2014,Zaragoza,50131,Jaulín,0,13,-13
2014,Zaragoza,50132,Joyosa (La),11,12,-1
2014,Zaragoza,50133,Lagata,0,2,-2
2014,Zaragoza,50134,Langa del Castillo,0,4,-4
2014,Zaragoza,50137,Leciñena,13,19,-6
2014,Zaragoza,50139,Letux,1,7,-6
2014,Zaragoza,50140,Litago,0,4,-4
2014,Zaragoza,50141,Lituénigo,0,2,-2
2014,Zaragoza,50142,Lobera de Onsella,0,1,-1
2014,Zaragoza,50143,Longares,5,9,-4
2014,Zaragoza,50146,Lucena de Jalón,2,7,-5
2014,Zaragoza,50147,Luceni,16,22,-6
2014,Zaragoza,50148,Luesia,1,11,-10
2014,Zaragoza,50149,Luesma,0,1,-1
2014,Zaragoza,50150,Lumpiaque,3,19,-16
2014,Zaragoza,50151,Luna,2,9,-7
2014,Zaragoza,50136,Lécera,1,18,-17
2014,Zaragoza,50152,Maella,16,24,-8
2014,Zaragoza,50153,Magallón,6,22,-16
2014,Zaragoza,50154,Mainar,0,3,-3
2014,Zaragoza,50155,Malanquilla,0,2,-2
2014,Zaragoza,50156,Maleján,2,2,0
2014,Zaragoza,50160,Mallén,27,44,-17
2014,Zaragoza,50159,Maluenda,4,22,-18
2014,Zaragoza,50157,Malón,3,10,-7
2014,Zaragoza,50162,Mara,0,3,-3
2014,Zaragoza,50902,Marracos,0,2,-2
2014,Zaragoza,50163,María de Huerva,107,23,84
2014,Zaragoza,50164,Mediana de Aragón,5,7,-2
2014,Zaragoza,50165,Mequinenza,13,19,-6
2014,Zaragoza,50166,Mesones de Isuela,2,5,-3
2014,Zaragoza,50167,Mezalocha,0,5,-5
2014,Zaragoza,50169,Miedes de Aragón,2,3,-1
2014,Zaragoza,50170,Monegrillo,1,8,-7
2014,Zaragoza,50172,Monreal de Ariza,0,2,-2
2014,Zaragoza,50173,Monterde,0,2,-2
2014,Zaragoza,50174,Montón,0,3,-3
2014,Zaragoza,50175,Morata de Jalón,4,10,-6
2014,Zaragoza,50176,Morata de Jiloca,0,7,-7
2014,Zaragoza,50178,Moros,0,4,-4
2014,Zaragoza,50177,Morés,0,5,-5
2014,Zaragoza,50179,Moyuela,0,7,-7
2014,Zaragoza,50180,Mozota,1,2,-1
2014,Zaragoza,50181,Muel,14,18,-4
2014,Zaragoza,50182,Muela (La),88,18,70
2014,Zaragoza,50183,Munébrega,0,4,-4
2014,Zaragoza,50184,Murero,0,3,-3
2014,Zaragoza,50185,Murillo de Gállego,0,2,-2
2014,Zaragoza,50187,Nigüella,0,1,-1
2014,Zaragoza,50189,Nonaspe,4,14,-10
2014,Zaragoza,50190,Novallas,5,17,-12
2014,Zaragoza,50191,Novillas,4,6,-2
2014,Zaragoza,50193,Nuez de Ebro,8,8,0
2014,Zaragoza,50192,Nuévalos,4,4,0
2014,Zaragoza,50194,Olvés,0,1,-1
2014,Zaragoza,50195,Orcajo,0,2,-2
2014,Zaragoza,50196,Orera,0,3,-3
2014,Zaragoza,50197,Orés,1,1,0
2014,Zaragoza,50199,Osera de Ebro,1,6,-5
2014,Zaragoza,50200,Paniza,10,11,-1
2014,Zaragoza,50201,Paracuellos de Jiloca,4,8,-4
2014,Zaragoza,50202,Paracuellos de la Ribera,0,1,-1
2014,Zaragoza,50203,Pastriz,5,11,-6
2014,Zaragoza,50204,Pedrola,24,32,-8
2014,Zaragoza,50205,Pedrosas (Las),1,1,0
2014,Zaragoza,50206,Perdiguera,4,8,-4
2014,Zaragoza,50207,Piedratajada,0,1,-1
2014,Zaragoza,50208,Pina de Ebro,24,26,-2
2014,Zaragoza,50209,Pinseque,36,49,-13
2014,Zaragoza,50211,Plasencia de Jalón,2,4,-2
2014,Zaragoza,50212,Pleitas,1,0,1
2014,Zaragoza,50213,Plenas,0,3,-3
2014,Zaragoza,50214,Pomer,0,2,-2
2014,Zaragoza,50216,Pozuelo de Aragón,2,9,-7
2014,Zaragoza,50217,Pradilla de Ebro,0,10,-10
2014,Zaragoza,50218,Puebla de Albortón,1,2,-1
2014,Zaragoza,50219,Puebla de Alfindén (La),80,27,53
2014,Zaragoza,50220,Puendeluna,0,1,-1
2014,Zaragoza,50222,Quinto,18,25,-7
2014,Zaragoza,50223,Remolinos,9,9,0
2014,Zaragoza,50224,Retascón,0,0,0
2014,Zaragoza,50225,Ricla,20,32,-12
2014,Zaragoza,50227,Romanos,0,1,-1
2014,Zaragoza,50228,Rueda de Jalón,2,6,-4
2014,Zaragoza,50231,Salillas de Jalón,0,4,-4
2014,Zaragoza,50232,Salvatierra de Esca,3,2,1
2014,Zaragoza,50233,Samper del Salz,1,2,-1
2014,Zaragoza,50234,San Martín de la Virgen de Moncayo,0,4,-4
2014,Zaragoza,50235,San Mateo de Gállego,28,30,-2
2014,Zaragoza,50236,Santa Cruz de Grío,0,3,-3
2014,Zaragoza,50238,Santa Eulalia de Gállego,0,5,-5
2014,Zaragoza,50241,Saviñán,5,13,-8
2014,Zaragoza,50242,Sediles,0,1,-1
2014,Zaragoza,50243,Sestrica,0,6,-6
2014,Zaragoza,50244,Sierra de Luna,0,2,-2
2014,Zaragoza,50245,Sigüés,1,1,0
2014,Zaragoza,50246,Sisamón,0,1,-1
2014,Zaragoza,50247,Sobradiel,15,11,4
2014,Zaragoza,50248,Sos del Rey Católico,1,5,-4
2014,Zaragoza,50230,Sádaba,5,28,-23
2014,Zaragoza,50240,Sástago,10,19,-9
2014,Zaragoza,50249,Tabuenca,0,5,-5
2014,Zaragoza,50250,Talamantes,0,2,-2
2014,Zaragoza,50251,Tarazona,100,115,-15
2014,Zaragoza,50252,Tauste,55,107,-52
2014,Zaragoza,50253,Terrer,3,8,-5
2014,Zaragoza,50254,Tierga,1,2,-1
2014,Zaragoza,50255,Tobed,0,12,-12
2014,Zaragoza,50256,Torralba de los Frailes,0,1,-1
2014,Zaragoza,50257,Torralba de Ribota,0,7,-7
2014,Zaragoza,50258,Torralbilla,0,1,-1
2014,Zaragoza,50259,Torrehermosa,0,2,-2
2014,Zaragoza,50261,Torrellas,1,7,-6
2014,Zaragoza,50262,Torres de Berrellén,7,15,-8
2014,Zaragoza,50263,Torrijo de la Cañada,0,5,-5
2014,Zaragoza,50264,Tosos,1,5,-4
2014,Zaragoza,50265,Trasmoz,0,1,-1
2014,Zaragoza,50266,Trasobares,0,3,-3
2014,Zaragoza,50267,Uncastillo,1,17,-16
2014,Zaragoza,50268,Undués de Lerda,2,0,2
2014,Zaragoza,50269,Urrea de Jalón,2,18,-16
2014,Zaragoza,50271,Used,0,5,-5
2014,Zaragoza,50272,Utebo,181,100,81
2014,Zaragoza,50274,Val de San Martín,0,1,-1
2014,Zaragoza,50273,Valdehorna,0,1,-1
2014,Zaragoza,50275,Valmadrid,0,4,-4
2014,Zaragoza,50276,Valpalmas,0,1,-1
2014,Zaragoza,50277,Valtorres,2,3,-1
2014,Zaragoza,50278,Velilla de Ebro,1,2,-1
2014,Zaragoza,50279,Velilla de Jiloca,0,3,-3
2014,Zaragoza,50280,Vera de Moncayo,1,8,-7
2014,Zaragoza,50281,Vierlas,0,1,-1
2014,Zaragoza,50283,Villadoz,0,1,-1
2014,Zaragoza,50284,Villafeliche,0,6,-6
2014,Zaragoza,50285,Villafranca de Ebro,6,11,-5
2014,Zaragoza,50286,Villalba de Perejil,1,1,0
2014,Zaragoza,50287,Villalengua,0,6,-6
2014,Zaragoza,50903,Villamayor de Gállego,14,24,-10
2014,Zaragoza,50288,Villanueva de Gállego,56,46,10
2014,Zaragoza,50290,Villanueva de Huerva,2,9,-7
2014,Zaragoza,50291,Villar de los Navarros,0,3,-3
2014,Zaragoza,50292,Villarreal de Huerva,3,3,0
2014,Zaragoza,50293,Villarroya de la Sierra,1,9,-8
2014,Zaragoza,50294,Villarroya del Campo,0,2,-2
2014,Zaragoza,50282,Vilueña (La),0,1,-1
2014,Zaragoza,50296,Zaida (La),4,11,-7
2014,Zaragoza,50297,Zaragoza,6248,6363,-115
2014,Zaragoza,50298,Zuera,79,55,24
2014,Zaragoza,50099,Épila,38,49,-11
2013,Zaragoza,50001,Abanto,0,6,-6
2013,Zaragoza,50002,Acered,2,2,0
2013,Zaragoza,50004,Aguarón,2,9,-7
2013,Zaragoza,50005,Aguilón,1,2,-1
2013,Zaragoza,50003,Agón,1,4,-3
2013,Zaragoza,50006,Ainzón,1,16,-15
2013,Zaragoza,50007,Aladrén,0,1,-1
2013,Zaragoza,50008,Alagón,63,73,-10
2013,Zaragoza,50009,Alarba,0,2,-2
2013,Zaragoza,50010,Alberite de San Juan,0,1,-1
2013,Zaragoza,50011,Albeta,0,4,-4
2013,Zaragoza,50013,Alcalá de Ebro,1,3,-2
2013,Zaragoza,50014,Alcalá de Moncayo,1,4,-3
2013,Zaragoza,50016,Aldehuela de Liestos,0,2,-2
2013,Zaragoza,50017,Alfajarín,32,23,9
2013,Zaragoza,50018,Alfamén,8,22,-14
2013,Zaragoza,50019,Alforque,0,1,-1
2013,Zaragoza,50020,Alhama de Aragón,10,13,-3
2013,Zaragoza,50022,Almolda (La),1,5,-4
2013,Zaragoza,50023,Almonacid de la Cuba,0,2,-2
2013,Zaragoza,50024,Almonacid de la Sierra,8,15,-7
2013,Zaragoza,50025,Almunia de Doña Godina (La),51,73,-22
2013,Zaragoza,50026,Alpartir,6,5,1
2013,Zaragoza,50027,Ambel,0,6,-6
2013,Zaragoza,50029,Aniñón,2,10,-8
2013,Zaragoza,50031,Aranda de Moncayo,1,3,-2
2013,Zaragoza,50033,Ardisa,0,1,-1
2013,Zaragoza,50034,Ariza,8,21,-13
2013,Zaragoza,50035,Artieda,1,2,-1
2013,Zaragoza,50032,Arándiga,0,7,-7
2013,Zaragoza,50037,Atea,0,1,-1
2013,Zaragoza,50038,Ateca,3,18,-15
2013,Zaragoza,50039,Azuara,4,17,-13
2013,Zaragoza,50030,Añón de Moncayo,3,5,-2
2013,Zaragoza,50040,Badules,0,1,-1
2013,Zaragoza,50044,Bardallur,2,4,-2
2013,Zaragoza,50045,Belchite,7,18,-11
2013,Zaragoza,50046,Belmonte de Gracián,1,6,-5
2013,Zaragoza,50901,Biel,0,1,-1
2013,Zaragoza,50050,Bijuesca,0,1,-1
2013,Zaragoza,50051,Biota,1,19,-18
2013,Zaragoza,50052,Bisimbre,0,3,-3
2013,Zaragoza,50053,Boquiñeni,11,10,1
2013,Zaragoza,50055,Borja,39,50,-11
2013,Zaragoza,50056,Botorrita,2,3,-1
2013,Zaragoza,50057,Brea de Aragón,6,29,-23
2013,Zaragoza,50058,Bubierca,0,2,-2
2013,Zaragoza,50059,Bujaraloz,3,13,-10
2013,Zaragoza,50060,Bulbuente,1,8,-7
2013,Zaragoza,50061,Bureta,0,7,-7
2013,Zaragoza,50062,Burgo de Ebro (El),36,17,19
2013,Zaragoza,50063,Buste (El),0,0,0
2013,Zaragoza,50043,Bárboles,1,1,0
2013,Zaragoza,50064,Cabañas de Ebro,0,9,-9
2013,Zaragoza,50066,Cadrete,44,17,27
2013,Zaragoza,50067,Calatayud,154,208,-54
2013,Zaragoza,50068,Calatorao,22,25,-3
2013,Zaragoza,50069,Calcena,0,5,-5
2013,Zaragoza,50070,Calmarza,0,2,-2
2013,Zaragoza,50071,Campillo de Aragón,0,0,0
2013,Zaragoza,50072,Carenas,2,2,0
2013,Zaragoza,50073,Cariñena,27,50,-23
2013,Zaragoza,50074,Caspe,98,97,1
2013,Zaragoza,50075,Castejón de Alarba,0,1,-1
2013,Zaragoza,50076,Castejón de las Armas,0,2,-2
2013,Zaragoza,50077,Castejón de Valdejasa,1,5,-4
2013,Zaragoza,50078,Castiliscar,0,2,-2
2013,Zaragoza,50079,Cervera de la Cañada,1,7,-6
2013,Zaragoza,50081,Cetina,4,9,-5
2013,Zaragoza,50092,Chiprana,5,6,-1
2013,Zaragoza,50093,Chodes,0,0,0
2013,Zaragoza,50082,Cimballa,1,3,-2
2013,Zaragoza,50083,Cinco Olivas,0,2,-2
2013,Zaragoza,50084,Clarés de Ribota,0,3,-3
2013,Zaragoza,50085,Codo,0,7,-7
2013,Zaragoza,50086,Codos,0,2,-2
2013,Zaragoza,50087,Contamina,1,1,0
2013,Zaragoza,50088,Cosuenda,5,6,-1
2013,Zaragoza,50089,Cuarte de Huerva,229,29,200
2013,Zaragoza,50090,Cubel,1,3,-2
2013,Zaragoza,50091,Cuerlas (Las),0,1,-1
2013,Zaragoza,50094,Daroca,13,44,-31
2013,Zaragoza,50095,Ejea de los Caballeros,130,157,-27
2013,Zaragoza,50096,Embid de Ariza,0,2,-2
2013,Zaragoza,50098,Encinacorba,0,3,-3
2013,Zaragoza,50100,Erla,1,5,-4
2013,Zaragoza,50101,Escatrón,5,24,-19
2013,Zaragoza,50102,Fabara,8,18,-10
2013,Zaragoza,50104,Farlete,1,5,-4
2013,Zaragoza,50106,Fayos (Los),1,2,-1
2013,Zaragoza,50105,Fayón,2,7,-5
2013,Zaragoza,50107,Figueruelas,9,18,-9
2013,Zaragoza,50108,Fombuena,1,0,1
2013,Zaragoza,50109,Frago (El),0,1,-1
2013,Zaragoza,50110,Frasno (El),1,5,-4
2013,Zaragoza,50111,Fréscano,1,3,-2
2013,Zaragoza,50113,Fuendejalón,5,10,-5
2013,Zaragoza,50114,Fuendetodos,0,1,-1
2013,Zaragoza,50115,Fuentes de Ebro,47,42,5
2013,Zaragoza,50116,Fuentes de Jiloca,3,3,0
2013,Zaragoza,50117,Gallocanta,3,1,2
2013,Zaragoza,50118,Gallur,18,40,-22
2013,Zaragoza,50119,Gelsa,7,18,-11
2013,Zaragoza,50120,Godojos,0,2,-2
2013,Zaragoza,50121,Gotor,0,2,-2
2013,Zaragoza,50122,Grisel,0,1,-1
2013,Zaragoza,50123,Grisén,7,5,2
2013,Zaragoza,50124,Herrera de los Navarros,7,6,1
2013,Zaragoza,50125,Ibdes,1,6,-5
2013,Zaragoza,50126,Illueca,15,28,-13
2013,Zaragoza,50128,Isuerre,0,1,-1
2013,Zaragoza,50129,Jaraba,2,6,-4
2013,Zaragoza,50130,Jarque de Moncayo,4,4,0
2013,Zaragoza,50131,Jaulín,1,8,-7
2013,Zaragoza,50132,Joyosa (La),15,4,11
2013,Zaragoza,50133,Lagata,0,2,-2
2013,Zaragoza,50134,Langa del Castillo,0,2,-2
2013,Zaragoza,50138,Lechón,0,1,-1
2013,Zaragoza,50137,Leciñena,5,18,-13
2013,Zaragoza,50139,Letux,0,13,-13
2013,Zaragoza,50140,Litago,0,2,-2
2013,Zaragoza,50141,Lituénigo,1,1,0
2013,Zaragoza,50143,Longares,4,16,-12
2013,Zaragoza,50146,Lucena de Jalón,0,6,-6
2013,Zaragoza,50147,Luceni,1,16,-15
2013,Zaragoza,50148,Luesia,0,5,-5
2013,Zaragoza,50150,Lumpiaque,10,11,-1
2013,Zaragoza,50151,Luna,1,10,-9
2013,Zaragoza,50136,Lécera,3,11,-8
2013,Zaragoza,50152,Maella,13,28,-15
2013,Zaragoza,50153,Magallón,7,21,-14
2013,Zaragoza,50154,Mainar,0,1,-1
2013,Zaragoza,50155,Malanquilla,0,1,-1
2013,Zaragoza,50156,Maleján,1,5,-4
2013,Zaragoza,50160,Mallén,22,36,-14
2013,Zaragoza,50159,Maluenda,2,11,-9
2013,Zaragoza,50157,Malón,5,9,-4
2013,Zaragoza,50161,Manchones,0,1,-1
2013,Zaragoza,50162,Mara,0,4,-4
2013,Zaragoza,50163,María de Huerva,99,22,77
2013,Zaragoza,50164,Mediana de Aragón,3,3,0
2013,Zaragoza,50165,Mequinenza,22,32,-10
2013,Zaragoza,50166,Mesones de Isuela,0,9,-9
2013,Zaragoza,50167,Mezalocha,0,2,-2
2013,Zaragoza,50168,Mianos,0,1,-1
2013,Zaragoza,50169,Miedes de Aragón,2,7,-5
2013,Zaragoza,50170,Monegrillo,1,3,-2
2013,Zaragoza,50171,Moneva,0,1,-1
2013,Zaragoza,50172,Monreal de Ariza,0,2,-2
2013,Zaragoza,50173,Monterde,1,3,-2
2013,Zaragoza,50175,Morata de Jalón,5,18,-13
2013,Zaragoza,50176,Morata de Jiloca,0,5,-5
2013,Zaragoza,50178,Moros,0,10,-10
2013,Zaragoza,50177,Morés,0,6,-6
2013,Zaragoza,50179,Moyuela,0,5,-5
2013,Zaragoza,50180,Mozota,3,1,2
2013,Zaragoza,50181,Muel,18,13,5
2013,Zaragoza,50182,Muela (La),83,22,61
2013,Zaragoza,50183,Munébrega,0,10,-10
2013,Zaragoza,50184,Murero,0,3,-3
2013,Zaragoza,50185,Murillo de Gállego,2,0,2
2013,Zaragoza,50186,Navardún,0,1,-1
2013,Zaragoza,50188,Nombrevilla,0,1,-1
2013,Zaragoza,50189,Nonaspe,6,14,-8
2013,Zaragoza,50190,Novallas,8,14,-6
2013,Zaragoza,50191,Novillas,2,11,-9
2013,Zaragoza,50193,Nuez de Ebro,6,5,1
2013,Zaragoza,50192,Nuévalos,1,3,-2
2013,Zaragoza,50194,Olvés,1,1,0
2013,Zaragoza,50195,Orcajo,0,1,-1
2013,Zaragoza,50196,Orera,0,2,-2
2013,Zaragoza,50197,Orés,0,1,-1
2013,Zaragoza,50199,Osera de Ebro,3,8,-5
2013,Zaragoza,50200,Paniza,5,8,-3
2013,Zaragoza,50201,Paracuellos de Jiloca,6,9,-3
2013,Zaragoza,50202,Paracuellos de la Ribera,0,3,-3
2013,Zaragoza,50203,Pastriz,7,12,-5
2013,Zaragoza,50204,Pedrola,28,31,-3
2013,Zaragoza,50205,Pedrosas (Las),2,0,2
2013,Zaragoza,50206,Perdiguera,3,9,-6
2013,Zaragoza,50207,Piedratajada,0,1,-1
2013,Zaragoza,50208,Pina de Ebro,18,20,-2
2013,Zaragoza,50209,Pinseque,46,47,-1
2013,Zaragoza,50210,Pintanos (Los),1,1,0
2013,Zaragoza,50211,Plasencia de Jalón,1,8,-7
2013,Zaragoza,50212,Pleitas,0,1,-1
2013,Zaragoza,50213,Plenas,0,2,-2
2013,Zaragoza,50215,Pozuel de Ariza,0,1,-1
2013,Zaragoza,50216,Pozuelo de Aragón,0,9,-9
2013,Zaragoza,50217,Pradilla de Ebro,3,14,-11
2013,Zaragoza,50218,Puebla de Albortón,2,1,1
2013,Zaragoza,50219,Puebla de Alfindén (La),81,20,61
2013,Zaragoza,50220,Puendeluna,0,2,-2
2013,Zaragoza,50222,Quinto,9,20,-11
2013,Zaragoza,50223,Remolinos,5,25,-20
2013,Zaragoza,50224,Retascón,0,1,-1
2013,Zaragoza,50225,Ricla,20,26,-6
2013,Zaragoza,50227,Romanos,1,2,-1
2013,Zaragoza,50228,Rueda de Jalón,5,2,3
2013,Zaragoza,50231,Salillas de Jalón,2,4,-2
2013,Zaragoza,50232,Salvatierra de Esca,1,4,-3
2013,Zaragoza,50233,Samper del Salz,0,1,-1
2013,Zaragoza,50234,San Martín de la Virgen de Moncayo,3,8,-5
2013,Zaragoza,50235,San Mateo de Gállego,27,32,-5
2013,Zaragoza,50236,Santa Cruz de Grío,0,2,-2
2013,Zaragoza,50237,Santa Cruz de Moncayo,0,1,-1
2013,Zaragoza,50238,Santa Eulalia de Gállego,0,1,-1
2013,Zaragoza,50239,Santed,0,2,-2
2013,Zaragoza,50241,Saviñán,2,5,-3
2013,Zaragoza,50242,Sediles,0,1,-1
2013,Zaragoza,50243,Sestrica,0,7,-7
2013,Zaragoza,50244,Sierra de Luna,1,4,-3
2013,Zaragoza,50245,Sigüés,0,4,-4
2013,Zaragoza,50246,Sisamón,0,1,-1
2013,Zaragoza,50247,Sobradiel,18,13,5
2013,Zaragoza,50248,Sos del Rey Católico,5,11,-6
2013,Zaragoza,50230,Sádaba,2,30,-28
2013,Zaragoza,50240,Sástago,8,16,-8
2013,Zaragoza,50249,Tabuenca,1,3,-2
2013,Zaragoza,50251,Tarazona,96,127,-31
2013,Zaragoza,50252,Tauste,32,89,-57
2013,Zaragoza,50253,Terrer,4,9,-5
2013,Zaragoza,50254,Tierga,0,2,-2
2013,Zaragoza,50255,Tobed,0,8,-8
2013,Zaragoza,50256,Torralba de los Frailes,0,1,-1
2013,Zaragoza,50257,Torralba de Ribota,0,4,-4
2013,Zaragoza,50261,Torrellas,0,4,-4
2013,Zaragoza,50262,Torres de Berrellén,13,17,-4
2013,Zaragoza,50263,Torrijo de la Cañada,1,6,-5
2013,Zaragoza,50264,Tosos,0,3,-3
2013,Zaragoza,50266,Trasobares,0,2,-2
2013,Zaragoza,50267,Uncastillo,0,16,-16
2013,Zaragoza,50268,Undués de Lerda,1,0,1
2013,Zaragoza,50269,Urrea de Jalón,4,8,-4
2013,Zaragoza,50270,Urriés,0,1,-1
2013,Zaragoza,50271,Used,0,1,-1
2013,Zaragoza,50272,Utebo,211,83,128
2013,Zaragoza,50274,Val de San Martín,0,1,-1
2013,Zaragoza,50275,Valmadrid,1,6,-5
2013,Zaragoza,50276,Valpalmas,0,6,-6
2013,Zaragoza,50278,Velilla de Ebro,4,3,1
2013,Zaragoza,50279,Velilla de Jiloca,0,3,-3
2013,Zaragoza,50280,Vera de Moncayo,3,8,-5
2013,Zaragoza,50281,Vierlas,1,1,0
2013,Zaragoza,50284,Villafeliche,0,7,-7
2013,Zaragoza,50285,Villafranca de Ebro,5,15,-10
2013,Zaragoza,50286,Villalba de Perejil,1,1,0
2013,Zaragoza,50287,Villalengua,1,7,-6
2013,Zaragoza,50903,Villamayor de Gállego,19,23,-4
2013,Zaragoza,50288,Villanueva de Gállego,40,35,5
2013,Zaragoza,50290,Villanueva de Huerva,1,15,-14
2013,Zaragoza,50289,Villanueva de Jiloca,0,5,-5
2013,Zaragoza,50291,Villar de los Navarros,0,2,-2
2013,Zaragoza,50292,Villarreal de Huerva,2,3,-1
2013,Zaragoza,50293,Villarroya de la Sierra,1,12,-11
2013,Zaragoza,50282,Vilueña (La),1,0,1
2013,Zaragoza,50296,Zaida (La),4,5,-1
2013,Zaragoza,50297,Zaragoza,6175,6110,65
2013,Zaragoza,50298,Zuera,71,67,4
2013,Zaragoza,50099,Épila,48,62,-14
2012,Zaragoza,50001,Abanto,0,6,-6
2012,Zaragoza,50002,Acered,0,3,-3
2012,Zaragoza,50004,Aguarón,0,17,-17
2012,Zaragoza,50005,Aguilón,0,3,-3
2012,Zaragoza,50003,Agón,0,5,-5
2012,Zaragoza,50006,Ainzón,6,27,-21
2012,Zaragoza,50008,Alagón,73,78,-5
2012,Zaragoza,50009,Alarba,0,3,-3
2012,Zaragoza,50010,Alberite de San Juan,0,3,-3
2012,Zaragoza,50011,Albeta,0,1,-1
2012,Zaragoza,50012,Alborge,0,2,-2
2012,Zaragoza,50013,Alcalá de Ebro,2,2,0
2012,Zaragoza,50014,Alcalá de Moncayo,1,3,-2
2012,Zaragoza,50015,Alconchel de Ariza,0,1,-1
2012,Zaragoza,50016,Aldehuela de Liestos,0,2,-2
2012,Zaragoza,50017,Alfajarín,34,18,16
2012,Zaragoza,50018,Alfamén,10,17,-7
2012,Zaragoza,50019,Alforque,0,1,-1
2012,Zaragoza,50020,Alhama de Aragón,3,16,-13
2012,Zaragoza,50021,Almochuel,0,1,-1
2012,Zaragoza,50022,Almolda (La),1,4,-3
2012,Zaragoza,50023,Almonacid de la Cuba,0,3,-3
2012,Zaragoza,50024,Almonacid de la Sierra,3,16,-13
2012,Zaragoza,50025,Almunia de Doña Godina (La),79,96,-17
2012,Zaragoza,50026,Alpartir,3,9,-6
2012,Zaragoza,50027,Ambel,2,5,-3
2012,Zaragoza,50028,Anento,0,1,-1
2012,Zaragoza,50029,Aniñón,4,9,-5
2012,Zaragoza,50031,Aranda de Moncayo,0,3,-3
2012,Zaragoza,50033,Ardisa,0,1,-1
2012,Zaragoza,50034,Ariza,9,32,-23
2012,Zaragoza,50032,Arándiga,1,3,-2
2012,Zaragoza,50036,Asín,0,3,-3
2012,Zaragoza,50037,Atea,0,4,-4
2012,Zaragoza,50038,Ateca,7,23,-16
2012,Zaragoza,50039,Azuara,1,11,-10
2012,Zaragoza,50030,Añón de Moncayo,0,8,-8
2012,Zaragoza,50040,Badules,1,0,1
2012,Zaragoza,50044,Bardallur,2,4,-2
2012,Zaragoza,50045,Belchite,12,21,-9
2012,Zaragoza,50046,Belmonte de Gracián,0,6,-6
2012,Zaragoza,50048,Berrueco,0,1,-1
2012,Zaragoza,50901,Biel,0,4,-4
2012,Zaragoza,50050,Bijuesca,0,2,-2
2012,Zaragoza,50051,Biota,7,22,-15
2012,Zaragoza,50052,Bisimbre,0,1,-1
2012,Zaragoza,50053,Boquiñeni,3,18,-15
2012,Zaragoza,50055,Borja,37,57,-20
2012,Zaragoza,50056,Botorrita,3,7,-4
2012,Zaragoza,50057,Brea de Aragón,12,23,-11
2012,Zaragoza,50058,Bubierca,0,3,-3
2012,Zaragoza,50059,Bujaraloz,13,16,-3
2012,Zaragoza,50060,Bulbuente,0,6,-6
2012,Zaragoza,50061,Bureta,1,2,-1
2012,Zaragoza,50062,Burgo de Ebro (El),24,14,10
2012,Zaragoza,50063,Buste (El),0,1,-1
2012,Zaragoza,50043,Bárboles,1,2,-1
2012,Zaragoza,50064,Cabañas de Ebro,2,7,-5
2012,Zaragoza,50066,Cadrete,37,22,15
2012,Zaragoza,50067,Calatayud,163,248,-85
2012,Zaragoza,50068,Calatorao,20,19,1
2012,Zaragoza,50069,Calcena,0,1,-1
2012,Zaragoza,50070,Calmarza,0,2,-2
2012,Zaragoza,50071,Campillo de Aragón,0,2,-2
2012,Zaragoza,50072,Carenas,1,4,-3
2012,Zaragoza,50073,Cariñena,36,57,-21
2012,Zaragoza,50074,Caspe,102,95,7
2012,Zaragoza,50075,Castejón de Alarba,1,3,-2
2012,Zaragoza,50076,Castejón de las Armas,0,4,-4
2012,Zaragoza,50077,Castejón de Valdejasa,0,6,-6
2012,Zaragoza,50078,Castiliscar,1,6,-5
2012,Zaragoza,50079,Cervera de la Cañada,3,6,-3
2012,Zaragoza,50081,Cetina,4,15,-11
2012,Zaragoza,50092,Chiprana,3,9,-6
2012,Zaragoza,50093,Chodes,0,5,-5
2012,Zaragoza,50082,Cimballa,1,3,-2
2012,Zaragoza,50083,Cinco Olivas,0,1,-1
2012,Zaragoza,50085,Codo,0,3,-3
2012,Zaragoza,50086,Codos,1,2,-1
2012,Zaragoza,50088,Cosuenda,2,3,-1
2012,Zaragoza,50089,Cuarte de Huerva,256,42,214
2012,Zaragoza,50090,Cubel,0,1,-1
2012,Zaragoza,50091,Cuerlas (Las),0,2,-2
2012,Zaragoza,50094,Daroca,12,51,-39
2012,Zaragoza,50095,Ejea de los Caballeros,129,201,-72
2012,Zaragoza,50096,Embid de Ariza,0,1,-1
2012,Zaragoza,50098,Encinacorba,0,5,-5
2012,Zaragoza,50100,Erla,1,4,-3
2012,Zaragoza,50101,Escatrón,6,19,-13
2012,Zaragoza,50102,Fabara,12,11,1
2012,Zaragoza,50104,Farlete,0,7,-7
2012,Zaragoza,50106,Fayos (Los),3,2,1
2012,Zaragoza,50105,Fayón,5,4,1
2012,Zaragoza,50107,Figueruelas,6,13,-7
2012,Zaragoza,50109,Frago (El),0,1,-1
2012,Zaragoza,50110,Frasno (El),0,4,-4
2012,Zaragoza,50111,Fréscano,0,3,-3
2012,Zaragoza,50113,Fuendejalón,8,12,-4
2012,Zaragoza,50114,Fuendetodos,1,2,-1
2012,Zaragoza,50115,Fuentes de Ebro,44,33,11
2012,Zaragoza,50116,Fuentes de Jiloca,0,7,-7
2012,Zaragoza,50117,Gallocanta,1,0,1
2012,Zaragoza,50118,Gallur,13,34,-21
2012,Zaragoza,50119,Gelsa,9,18,-9
2012,Zaragoza,50120,Godojos,0,1,-1
2012,Zaragoza,50121,Gotor,0,3,-3
2012,Zaragoza,50122,Grisel,2,1,1
2012,Zaragoza,50123,Grisén,7,6,1
2012,Zaragoza,50124,Herrera de los Navarros,1,4,-3
2012,Zaragoza,50125,Ibdes,2,8,-6
2012,Zaragoza,50126,Illueca,18,25,-7
2012,Zaragoza,50129,Jaraba,6,3,3
2012,Zaragoza,50130,Jarque de Moncayo,3,7,-4
2012,Zaragoza,50131,Jaulín,0,15,-15
2012,Zaragoza,50132,Joyosa (La),16,5,11
2012,Zaragoza,50133,Lagata,0,1,-1
2012,Zaragoza,50134,Langa del Castillo,1,2,-1
2012,Zaragoza,50135,Layana,1,2,-1
2012,Zaragoza,50138,Lechón,0,1,-1
2012,Zaragoza,50137,Leciñena,10,18,-8
2012,Zaragoza,50139,Letux,0,6,-6
2012,Zaragoza,50140,Litago,0,4,-4
2012,Zaragoza,50141,Lituénigo,0,5,-5
2012,Zaragoza,50142,Lobera de Onsella,0,1,-1
2012,Zaragoza,50143,Longares,7,9,-2
2012,Zaragoza,50146,Lucena de Jalón,3,3,0
2012,Zaragoza,50147,Luceni,11,12,-1
2012,Zaragoza,50148,Luesia,0,5,-5
2012,Zaragoza,50150,Lumpiaque,11,14,-3
2012,Zaragoza,50151,Luna,3,15,-12
2012,Zaragoza,50136,Lécera,3,13,-10
2012,Zaragoza,50152,Maella,7,18,-11
2012,Zaragoza,50153,Magallón,6,31,-25
2012,Zaragoza,50154,Mainar,0,6,-6
2012,Zaragoza,50155,Malanquilla,0,1,-1
2012,Zaragoza,50156,Maleján,1,2,-1
2012,Zaragoza,50160,Mallén,27,29,-2
2012,Zaragoza,50159,Maluenda,5,13,-8
2012,Zaragoza,50157,Malón,2,8,-6
2012,Zaragoza,50161,Manchones,0,2,-2
2012,Zaragoza,50162,Mara,2,5,-3
2012,Zaragoza,50163,María de Huerva,96,28,68
2012,Zaragoza,50164,Mediana de Aragón,1,10,-9
2012,Zaragoza,50165,Mequinenza,21,25,-4
2012,Zaragoza,50166,Mesones de Isuela,1,5,-4
2012,Zaragoza,50167,Mezalocha,0,5,-5
2012,Zaragoza,50168,Mianos,0,2,-2
2012,Zaragoza,50169,Miedes de Aragón,1,4,-3
2012,Zaragoza,50170,Monegrillo,1,7,-6
2012,Zaragoza,50171,Moneva,0,1,-1
2012,Zaragoza,50172,Monreal de Ariza,0,2,-2
2012,Zaragoza,50173,Monterde,0,3,-3
2012,Zaragoza,50174,Montón,0,2,-2
2012,Zaragoza,50175,Morata de Jalón,7,17,-10
2012,Zaragoza,50176,Morata de Jiloca,1,5,-4
2012,Zaragoza,50178,Moros,0,11,-11
2012,Zaragoza,50177,Morés,2,11,-9
2012,Zaragoza,50179,Moyuela,0,10,-10
2012,Zaragoza,50180,Mozota,1,0,1
2012,Zaragoza,50181,Muel,12,16,-4
2012,Zaragoza,50182,Muela (La),85,17,68
2012,Zaragoza,50183,Munébrega,0,8,-8
2012,Zaragoza,50184,Murero,2,2,0
2012,Zaragoza,50185,Murillo de Gállego,0,3,-3
2012,Zaragoza,50189,Nonaspe,4,7,-3
2012,Zaragoza,50190,Novallas,8,9,-1
2012,Zaragoza,50191,Novillas,3,13,-10
2012,Zaragoza,50193,Nuez de Ebro,11,5,6
2012,Zaragoza,50192,Nuévalos,5,4,1
2012,Zaragoza,50194,Olvés,0,6,-6
2012,Zaragoza,50195,Orcajo,0,2,-2
2012,Zaragoza,50196,Orera,1,4,-3
2012,Zaragoza,50197,Orés,0,2,-2
2012,Zaragoza,50199,Osera de Ebro,1,16,-15
2012,Zaragoza,50200,Paniza,4,7,-3
2012,Zaragoza,50201,Paracuellos de Jiloca,1,4,-3
2012,Zaragoza,50202,Paracuellos de la Ribera,0,8,-8
2012,Zaragoza,50203,Pastriz,9,17,-8
2012,Zaragoza,50204,Pedrola,38,36,2
2012,Zaragoza,50205,Pedrosas (Las),0,1,-1
2012,Zaragoza,50206,Perdiguera,3,12,-9
2012,Zaragoza,50207,Piedratajada,0,1,-1
2012,Zaragoza,50208,Pina de Ebro,26,24,2
2012,Zaragoza,50209,Pinseque,60,51,9
2012,Zaragoza,50211,Plasencia de Jalón,0,6,-6
2012,Zaragoza,50212,Pleitas,0,2,-2
2012,Zaragoza,50213,Plenas,0,2,-2
2012,Zaragoza,50216,Pozuelo de Aragón,1,4,-3
2012,Zaragoza,50217,Pradilla de Ebro,4,7,-3
2012,Zaragoza,50218,Puebla de Albortón,3,2,1
2012,Zaragoza,50219,Puebla de Alfindén (La),108,18,90
2012,Zaragoza,50220,Puendeluna,2,0,2
2012,Zaragoza,50222,Quinto,19,25,-6
2012,Zaragoza,50223,Remolinos,2,15,-13
2012,Zaragoza,50225,Ricla,22,22,0
2012,Zaragoza,50227,Romanos,0,1,-1
2012,Zaragoza,50228,Rueda de Jalón,0,4,-4
2012,Zaragoza,50231,Salillas de Jalón,4,3,1
2012,Zaragoza,50232,Salvatierra de Esca,2,0,2
2012,Zaragoza,50233,Samper del Salz,0,2,-2
2012,Zaragoza,50234,San Martín de la Virgen de Moncayo,1,1,0
2012,Zaragoza,50235,San Mateo de Gállego,34,31,3
2012,Zaragoza,50236,Santa Cruz de Grío,0,4,-4
2012,Zaragoza,50237,Santa Cruz de Moncayo,3,1,2
2012,Zaragoza,50241,Saviñán,3,17,-14
2012,Zaragoza,50242,Sediles,0,1,-1
2012,Zaragoza,50243,Sestrica,0,3,-3
2012,Zaragoza,50244,Sierra de Luna,0,4,-4
2012,Zaragoza,50245,Sigüés,2,5,-3
2012,Zaragoza,50246,Sisamón,0,1,-1
2012,Zaragoza,50247,Sobradiel,13,8,5
2012,Zaragoza,50248,Sos del Rey Católico,7,8,-1
2012,Zaragoza,50230,Sádaba,6,45,-39
2012,Zaragoza,50240,Sástago,9,18,-9
2012,Zaragoza,50249,Tabuenca,0,4,-4
2012,Zaragoza,50251,Tarazona,90,128,-38
2012,Zaragoza,50252,Tauste,47,77,-30
2012,Zaragoza,50253,Terrer,0,11,-11
2012,Zaragoza,50254,Tierga,0,4,-4
2012,Zaragoza,50255,Tobed,0,6,-6
2012,Zaragoza,50257,Torralba de Ribota,0,3,-3
2012,Zaragoza,50259,Torrehermosa,0,1,-1
2012,Zaragoza,50261,Torrellas,0,11,-11
2012,Zaragoza,50262,Torres de Berrellén,9,15,-6
2012,Zaragoza,50263,Torrijo de la Cañada,0,9,-9
2012,Zaragoza,50264,Tosos,0,3,-3
2012,Zaragoza,50266,Trasobares,0,4,-4
2012,Zaragoza,50267,Uncastillo,3,18,-15
2012,Zaragoza,50268,Undués de Lerda,0,1,-1
2012,Zaragoza,50269,Urrea de Jalón,3,6,-3
2012,Zaragoza,50271,Used,0,8,-8
2012,Zaragoza,50272,Utebo,255,89,166
2012,Zaragoza,50274,Val de San Martín,0,2,-2
2012,Zaragoza,50273,Valdehorna,0,4,-4
2012,Zaragoza,50275,Valmadrid,1,2,-1
2012,Zaragoza,50276,Valpalmas,0,3,-3
2012,Zaragoza,50277,Valtorres,0,1,-1
2012,Zaragoza,50278,Velilla de Ebro,2,3,-1
2012,Zaragoza,50279,Velilla de Jiloca,0,5,-5
2012,Zaragoza,50280,Vera de Moncayo,3,13,-10
2012,Zaragoza,50281,Vierlas,0,4,-4
2012,Zaragoza,50284,Villafeliche,0,4,-4
2012,Zaragoza,50285,Villafranca de Ebro,3,13,-10
2012,Zaragoza,50286,Villalba de Perejil,0,5,-5
2012,Zaragoza,50287,Villalengua,4,4,0
2012,Zaragoza,50903,Villamayor de Gállego,7,23,-16
2012,Zaragoza,50288,Villanueva de Gállego,34,30,4
2012,Zaragoza,50290,Villanueva de Huerva,1,11,-10
2012,Zaragoza,50289,Villanueva de Jiloca,0,2,-2
2012,Zaragoza,50291,Villar de los Navarros,0,3,-3
2012,Zaragoza,50292,Villarreal de Huerva,1,2,-1
2012,Zaragoza,50293,Villarroya de la Sierra,4,14,-10
2012,Zaragoza,50294,Villarroya del Campo,0,2,-2
2012,Zaragoza,50282,Vilueña (La),0,1,-1
2012,Zaragoza,50295,Vistabella,0,1,-1
2012,Zaragoza,50296,Zaida (La),1,6,-5
2012,Zaragoza,50297,Zaragoza,6314,6159,155
2012,Zaragoza,50298,Zuera,68,56,12
2012,Zaragoza,50099,Épila,52,44,8
2011,Zaragoza,50001,Abanto,0,3,-3
2011,Zaragoza,50002,Acered,0,6,-6
2011,Zaragoza,50004,Aguarón,2,17,-15
2011,Zaragoza,50005,Aguilón,0,5,-5
2011,Zaragoza,50003,Agón,1,0,1
2011,Zaragoza,50006,Ainzón,6,12,-6
2011,Zaragoza,50008,Alagón,62,77,-15
2011,Zaragoza,50009,Alarba,0,1,-1
2011,Zaragoza,50011,Albeta,2,3,-1
2011,Zaragoza,50012,Alborge,0,2,-2
2011,Zaragoza,50013,Alcalá de Ebro,3,4,-1
2011,Zaragoza,50014,Alcalá de Moncayo,2,1,1
2011,Zaragoza,50015,Alconchel de Ariza,0,1,-1
2011,Zaragoza,50016,Aldehuela de Liestos,0,1,-1
2011,Zaragoza,50017,Alfajarín,22,18,4
2011,Zaragoza,50018,Alfamén,17,6,11
2011,Zaragoza,50019,Alforque,0,3,-3
2011,Zaragoza,50020,Alhama de Aragón,12,12,0
2011,Zaragoza,50022,Almolda (La),0,11,-11
2011,Zaragoza,50023,Almonacid de la Cuba,1,6,-5
2011,Zaragoza,50024,Almonacid de la Sierra,3,18,-15
2011,Zaragoza,50025,Almunia de Doña Godina (La),87,80,7
2011,Zaragoza,50026,Alpartir,3,9,-6
2011,Zaragoza,50027,Ambel,2,4,-2
2011,Zaragoza,50029,Aniñón,5,11,-6
2011,Zaragoza,50031,Aranda de Moncayo,1,1,0
2011,Zaragoza,50033,Ardisa,0,1,-1
2011,Zaragoza,50034,Ariza,6,17,-11
2011,Zaragoza,50035,Artieda,1,0,1
2011,Zaragoza,50032,Arándiga,1,15,-14
2011,Zaragoza,50037,Atea,0,4,-4
2011,Zaragoza,50038,Ateca,11,23,-12
2011,Zaragoza,50039,Azuara,0,10,-10
2011,Zaragoza,50030,Añón de Moncayo,2,5,-3
2011,Zaragoza,50042,Balconchán,0,1,-1
2011,Zaragoza,50044,Bardallur,1,3,-2
2011,Zaragoza,50045,Belchite,11,32,-21
2011,Zaragoza,50046,Belmonte de Gracián,0,3,-3
2011,Zaragoza,50047,Berdejo,0,2,-2
2011,Zaragoza,50048,Berrueco,0,2,-2
2011,Zaragoza,50901,Biel,0,1,-1
2011,Zaragoza,50050,Bijuesca,0,1,-1
2011,Zaragoza,50051,Biota,5,11,-6
2011,Zaragoza,50052,Bisimbre,1,3,-2
2011,Zaragoza,50053,Boquiñeni,7,13,-6
2011,Zaragoza,50054,Bordalba,0,1,-1
2011,Zaragoza,50055,Borja,56,64,-8
2011,Zaragoza,50056,Botorrita,7,6,1
2011,Zaragoza,50057,Brea de Aragón,17,24,-7
2011,Zaragoza,50058,Bubierca,0,1,-1
2011,Zaragoza,50059,Bujaraloz,11,11,0
2011,Zaragoza,50060,Bulbuente,1,2,-1
2011,Zaragoza,50061,Bureta,1,0,1
2011,Zaragoza,50062,Burgo de Ebro (El),29,22,7
2011,Zaragoza,50063,Buste (El),0,4,-4
2011,Zaragoza,50043,Bárboles,1,3,-2
2011,Zaragoza,50064,Cabañas de Ebro,1,6,-5
2011,Zaragoza,50065,Cabolafuente,0,2,-2
2011,Zaragoza,50066,Cadrete,53,23,30
2011,Zaragoza,50067,Calatayud,198,231,-33
2011,Zaragoza,50068,Calatorao,31,32,-1
2011,Zaragoza,50069,Calcena,0,5,-5
2011,Zaragoza,50070,Calmarza,0,2,-2
2011,Zaragoza,50071,Campillo de Aragón,0,4,-4
2011,Zaragoza,50072,Carenas,0,4,-4
2011,Zaragoza,50073,Cariñena,37,47,-10
2011,Zaragoza,50074,Caspe,111,128,-17
2011,Zaragoza,50075,Castejón de Alarba,0,2,-2
2011,Zaragoza,50076,Castejón de las Armas,0,3,-3
2011,Zaragoza,50077,Castejón de Valdejasa,0,6,-6
2011,Zaragoza,50078,Castiliscar,1,10,-9
2011,Zaragoza,50079,Cervera de la Cañada,3,6,-3
2011,Zaragoza,50081,Cetina,4,6,-2
2011,Zaragoza,50092,Chiprana,5,6,-1
2011,Zaragoza,50093,Chodes,0,1,-1
2011,Zaragoza,50082,Cimballa,0,1,-1
2011,Zaragoza,50083,Cinco Olivas,2,3,-1
2011,Zaragoza,50084,Clarés de Ribota,0,2,-2
2011,Zaragoza,50085,Codo,1,9,-8
2011,Zaragoza,50086,Codos,0,3,-3
2011,Zaragoza,50087,Contamina,0,1,-1
2011,Zaragoza,50088,Cosuenda,3,6,-3
2011,Zaragoza,50089,Cuarte de Huerva,247,23,224
2011,Zaragoza,50090,Cubel,0,2,-2
2011,Zaragoza,50091,Cuerlas (Las),0,6,-6
2011,Zaragoza,50094,Daroca,11,34,-23
2011,Zaragoza,50095,Ejea de los Caballeros,138,178,-40
2011,Zaragoza,50096,Embid de Ariza,0,1,-1
2011,Zaragoza,50098,Encinacorba,0,5,-5
2011,Zaragoza,50100,Erla,1,5,-4
2011,Zaragoza,50101,Escatrón,4,13,-9
2011,Zaragoza,50102,Fabara,8,24,-16
2011,Zaragoza,50104,Farlete,2,6,-4
2011,Zaragoza,50106,Fayos (Los),1,1,0
2011,Zaragoza,50105,Fayón,0,5,-5
2011,Zaragoza,50107,Figueruelas,10,11,-1
2011,Zaragoza,50110,Frasno (El),1,8,-7
2011,Zaragoza,50111,Fréscano,1,6,-5
2011,Zaragoza,50113,Fuendejalón,7,15,-8
2011,Zaragoza,50114,Fuendetodos,0,2,-2
2011,Zaragoza,50115,Fuentes de Ebro,40,41,-1
2011,Zaragoza,50116,Fuentes de Jiloca,0,6,-6
2011,Zaragoza,50117,Gallocanta,0,2,-2
2011,Zaragoza,50118,Gallur,24,20,4
2011,Zaragoza,50119,Gelsa,4,11,-7
2011,Zaragoza,50121,Gotor,0,4,-4
2011,Zaragoza,50122,Grisel,1,1,0
2011,Zaragoza,50123,Grisén,5,7,-2
2011,Zaragoza,50124,Herrera de los Navarros,3,9,-6
2011,Zaragoza,50125,Ibdes,2,11,-9
2011,Zaragoza,50126,Illueca,21,29,-8
2011,Zaragoza,50129,Jaraba,4,7,-3
2011,Zaragoza,50130,Jarque de Moncayo,2,7,-5
2011,Zaragoza,50131,Jaulín,0,10,-10
2011,Zaragoza,50132,Joyosa (La),12,8,4
2011,Zaragoza,50133,Lagata,0,2,-2
2011,Zaragoza,50134,Langa del Castillo,0,3,-3
2011,Zaragoza,50137,Leciñena,11,23,-12
2011,Zaragoza,50139,Letux,0,8,-8
2011,Zaragoza,50140,Litago,0,6,-6
2011,Zaragoza,50141,Lituénigo,0,2,-2
2011,Zaragoza,50142,Lobera de Onsella,0,1,-1
2011,Zaragoza,50143,Longares,8,15,-7
2011,Zaragoza,50144,Longás,0,1,-1
2011,Zaragoza,50146,Lucena de Jalón,4,4,0
2011,Zaragoza,50147,Luceni,4,17,-13
2011,Zaragoza,50148,Luesia,0,6,-6
2011,Zaragoza,50150,Lumpiaque,5,15,-10
2011,Zaragoza,50151,Luna,3,13,-10
2011,Zaragoza,50136,Lécera,4,13,-9
2011,Zaragoza,50152,Maella,2,33,-31
2011,Zaragoza,50153,Magallón,8,20,-12
2011,Zaragoza,50154,Mainar,0,5,-5
2011,Zaragoza,50155,Malanquilla,0,1,-1
2011,Zaragoza,50156,Maleján,5,4,1
2011,Zaragoza,50160,Mallén,32,29,3
2011,Zaragoza,50159,Maluenda,8,21,-13
2011,Zaragoza,50157,Malón,2,3,-1
2011,Zaragoza,50161,Manchones,0,3,-3
2011,Zaragoza,50162,Mara,0,2,-2
2011,Zaragoza,50163,María de Huerva,93,18,75
2011,Zaragoza,50164,Mediana de Aragón,5,6,-1
2011,Zaragoza,50165,Mequinenza,18,44,-26
2011,Zaragoza,50166,Mesones de Isuela,0,4,-4
2011,Zaragoza,50167,Mezalocha,1,3,-2
2011,Zaragoza,50169,Miedes de Aragón,1,11,-10
2011,Zaragoza,50170,Monegrillo,2,3,-1
2011,Zaragoza,50171,Moneva,0,1,-1
2011,Zaragoza,50172,Monreal de Ariza,0,1,-1
2011,Zaragoza,50173,Monterde,0,3,-3
2011,Zaragoza,50174,Montón,0,1,-1
2011,Zaragoza,50175,Morata de Jalón,4,27,-23
2011,Zaragoza,50176,Morata de Jiloca,2,3,-1
2011,Zaragoza,50178,Moros,1,11,-10
2011,Zaragoza,50177,Morés,2,8,-6
2011,Zaragoza,50179,Moyuela,0,6,-6
2011,Zaragoza,50180,Mozota,0,1,-1
2011,Zaragoza,50181,Muel,9,22,-13
2011,Zaragoza,50182,Muela (La),100,19,81
2011,Zaragoza,50183,Munébrega,1,9,-8
2011,Zaragoza,50184,Murero,0,2,-2
2011,Zaragoza,50185,Murillo de Gállego,2,1,1
2011,Zaragoza,50186,Navardún,0,1,-1
2011,Zaragoza,50187,Nigüella,0,2,-2
2011,Zaragoza,50189,Nonaspe,6,20,-14
2011,Zaragoza,50190,Novallas,10,11,-1
2011,Zaragoza,50191,Novillas,2,5,-3
2011,Zaragoza,50193,Nuez de Ebro,10,7,3
2011,Zaragoza,50192,Nuévalos,1,3,-2
2011,Zaragoza,50194,Olvés,0,2,-2
2011,Zaragoza,50196,Orera,0,1,-1
2011,Zaragoza,50197,Orés,0,4,-4
2011,Zaragoza,50199,Osera de Ebro,1,15,-14
2011,Zaragoza,50200,Paniza,5,10,-5
2011,Zaragoza,50201,Paracuellos de Jiloca,7,6,1
2011,Zaragoza,50202,Paracuellos de la Ribera,0,8,-8
2011,Zaragoza,50203,Pastriz,18,10,8
2011,Zaragoza,50204,Pedrola,29,28,1
2011,Zaragoza,50205,Pedrosas (Las),0,3,-3
2011,Zaragoza,50206,Perdiguera,6,7,-1
2011,Zaragoza,50207,Piedratajada,1,0,1
2011,Zaragoza,50208,Pina de Ebro,30,20,10
2011,Zaragoza,50209,Pinseque,59,69,-10
2011,Zaragoza,50211,Plasencia de Jalón,3,6,-3
2011,Zaragoza,50212,Pleitas,0,1,-1
2011,Zaragoza,50213,Plenas,0,6,-6
2011,Zaragoza,50216,Pozuelo de Aragón,0,6,-6
2011,Zaragoza,50217,Pradilla de Ebro,6,13,-7
2011,Zaragoza,50218,Puebla de Albortón,1,1,0
2011,Zaragoza,50219,Puebla de Alfindén (La),99,16,83
2011,Zaragoza,50220,Puendeluna,0,1,-1
2011,Zaragoza,50222,Quinto,12,23,-11
2011,Zaragoza,50223,Remolinos,9,29,-20
2011,Zaragoza,50224,Retascón,0,3,-3
2011,Zaragoza,50225,Ricla,24,27,-3
2011,Zaragoza,50227,Romanos,1,3,-2
2011,Zaragoza,50228,Rueda de Jalón,2,5,-3
2011,Zaragoza,50229,Ruesca,0,1,-1
2011,Zaragoza,50231,Salillas de Jalón,1,3,-2
2011,Zaragoza,50232,Salvatierra de Esca,1,0,1
2011,Zaragoza,50233,Samper del Salz,0,3,-3
2011,Zaragoza,50234,San Martín de la Virgen de Moncayo,2,2,0
2011,Zaragoza,50235,San Mateo de Gállego,27,34,-7
2011,Zaragoza,50236,Santa Cruz de Grío,0,3,-3
2011,Zaragoza,50238,Santa Eulalia de Gállego,1,4,-3
2011,Zaragoza,50239,Santed,0,1,-1
2011,Zaragoza,50241,Saviñán,6,19,-13
2011,Zaragoza,50242,Sediles,0,2,-2
2011,Zaragoza,50243,Sestrica,1,6,-5
2011,Zaragoza,50244,Sierra de Luna,1,3,-2
2011,Zaragoza,50245,Sigüés,1,2,-1
2011,Zaragoza,50246,Sisamón,0,1,-1
2011,Zaragoza,50247,Sobradiel,16,13,3
2011,Zaragoza,50248,Sos del Rey Católico,1,8,-7
2011,Zaragoza,50230,Sádaba,12,52,-40
2011,Zaragoza,50240,Sástago,2,11,-9
2011,Zaragoza,50249,Tabuenca,0,8,-8
2011,Zaragoza,50250,Talamantes,0,1,-1
2011,Zaragoza,50251,Tarazona,97,106,-9
2011,Zaragoza,50252,Tauste,50,87,-37
2011,Zaragoza,50253,Terrer,2,9,-7
2011,Zaragoza,50254,Tierga,1,4,-3
2011,Zaragoza,50255,Tobed,1,6,-5
2011,Zaragoza,50256,Torralba de los Frailes,0,1,-1
2011,Zaragoza,50257,Torralba de Ribota,0,4,-4
2011,Zaragoza,50261,Torrellas,2,6,-4
2011,Zaragoza,50262,Torres de Berrellén,14,13,1
2011,Zaragoza,50263,Torrijo de la Cañada,0,6,-6
2011,Zaragoza,50264,Tosos,1,3,-2
2011,Zaragoza,50266,Trasobares,0,4,-4
2011,Zaragoza,50267,Uncastillo,1,19,-18
2011,Zaragoza,50268,Undués de Lerda,4,1,3
2011,Zaragoza,50269,Urrea de Jalón,5,14,-9
2011,Zaragoza,50271,Used,0,3,-3
2011,Zaragoza,50272,Utebo,233,77,156
2011,Zaragoza,50274,Val de San Martín,0,2,-2
2011,Zaragoza,50275,Valmadrid,0,1,-1
2011,Zaragoza,50276,Valpalmas,0,5,-5
2011,Zaragoza,50278,Velilla de Ebro,1,1,0
2011,Zaragoza,50279,Velilla de Jiloca,0,2,-2
2011,Zaragoza,50280,Vera de Moncayo,0,10,-10
2011,Zaragoza,50281,Vierlas,0,2,-2
2011,Zaragoza,50284,Villafeliche,0,2,-2
2011,Zaragoza,50285,Villafranca de Ebro,6,8,-2
2011,Zaragoza,50286,Villalba de Perejil,1,2,-1
2011,Zaragoza,50287,Villalengua,5,7,-2
2011,Zaragoza,50903,Villamayor de Gállego,11,24,-13
2011,Zaragoza,50288,Villanueva de Gállego,48,31,17
2011,Zaragoza,50290,Villanueva de Huerva,2,8,-6
2011,Zaragoza,50291,Villar de los Navarros,0,4,-4
2011,Zaragoza,50292,Villarreal de Huerva,1,2,-1
2011,Zaragoza,50293,Villarroya de la Sierra,2,11,-9
2011,Zaragoza,50294,Villarroya del Campo,0,2,-2
2011,Zaragoza,50282,Vilueña (La),0,4,-4
2011,Zaragoza,50296,Zaida (La),3,9,-6
2011,Zaragoza,50297,Zaragoza,6707,6081,626
2011,Zaragoza,50298,Zuera,86,67,19
2011,Zaragoza,50099,Épila,50,45,5
2010,Zaragoza,50001,Abanto,0,3,-3
2010,Zaragoza,50002,Acered,0,6,-6
2010,Zaragoza,50004,Aguarón,3,13,-10
2010,Zaragoza,50005,Aguilón,1,3,-2
2010,Zaragoza,50003,Agón,1,3,-2
2010,Zaragoza,50006,Ainzón,7,17,-10
2010,Zaragoza,50008,Alagón,75,82,-7
2010,Zaragoza,50009,Alarba,0,2,-2
2010,Zaragoza,50010,Alberite de San Juan,0,1,-1
2010,Zaragoza,50011,Albeta,1,2,-1
2010,Zaragoza,50012,Alborge,1,0,1
2010,Zaragoza,50013,Alcalá de Ebro,0,4,-4
2010,Zaragoza,50014,Alcalá de Moncayo,2,1,1
2010,Zaragoza,50015,Alconchel de Ariza,0,5,-5
2010,Zaragoza,50017,Alfajarín,29,21,8
2010,Zaragoza,50018,Alfamén,17,11,6
2010,Zaragoza,50019,Alforque,0,1,-1
2010,Zaragoza,50020,Alhama de Aragón,15,15,0
2010,Zaragoza,50022,Almolda (La),1,8,-7
2010,Zaragoza,50023,Almonacid de la Cuba,0,6,-6
2010,Zaragoza,50024,Almonacid de la Sierra,4,17,-13
2010,Zaragoza,50025,Almunia de Doña Godina (La),98,75,23
2010,Zaragoza,50026,Alpartir,4,7,-3
2010,Zaragoza,50027,Ambel,2,11,-9
2010,Zaragoza,50028,Anento,1,0,1
2010,Zaragoza,50029,Aniñón,3,10,-7
2010,Zaragoza,50031,Aranda de Moncayo,0,3,-3
2010,Zaragoza,50033,Ardisa,0,1,-1
2010,Zaragoza,50034,Ariza,14,11,3
2010,Zaragoza,50035,Artieda,0,1,-1
2010,Zaragoza,50032,Arándiga,0,11,-11
2010,Zaragoza,50036,Asín,0,5,-5
2010,Zaragoza,50037,Atea,0,2,-2
2010,Zaragoza,50038,Ateca,7,23,-16
2010,Zaragoza,50039,Azuara,1,7,-6
2010,Zaragoza,50030,Añón de Moncayo,1,7,-6
2010,Zaragoza,50040,Badules,0,2,-2
2010,Zaragoza,50041,Bagüés,0,1,-1
2010,Zaragoza,50042,Balconchán,0,1,-1
2010,Zaragoza,50044,Bardallur,0,6,-6
2010,Zaragoza,50045,Belchite,9,24,-15
2010,Zaragoza,50046,Belmonte de Gracián,0,6,-6
2010,Zaragoza,50901,Biel,0,2,-2
2010,Zaragoza,50050,Bijuesca,0,1,-1
2010,Zaragoza,50051,Biota,8,15,-7
2010,Zaragoza,50052,Bisimbre,1,1,0
2010,Zaragoza,50053,Boquiñeni,9,16,-7
2010,Zaragoza,50054,Bordalba,0,1,-1
2010,Zaragoza,50055,Borja,61,53,8
2010,Zaragoza,50056,Botorrita,2,0,2
2010,Zaragoza,50057,Brea de Aragón,16,21,-5
2010,Zaragoza,50058,Bubierca,0,1,-1
2010,Zaragoza,50059,Bujaraloz,6,17,-11
2010,Zaragoza,50060,Bulbuente,2,5,-3
2010,Zaragoza,50061,Bureta,1,6,-5
2010,Zaragoza,50062,Burgo de Ebro (El),30,16,14
2010,Zaragoza,50063,Buste (El),0,3,-3
2010,Zaragoza,50043,Bárboles,3,4,-1
2010,Zaragoza,50064,Cabañas de Ebro,3,7,-4
2010,Zaragoza,50066,Cadrete,49,24,25
2010,Zaragoza,50067,Calatayud,206,216,-10
2010,Zaragoza,50068,Calatorao,27,30,-3
2010,Zaragoza,50069,Calcena,0,4,-4
2010,Zaragoza,50070,Calmarza,3,2,1
2010,Zaragoza,50072,Carenas,0,3,-3
2010,Zaragoza,50073,Cariñena,46,44,2
2010,Zaragoza,50074,Caspe,88,101,-13
2010,Zaragoza,50075,Castejón de Alarba,0,2,-2
2010,Zaragoza,50076,Castejón de las Armas,0,1,-1
2010,Zaragoza,50077,Castejón de Valdejasa,0,4,-4
2010,Zaragoza,50078,Castiliscar,5,8,-3
2010,Zaragoza,50079,Cervera de la Cañada,0,4,-4
2010,Zaragoza,50081,Cetina,5,12,-7
2010,Zaragoza,50092,Chiprana,6,5,1
2010,Zaragoza,50093,Chodes,0,3,-3
2010,Zaragoza,50082,Cimballa,0,1,-1
2010,Zaragoza,50083,Cinco Olivas,0,3,-3
2010,Zaragoza,50084,Clarés de Ribota,0,1,-1
2010,Zaragoza,50085,Codo,0,4,-4
2010,Zaragoza,50086,Codos,0,1,-1
2010,Zaragoza,50087,Contamina,0,2,-2
2010,Zaragoza,50088,Cosuenda,0,3,-3
2010,Zaragoza,50089,Cuarte de Huerva,236,29,207
2010,Zaragoza,50090,Cubel,1,2,-1
2010,Zaragoza,50094,Daroca,16,39,-23
2010,Zaragoza,50095,Ejea de los Caballeros,152,178,-26
2010,Zaragoza,50096,Embid de Ariza,0,1,-1
2010,Zaragoza,50098,Encinacorba,1,2,-1
2010,Zaragoza,50100,Erla,2,6,-4
2010,Zaragoza,50101,Escatrón,10,16,-6
2010,Zaragoza,50102,Fabara,11,15,-4
2010,Zaragoza,50104,Farlete,0,3,-3
2010,Zaragoza,50106,Fayos (Los),0,2,-2
2010,Zaragoza,50105,Fayón,3,8,-5
2010,Zaragoza,50107,Figueruelas,11,24,-13
2010,Zaragoza,50110,Frasno (El),0,8,-8
2010,Zaragoza,50111,Fréscano,0,5,-5
2010,Zaragoza,50113,Fuendejalón,7,9,-2
2010,Zaragoza,50114,Fuendetodos,2,3,-1
2010,Zaragoza,50115,Fuentes de Ebro,48,44,4
2010,Zaragoza,50116,Fuentes de Jiloca,1,7,-6
2010,Zaragoza,50117,Gallocanta,3,1,2
2010,Zaragoza,50118,Gallur,22,29,-7
2010,Zaragoza,50119,Gelsa,4,12,-8
2010,Zaragoza,50120,Godojos,0,2,-2
2010,Zaragoza,50121,Gotor,1,3,-2
2010,Zaragoza,50122,Grisel,0,2,-2
2010,Zaragoza,50123,Grisén,7,9,-2
2010,Zaragoza,50124,Herrera de los Navarros,2,9,-7
2010,Zaragoza,50125,Ibdes,2,13,-11
2010,Zaragoza,50126,Illueca,16,36,-20
2010,Zaragoza,50128,Isuerre,0,1,-1
2010,Zaragoza,50129,Jaraba,6,6,0
2010,Zaragoza,50130,Jarque de Moncayo,1,5,-4
2010,Zaragoza,50131,Jaulín,2,8,-6
2010,Zaragoza,50132,Joyosa (La),14,10,4
2010,Zaragoza,50133,Lagata,0,3,-3
2010,Zaragoza,50134,Langa del Castillo,0,2,-2
2010,Zaragoza,50135,Layana,0,1,-1
2010,Zaragoza,50138,Lechón,0,2,-2
2010,Zaragoza,50137,Leciñena,9,15,-6
2010,Zaragoza,50139,Letux,0,6,-6
2010,Zaragoza,50140,Litago,0,1,-1
2010,Zaragoza,50141,Lituénigo,1,1,0
2010,Zaragoza,50143,Longares,4,15,-11
2010,Zaragoza,50144,Longás,0,0,0
2010,Zaragoza,50146,Lucena de Jalón,3,6,-3
2010,Zaragoza,50147,Luceni,14,21,-7
2010,Zaragoza,50148,Luesia,2,8,-6
2010,Zaragoza,50150,Lumpiaque,13,15,-2
2010,Zaragoza,50151,Luna,1,15,-14
2010,Zaragoza,50136,Lécera,2,12,-10
2010,Zaragoza,50152,Maella,12,19,-7
2010,Zaragoza,50153,Magallón,7,15,-8
2010,Zaragoza,50154,Mainar,1,0,1
2010,Zaragoza,50156,Maleján,4,6,-2
2010,Zaragoza,50160,Mallén,35,34,1
2010,Zaragoza,50159,Maluenda,5,12,-7
2010,Zaragoza,50157,Malón,3,7,-4
2010,Zaragoza,50161,Manchones,0,5,-5
2010,Zaragoza,50162,Mara,0,6,-6
2010,Zaragoza,50163,María de Huerva,107,16,91
2010,Zaragoza,50164,Mediana de Aragón,2,9,-7
2010,Zaragoza,50165,Mequinenza,12,27,-15
2010,Zaragoza,50166,Mesones de Isuela,3,5,-2
2010,Zaragoza,50167,Mezalocha,0,5,-5
2010,Zaragoza,50169,Miedes de Aragón,1,6,-5
2010,Zaragoza,50170,Monegrillo,2,6,-4
2010,Zaragoza,50172,Monreal de Ariza,0,4,-4
2010,Zaragoza,50173,Monterde,1,1,0
2010,Zaragoza,50174,Montón,2,3,-1
2010,Zaragoza,50175,Morata de Jalón,4,18,-14
2010,Zaragoza,50176,Morata de Jiloca,0,6,-6
2010,Zaragoza,50178,Moros,0,6,-6
2010,Zaragoza,50177,Morés,3,14,-11
2010,Zaragoza,50179,Moyuela,1,6,-5
2010,Zaragoza,50180,Mozota,0,1,-1
2010,Zaragoza,50181,Muel,11,10,1
2010,Zaragoza,50182,Muela (La),101,26,75
2010,Zaragoza,50183,Munébrega,0,8,-8
2010,Zaragoza,50184,Murero,1,4,-3
2010,Zaragoza,50185,Murillo de Gállego,1,3,-2
2010,Zaragoza,50187,Nigüella,0,1,-1
2010,Zaragoza,50189,Nonaspe,2,23,-21
2010,Zaragoza,50190,Novallas,7,9,-2
2010,Zaragoza,50191,Novillas,1,13,-12
2010,Zaragoza,50193,Nuez de Ebro,8,7,1
2010,Zaragoza,50192,Nuévalos,6,1,5
2010,Zaragoza,50196,Orera,0,2,-2
2010,Zaragoza,50197,Orés,0,5,-5
2010,Zaragoza,50199,Osera de Ebro,1,18,-17
2010,Zaragoza,50200,Paniza,4,9,-5
2010,Zaragoza,50201,Paracuellos de Jiloca,5,9,-4
2010,Zaragoza,50202,Paracuellos de la Ribera,0,2,-2
2010,Zaragoza,50203,Pastriz,10,13,-3
2010,Zaragoza,50204,Pedrola,38,31,7
2010,Zaragoza,50205,Pedrosas (Las),2,3,-1
2010,Zaragoza,50206,Perdiguera,2,5,-3
2010,Zaragoza,50207,Piedratajada,0,1,-1
2010,Zaragoza,50208,Pina de Ebro,18,26,-8
2010,Zaragoza,50209,Pinseque,51,50,1
2010,Zaragoza,50210,Pintanos (Los),0,2,-2
2010,Zaragoza,50211,Plasencia de Jalón,1,6,-5
2010,Zaragoza,50213,Plenas,1,1,0
2010,Zaragoza,50216,Pozuelo de Aragón,1,3,-2
2010,Zaragoza,50217,Pradilla de Ebro,4,11,-7
2010,Zaragoza,50218,Puebla de Albortón,1,1,0
2010,Zaragoza,50219,Puebla de Alfindén (La),105,30,75
2010,Zaragoza,50222,Quinto,17,22,-5
2010,Zaragoza,50223,Remolinos,7,19,-12
2010,Zaragoza,50225,Ricla,23,30,-7
2010,Zaragoza,50228,Rueda de Jalón,4,6,-2
2010,Zaragoza,50229,Ruesca,0,1,-1
2010,Zaragoza,50231,Salillas de Jalón,2,5,-3
2010,Zaragoza,50232,Salvatierra de Esca,0,3,-3
2010,Zaragoza,50234,San Martín de la Virgen de Moncayo,2,2,0
2010,Zaragoza,50235,San Mateo de Gállego,24,26,-2
2010,Zaragoza,50236,Santa Cruz de Grío,2,3,-1
2010,Zaragoza,50237,Santa Cruz de Moncayo,0,2,-2
2010,Zaragoza,50238,Santa Eulalia de Gállego,1,1,0
2010,Zaragoza,50239,Santed,0,0,0
2010,Zaragoza,50241,Saviñán,2,8,-6
2010,Zaragoza,50242,Sediles,0,1,-1
2010,Zaragoza,50243,Sestrica,2,4,-2
2010,Zaragoza,50244,Sierra de Luna,0,3,-3
2010,Zaragoza,50245,Sigüés,0,1,-1
2010,Zaragoza,50246,Sisamón,0,3,-3
2010,Zaragoza,50247,Sobradiel,12,13,-1
2010,Zaragoza,50248,Sos del Rey Católico,4,10,-6
2010,Zaragoza,50230,Sádaba,9,27,-18
2010,Zaragoza,50240,Sástago,0,12,-12
2010,Zaragoza,50249,Tabuenca,0,5,-5
2010,Zaragoza,50250,Talamantes,0,4,-4
2010,Zaragoza,50251,Tarazona,112,117,-5
2010,Zaragoza,50252,Tauste,59,79,-20
2010,Zaragoza,50253,Terrer,2,10,-8
2010,Zaragoza,50254,Tierga,0,3,-3
2010,Zaragoza,50255,Tobed,0,7,-7
2010,Zaragoza,50256,Torralba de los Frailes,0,2,-2
2010,Zaragoza,50257,Torralba de Ribota,0,3,-3
2010,Zaragoza,50258,Torralbilla,0,1,-1
2010,Zaragoza,50259,Torrehermosa,0,1,-1
2010,Zaragoza,50260,Torrelapaja,0,2,-2
2010,Zaragoza,50261,Torrellas,3,2,1
2010,Zaragoza,50262,Torres de Berrellén,30,16,14
2010,Zaragoza,50263,Torrijo de la Cañada,0,3,-3
2010,Zaragoza,50264,Tosos,1,3,-2
2010,Zaragoza,50265,Trasmoz,0,1,-1
2010,Zaragoza,50266,Trasobares,0,1,-1
2010,Zaragoza,50267,Uncastillo,1,16,-15
2010,Zaragoza,50268,Undués de Lerda,1,0,1
2010,Zaragoza,50269,Urrea de Jalón,5,12,-7
2010,Zaragoza,50271,Used,0,10,-10
2010,Zaragoza,50272,Utebo,272,91,181
2010,Zaragoza,50274,Val de San Martín,0,1,-1
2010,Zaragoza,50273,Valdehorna,0,1,-1
2010,Zaragoza,50275,Valmadrid,2,0,2
2010,Zaragoza,50276,Valpalmas,0,3,-3
2010,Zaragoza,50277,Valtorres,0,2,-2
2010,Zaragoza,50278,Velilla de Ebro,1,5,-4
2010,Zaragoza,50279,Velilla de Jiloca,0,1,-1
2010,Zaragoza,50280,Vera de Moncayo,0,11,-11
2010,Zaragoza,50281,Vierlas,0,3,-3
2010,Zaragoza,50283,Villadoz,0,2,-2
2010,Zaragoza,50284,Villafeliche,0,3,-3
2010,Zaragoza,50285,Villafranca de Ebro,8,9,-1
2010,Zaragoza,50286,Villalba de Perejil,1,3,-2
2010,Zaragoza,50287,Villalengua,2,9,-7
2010,Zaragoza,50903,Villamayor de Gállego,14,21,-7
2010,Zaragoza,50288,Villanueva de Gállego,49,36,13
2010,Zaragoza,50290,Villanueva de Huerva,1,10,-9
2010,Zaragoza,50289,Villanueva de Jiloca,0,2,-2
2010,Zaragoza,50291,Villar de los Navarros,2,1,1
2010,Zaragoza,50292,Villarreal de Huerva,3,3,0
2010,Zaragoza,50293,Villarroya de la Sierra,1,10,-9
2010,Zaragoza,50294,Villarroya del Campo,0,0,0
2010,Zaragoza,50296,Zaida (La),2,6,-4
2010,Zaragoza,50297,Zaragoza,6862,5859,1003
2010,Zaragoza,50298,Zuera,74,57,17
2010,Zaragoza,50099,Épila,53,48,5
2009,Zaragoza,50001,Abanto,0,1,-1
2009,Zaragoza,50002,Acered,0,5,-5
2009,Zaragoza,50004,Aguarón,2,25,-23
2009,Zaragoza,50005,Aguilón,0,3,-3
2009,Zaragoza,50003,Agón,1,2,-1
2009,Zaragoza,50006,Ainzón,14,13,1
2009,Zaragoza,50008,Alagón,77,82,-5
2009,Zaragoza,50009,Alarba,0,2,-2
2009,Zaragoza,50010,Alberite de San Juan,0,1,-1
2009,Zaragoza,50011,Albeta,1,0,1
2009,Zaragoza,50012,Alborge,1,0,1
2009,Zaragoza,50013,Alcalá de Ebro,2,4,-2
2009,Zaragoza,50014,Alcalá de Moncayo,1,3,-2
2009,Zaragoza,50017,Alfajarín,30,15,15
2009,Zaragoza,50018,Alfamén,16,11,5
2009,Zaragoza,50019,Alforque,0,2,-2
2009,Zaragoza,50020,Alhama de Aragón,6,14,-8
2009,Zaragoza,50022,Almolda (La),3,11,-8
2009,Zaragoza,50023,Almonacid de la Cuba,1,4,-3
2009,Zaragoza,50024,Almonacid de la Sierra,7,15,-8
2009,Zaragoza,50025,Almunia de Doña Godina (La),90,80,10
2009,Zaragoza,50026,Alpartir,2,7,-5
2009,Zaragoza,50027,Ambel,1,5,-4
2009,Zaragoza,50029,Aniñón,4,15,-11
2009,Zaragoza,50031,Aranda de Moncayo,0,3,-3
2009,Zaragoza,50033,Ardisa,0,1,-1
2009,Zaragoza,50034,Ariza,13,24,-11
2009,Zaragoza,50035,Artieda,1,1,0
2009,Zaragoza,50032,Arándiga,2,6,-4
2009,Zaragoza,50036,Asín,0,6,-6
2009,Zaragoza,50038,Ateca,18,26,-8
2009,Zaragoza,50039,Azuara,2,12,-10
2009,Zaragoza,50030,Añón de Moncayo,1,9,-8
2009,Zaragoza,50040,Badules,0,1,-1
2009,Zaragoza,50044,Bardallur,2,5,-3
2009,Zaragoza,50045,Belchite,5,28,-23
2009,Zaragoza,50046,Belmonte de Gracián,1,5,-4
2009,Zaragoza,50901,Biel,0,3,-3
2009,Zaragoza,50050,Bijuesca,0,6,-6
2009,Zaragoza,50051,Biota,4,16,-12
2009,Zaragoza,50052,Bisimbre,0,1,-1
2009,Zaragoza,50053,Boquiñeni,5,13,-8
2009,Zaragoza,50054,Bordalba,0,2,-2
2009,Zaragoza,50055,Borja,53,67,-14
2009,Zaragoza,50056,Botorrita,3,5,-2
2009,Zaragoza,50057,Brea de Aragón,14,24,-10
2009,Zaragoza,50058,Bubierca,0,2,-2
2009,Zaragoza,50059,Bujaraloz,15,7,8
2009,Zaragoza,50060,Bulbuente,1,8,-7
2009,Zaragoza,50061,Bureta,1,10,-9
2009,Zaragoza,50062,Burgo de Ebro (El),24,13,11
2009,Zaragoza,50063,Buste (El),0,1,-1
2009,Zaragoza,50043,Bárboles,3,3,0
2009,Zaragoza,50064,Cabañas de Ebro,5,8,-3
2009,Zaragoza,50066,Cadrete,42,14,28
2009,Zaragoza,50067,Calatayud,203,262,-59
2009,Zaragoza,50068,Calatorao,31,32,-1
2009,Zaragoza,50070,Calmarza,0,2,-2
2009,Zaragoza,50071,Campillo de Aragón,0,3,-3
2009,Zaragoza,50072,Carenas,0,6,-6
2009,Zaragoza,50073,Cariñena,30,43,-13
2009,Zaragoza,50074,Caspe,96,113,-17
2009,Zaragoza,50075,Castejón de Alarba,0,2,-2
2009,Zaragoza,50076,Castejón de las Armas,0,2,-2
2009,Zaragoza,50077,Castejón de Valdejasa,0,3,-3
2009,Zaragoza,50078,Castiliscar,1,4,-3
2009,Zaragoza,50079,Cervera de la Cañada,2,7,-5
2009,Zaragoza,50080,Cerveruela,1,0,1
2009,Zaragoza,50081,Cetina,1,16,-15
2009,Zaragoza,50092,Chiprana,2,10,-8
2009,Zaragoza,50093,Chodes,1,2,-1
2009,Zaragoza,50082,Cimballa,0,0,0
2009,Zaragoza,50083,Cinco Olivas,4,4,0
2009,Zaragoza,50084,Clarés de Ribota,0,3,-3
2009,Zaragoza,50085,Codo,0,3,-3
2009,Zaragoza,50086,Codos,0,3,-3
2009,Zaragoza,50087,Contamina,1,2,-1
2009,Zaragoza,50088,Cosuenda,3,13,-10
2009,Zaragoza,50089,Cuarte de Huerva,178,23,155
2009,Zaragoza,50090,Cubel,1,4,-3
2009,Zaragoza,50091,Cuerlas (Las),0,1,-1
2009,Zaragoza,50094,Daroca,16,50,-34
2009,Zaragoza,50095,Ejea de los Caballeros,159,190,-31
2009,Zaragoza,50096,Embid de Ariza,1,2,-1
2009,Zaragoza,50098,Encinacorba,0,2,-2
2009,Zaragoza,50100,Erla,1,3,-2
2009,Zaragoza,50101,Escatrón,7,22,-15
2009,Zaragoza,50102,Fabara,6,14,-8
2009,Zaragoza,50104,Farlete,3,5,-2
2009,Zaragoza,50106,Fayos (Los),1,4,-3
2009,Zaragoza,50105,Fayón,2,6,-4
2009,Zaragoza,50107,Figueruelas,10,22,-12
2009,Zaragoza,50109,Frago (El),0,1,-1
2009,Zaragoza,50110,Frasno (El),2,8,-6
2009,Zaragoza,50111,Fréscano,0,4,-4
2009,Zaragoza,50113,Fuendejalón,7,15,-8
2009,Zaragoza,50114,Fuendetodos,1,2,-1
2009,Zaragoza,50115,Fuentes de Ebro,53,46,7
2009,Zaragoza,50116,Fuentes de Jiloca,2,9,-7
2009,Zaragoza,50117,Gallocanta,0,1,-1
2009,Zaragoza,50118,Gallur,20,30,-10
2009,Zaragoza,50119,Gelsa,6,17,-11
2009,Zaragoza,50120,Godojos,0,2,-2
2009,Zaragoza,50121,Gotor,0,1,-1
2009,Zaragoza,50123,Grisén,9,8,1
2009,Zaragoza,50124,Herrera de los Navarros,6,7,-1
2009,Zaragoza,50125,Ibdes,3,9,-6
2009,Zaragoza,50126,Illueca,25,24,1
2009,Zaragoza,50128,Isuerre,0,1,-1
2009,Zaragoza,50129,Jaraba,1,10,-9
2009,Zaragoza,50130,Jarque de Moncayo,2,9,-7
2009,Zaragoza,50131,Jaulín,0,9,-9
2009,Zaragoza,50132,Joyosa (La),18,9,9
2009,Zaragoza,50133,Lagata,0,3,-3
2009,Zaragoza,50134,Langa del Castillo,0,3,-3
2009,Zaragoza,50135,Layana,0,4,-4
2009,Zaragoza,50137,Leciñena,5,11,-6
2009,Zaragoza,50139,Letux,0,6,-6
2009,Zaragoza,50140,Litago,0,4,-4
2009,Zaragoza,50141,Lituénigo,1,0,1
2009,Zaragoza,50143,Longares,7,11,-4
2009,Zaragoza,50146,Lucena de Jalón,0,4,-4
2009,Zaragoza,50147,Luceni,12,15,-3
2009,Zaragoza,50148,Luesia,0,1,-1
2009,Zaragoza,50150,Lumpiaque,10,14,-4
2009,Zaragoza,50151,Luna,2,15,-13
2009,Zaragoza,50136,Lécera,5,9,-4
2009,Zaragoza,50152,Maella,1,10,-9
2009,Zaragoza,50153,Magallón,8,10,-2
2009,Zaragoza,50154,Mainar,1,1,0
2009,Zaragoza,50155,Malanquilla,0,1,-1
2009,Zaragoza,50156,Maleján,4,0,4
2009,Zaragoza,50160,Mallén,32,31,1
2009,Zaragoza,50159,Maluenda,10,11,-1
2009,Zaragoza,50157,Malón,2,8,-6
2009,Zaragoza,50161,Manchones,0,4,-4
2009,Zaragoza,50162,Mara,2,6,-4
2009,Zaragoza,50163,María de Huerva,107,17,90
2009,Zaragoza,50164,Mediana de Aragón,2,2,0
2009,Zaragoza,50165,Mequinenza,23,29,-6
2009,Zaragoza,50166,Mesones de Isuela,0,4,-4
2009,Zaragoza,50167,Mezalocha,1,4,-3
2009,Zaragoza,50168,Mianos,2,2,0
2009,Zaragoza,50169,Miedes de Aragón,2,8,-6
2009,Zaragoza,50170,Monegrillo,4,7,-3
2009,Zaragoza,50171,Moneva,0,1,-1
2009,Zaragoza,50172,Monreal de Ariza,0,2,-2
2009,Zaragoza,50173,Monterde,0,2,-2
2009,Zaragoza,50174,Montón,0,3,-3
2009,Zaragoza,50175,Morata de Jalón,5,18,-13
2009,Zaragoza,50176,Morata de Jiloca,0,3,-3
2009,Zaragoza,50178,Moros,0,4,-4
2009,Zaragoza,50177,Morés,2,9,-7
2009,Zaragoza,50179,Moyuela,0,5,-5
2009,Zaragoza,50180,Mozota,0,4,-4
2009,Zaragoza,50181,Muel,21,15,6
2009,Zaragoza,50182,Muela (La),59,21,38
2009,Zaragoza,50183,Munébrega,3,4,-1
2009,Zaragoza,50184,Murero,0,2,-2
2009,Zaragoza,50185,Murillo de Gállego,1,1,0
2009,Zaragoza,50186,Navardún,0,0,0
2009,Zaragoza,50187,Nigüella,0,3,-3
2009,Zaragoza,50189,Nonaspe,8,12,-4
2009,Zaragoza,50190,Novallas,6,9,-3
2009,Zaragoza,50191,Novillas,2,5,-3
2009,Zaragoza,50193,Nuez de Ebro,10,4,6
2009,Zaragoza,50192,Nuévalos,7,4,3
2009,Zaragoza,50194,Olvés,0,4,-4
2009,Zaragoza,50195,Orcajo,0,1,-1
2009,Zaragoza,50196,Orera,0,4,-4
2009,Zaragoza,50197,Orés,1,5,-4
2009,Zaragoza,50199,Osera de Ebro,3,15,-12
2009,Zaragoza,50200,Paniza,3,8,-5
2009,Zaragoza,50201,Paracuellos de Jiloca,5,6,-1
2009,Zaragoza,50202,Paracuellos de la Ribera,0,4,-4
2009,Zaragoza,50203,Pastriz,16,16,0
2009,Zaragoza,50204,Pedrola,39,28,11
2009,Zaragoza,50205,Pedrosas (Las),1,0,1
2009,Zaragoza,50206,Perdiguera,5,5,0
2009,Zaragoza,50207,Piedratajada,0,1,-1
2009,Zaragoza,50208,Pina de Ebro,35,19,16
2009,Zaragoza,50209,Pinseque,51,60,-9
2009,Zaragoza,50211,Plasencia de Jalón,3,5,-2
2009,Zaragoza,50212,Pleitas,0,1,-1
2009,Zaragoza,50213,Plenas,0,2,-2
2009,Zaragoza,50216,Pozuelo de Aragón,4,7,-3
2009,Zaragoza,50217,Pradilla de Ebro,1,9,-8
2009,Zaragoza,50218,Puebla de Albortón,4,3,1
2009,Zaragoza,50219,Puebla de Alfindén (La),96,28,68
2009,Zaragoza,50220,Puendeluna,0,2,-2
2009,Zaragoza,50222,Quinto,19,19,0
2009,Zaragoza,50223,Remolinos,9,21,-12
2009,Zaragoza,50224,Retascón,0,4,-4
2009,Zaragoza,50225,Ricla,26,28,-2
2009,Zaragoza,50227,Romanos,1,2,-1
2009,Zaragoza,50228,Rueda de Jalón,1,1,0
2009,Zaragoza,50229,Ruesca,0,2,-2
2009,Zaragoza,50231,Salillas de Jalón,1,4,-3
2009,Zaragoza,50232,Salvatierra de Esca,2,4,-2
2009,Zaragoza,50233,Samper del Salz,0,2,-2
2009,Zaragoza,50234,San Martín de la Virgen de Moncayo,2,4,-2
2009,Zaragoza,50235,San Mateo de Gállego,35,30,5
2009,Zaragoza,50236,Santa Cruz de Grío,1,0,1
2009,Zaragoza,50237,Santa Cruz de Moncayo,0,4,-4
2009,Zaragoza,50239,Santed,0,1,-1
2009,Zaragoza,50241,Saviñán,4,12,-8
2009,Zaragoza,50242,Sediles,1,0,1
2009,Zaragoza,50243,Sestrica,0,9,-9
2009,Zaragoza,50244,Sierra de Luna,1,3,-2
2009,Zaragoza,50245,Sigüés,0,1,-1
2009,Zaragoza,50246,Sisamón,0,1,-1
2009,Zaragoza,50247,Sobradiel,12,13,-1
2009,Zaragoza,50248,Sos del Rey Católico,2,16,-14
2009,Zaragoza,50230,Sádaba,10,28,-18
2009,Zaragoza,50240,Sástago,1,13,-12
2009,Zaragoza,50249,Tabuenca,2,4,-2
2009,Zaragoza,50250,Talamantes,0,1,-1
2009,Zaragoza,50251,Tarazona,105,141,-36
2009,Zaragoza,50252,Tauste,47,86,-39
2009,Zaragoza,50253,Terrer,3,9,-6
2009,Zaragoza,50254,Tierga,0,5,-5
2009,Zaragoza,50255,Tobed,1,9,-8
2009,Zaragoza,50256,Torralba de los Frailes,0,2,-2
2009,Zaragoza,50261,Torrellas,1,3,-2
2009,Zaragoza,50262,Torres de Berrellén,13,20,-7
2009,Zaragoza,50263,Torrijo de la Cañada,0,3,-3
2009,Zaragoza,50264,Tosos,2,3,-1
2009,Zaragoza,50265,Trasmoz,1,1,0
2009,Zaragoza,50266,Trasobares,0,1,-1
2009,Zaragoza,50267,Uncastillo,2,17,-15
2009,Zaragoza,50268,Undués de Lerda,1,1,0
2009,Zaragoza,50269,Urrea de Jalón,2,11,-9
2009,Zaragoza,50270,Urriés,0,1,-1
2009,Zaragoza,50271,Used,0,4,-4
2009,Zaragoza,50272,Utebo,291,64,227
2009,Zaragoza,50274,Val de San Martín,0,2,-2
2009,Zaragoza,50273,Valdehorna,0,1,-1
2009,Zaragoza,50275,Valmadrid,1,2,-1
2009,Zaragoza,50276,Valpalmas,0,4,-4
2009,Zaragoza,50277,Valtorres,0,2,-2
2009,Zaragoza,50278,Velilla de Ebro,4,2,2
2009,Zaragoza,50279,Velilla de Jiloca,0,2,-2
2009,Zaragoza,50280,Vera de Moncayo,1,10,-9
2009,Zaragoza,50281,Vierlas,0,1,-1
2009,Zaragoza,50284,Villafeliche,1,4,-3
2009,Zaragoza,50285,Villafranca de Ebro,4,14,-10
2009,Zaragoza,50286,Villalba de Perejil,0,2,-2
2009,Zaragoza,50287,Villalengua,2,2,0
2009,Zaragoza,50903,Villamayor de Gállego,17,27,-10
2009,Zaragoza,50288,Villanueva de Gállego,43,25,18
2009,Zaragoza,50290,Villanueva de Huerva,5,7,-2
2009,Zaragoza,50291,Villar de los Navarros,0,1,-1
2009,Zaragoza,50292,Villarreal de Huerva,0,2,-2
2009,Zaragoza,50293,Villarroya de la Sierra,1,6,-5
2009,Zaragoza,50294,Villarroya del Campo,0,3,-3
2009,Zaragoza,50295,Vistabella,0,1,-1
2009,Zaragoza,50296,Zaida (La),0,11,-11
2009,Zaragoza,50297,Zaragoza,6906,5854,1052
2009,Zaragoza,50298,Zuera,74,63,11
2009,Zaragoza,50099,Épila,63,45,18
2008,Zaragoza,50001,Abanto,0,3,-3
2008,Zaragoza,50002,Acered,1,8,-7
2008,Zaragoza,50004,Aguarón,4,25,-21
2008,Zaragoza,50005,Aguilón,0,1,-1
2008,Zaragoza,50003,Agón,1,1,0
2008,Zaragoza,50006,Ainzón,8,23,-15
2008,Zaragoza,50007,Aladrén,0,1,-1
2008,Zaragoza,50008,Alagón,67,91,-24
2008,Zaragoza,50009,Alarba,0,3,-3
2008,Zaragoza,50010,Alberite de San Juan,0,3,-3
2008,Zaragoza,50011,Albeta,1,4,-3
2008,Zaragoza,50012,Alborge,0,1,-1
2008,Zaragoza,50013,Alcalá de Ebro,0,3,-3
2008,Zaragoza,50014,Alcalá de Moncayo,0,1,-1
2008,Zaragoza,50015,Alconchel de Ariza,0,2,-2
2008,Zaragoza,50017,Alfajarín,26,20,6
2008,Zaragoza,50018,Alfamén,22,11,11
2008,Zaragoza,50020,Alhama de Aragón,9,11,-2
2008,Zaragoza,50021,Almochuel,0,1,-1
2008,Zaragoza,50022,Almolda (La),2,7,-5
2008,Zaragoza,50023,Almonacid de la Cuba,0,3,-3
2008,Zaragoza,50024,Almonacid de la Sierra,4,8,-4
2008,Zaragoza,50025,Almunia de Doña Godina (La),91,79,12
2008,Zaragoza,50026,Alpartir,2,3,-1
2008,Zaragoza,50027,Ambel,1,2,-1
2008,Zaragoza,50028,Anento,1,0,1
2008,Zaragoza,50029,Aniñón,2,14,-12
2008,Zaragoza,50031,Aranda de Moncayo,1,4,-3
2008,Zaragoza,50033,Ardisa,0,1,-1
2008,Zaragoza,50034,Ariza,12,22,-10
2008,Zaragoza,50032,Arándiga,0,11,-11
2008,Zaragoza,50036,Asín,0,4,-4
2008,Zaragoza,50037,Atea,0,5,-5
2008,Zaragoza,50038,Ateca,9,24,-15
2008,Zaragoza,50039,Azuara,4,6,-2
2008,Zaragoza,50030,Añón de Moncayo,0,6,-6
2008,Zaragoza,50040,Badules,0,5,-5
2008,Zaragoza,50041,Bagüés,0,0,0
2008,Zaragoza,50042,Balconchán,0,1,-1
2008,Zaragoza,50044,Bardallur,2,2,0
2008,Zaragoza,50045,Belchite,10,26,-16
2008,Zaragoza,50046,Belmonte de Gracián,1,7,-6
2008,Zaragoza,50047,Berdejo,2,2,0
2008,Zaragoza,50048,Berrueco,0,1,-1
2008,Zaragoza,50901,Biel,0,1,-1
2008,Zaragoza,50050,Bijuesca,0,3,-3
2008,Zaragoza,50051,Biota,4,14,-10
2008,Zaragoza,50052,Bisimbre,1,0,1
2008,Zaragoza,50053,Boquiñeni,3,11,-8
2008,Zaragoza,50055,Borja,70,61,9
2008,Zaragoza,50056,Botorrita,3,3,0
2008,Zaragoza,50057,Brea de Aragón,9,27,-18
2008,Zaragoza,50058,Bubierca,1,2,-1
2008,Zaragoza,50059,Bujaraloz,10,16,-6
2008,Zaragoza,50060,Bulbuente,1,5,-4
2008,Zaragoza,50061,Bureta,2,3,-1
2008,Zaragoza,50062,Burgo de Ebro (El),30,20,10
2008,Zaragoza,50043,Bárboles,1,1,0
2008,Zaragoza,50064,Cabañas de Ebro,4,18,-14
2008,Zaragoza,50066,Cadrete,40,20,20
2008,Zaragoza,50067,Calatayud,225,253,-28
2008,Zaragoza,50068,Calatorao,29,29,0
2008,Zaragoza,50069,Calcena,0,1,-1
2008,Zaragoza,50070,Calmarza,0,3,-3
2008,Zaragoza,50071,Campillo de Aragón,0,2,-2
2008,Zaragoza,50072,Carenas,0,5,-5
2008,Zaragoza,50073,Cariñena,41,52,-11
2008,Zaragoza,50074,Caspe,103,89,14
2008,Zaragoza,50075,Castejón de Alarba,0,2,-2
2008,Zaragoza,50076,Castejón de las Armas,0,2,-2
2008,Zaragoza,50077,Castejón de Valdejasa,0,7,-7
2008,Zaragoza,50078,Castiliscar,0,5,-5
2008,Zaragoza,50079,Cervera de la Cañada,2,7,-5
2008,Zaragoza,50081,Cetina,5,22,-17
2008,Zaragoza,50092,Chiprana,3,4,-1
2008,Zaragoza,50093,Chodes,1,1,0
2008,Zaragoza,50082,Cimballa,0,2,-2
2008,Zaragoza,50083,Cinco Olivas,0,4,-4
2008,Zaragoza,50084,Clarés de Ribota,0,1,-1
2008,Zaragoza,50085,Codo,0,5,-5
2008,Zaragoza,50086,Codos,0,7,-7
2008,Zaragoza,50087,Contamina,1,3,-2
2008,Zaragoza,50088,Cosuenda,3,5,-2
2008,Zaragoza,50089,Cuarte de Huerva,188,26,162
2008,Zaragoza,50090,Cubel,5,4,1
2008,Zaragoza,50094,Daroca,19,37,-18
2008,Zaragoza,50095,Ejea de los Caballeros,185,176,9
2008,Zaragoza,50098,Encinacorba,0,3,-3
2008,Zaragoza,50100,Erla,0,4,-4
2008,Zaragoza,50101,Escatrón,3,16,-13
2008,Zaragoza,50102,Fabara,12,12,0
2008,Zaragoza,50104,Farlete,2,9,-7
2008,Zaragoza,50106,Fayos (Los),0,6,-6
2008,Zaragoza,50105,Fayón,0,10,-10
2008,Zaragoza,50107,Figueruelas,16,19,-3
2008,Zaragoza,50108,Fombuena,0,1,-1
2008,Zaragoza,50109,Frago (El),0,1,-1
2008,Zaragoza,50110,Frasno (El),1,9,-8
2008,Zaragoza,50111,Fréscano,0,3,-3
2008,Zaragoza,50113,Fuendejalón,5,14,-9
2008,Zaragoza,50114,Fuendetodos,0,2,-2
2008,Zaragoza,50115,Fuentes de Ebro,53,36,17
2008,Zaragoza,50116,Fuentes de Jiloca,1,6,-5
2008,Zaragoza,50117,Gallocanta,1,0,1
2008,Zaragoza,50118,Gallur,23,37,-14
2008,Zaragoza,50119,Gelsa,5,13,-8
2008,Zaragoza,50120,Godojos,0,1,-1
2008,Zaragoza,50121,Gotor,4,2,2
2008,Zaragoza,50122,Grisel,0,1,-1
2008,Zaragoza,50123,Grisén,4,5,-1
2008,Zaragoza,50124,Herrera de los Navarros,4,6,-2
2008,Zaragoza,50125,Ibdes,0,6,-6
2008,Zaragoza,50126,Illueca,30,23,7
2008,Zaragoza,50128,Isuerre,1,1,0
2008,Zaragoza,50129,Jaraba,5,4,1
2008,Zaragoza,50130,Jarque de Moncayo,2,6,-4
2008,Zaragoza,50131,Jaulín,1,7,-6
2008,Zaragoza,50132,Joyosa (La),15,8,7
2008,Zaragoza,50133,Lagata,0,2,-2
2008,Zaragoza,50134,Langa del Castillo,0,0,0
2008,Zaragoza,50138,Lechón,0,1,-1
2008,Zaragoza,50137,Leciñena,5,14,-9
2008,Zaragoza,50139,Letux,0,9,-9
2008,Zaragoza,50140,Litago,0,4,-4
2008,Zaragoza,50141,Lituénigo,0,1,-1
2008,Zaragoza,50142,Lobera de Onsella,0,2,-2
2008,Zaragoza,50143,Longares,7,9,-2
2008,Zaragoza,50144,Longás,0,1,-1
2008,Zaragoza,50146,Lucena de Jalón,3,3,0
2008,Zaragoza,50147,Luceni,11,17,-6
2008,Zaragoza,50148,Luesia,1,9,-8
2008,Zaragoza,50150,Lumpiaque,6,19,-13
2008,Zaragoza,50151,Luna,1,11,-10
2008,Zaragoza,50136,Lécera,2,12,-10
2008,Zaragoza,50152,Maella,1,15,-14
2008,Zaragoza,50153,Magallón,15,11,4
2008,Zaragoza,50154,Mainar,0,4,-4
2008,Zaragoza,50156,Maleján,2,4,-2
2008,Zaragoza,50160,Mallén,42,32,10
2008,Zaragoza,50159,Maluenda,10,15,-5
2008,Zaragoza,50157,Malón,0,4,-4
2008,Zaragoza,50161,Manchones,0,2,-2
2008,Zaragoza,50902,Marracos,0,0,0
2008,Zaragoza,50163,María de Huerva,117,19,98
2008,Zaragoza,50164,Mediana de Aragón,2,4,-2
2008,Zaragoza,50165,Mequinenza,11,38,-27
2008,Zaragoza,50166,Mesones de Isuela,1,5,-4
2008,Zaragoza,50167,Mezalocha,0,2,-2
2008,Zaragoza,50169,Miedes de Aragón,0,7,-7
2008,Zaragoza,50170,Monegrillo,2,12,-10
2008,Zaragoza,50171,Moneva,0,1,-1
2008,Zaragoza,50172,Monreal de Ariza,0,6,-6
2008,Zaragoza,50173,Monterde,0,5,-5
2008,Zaragoza,50174,Montón,0,2,-2
2008,Zaragoza,50175,Morata de Jalón,6,16,-10
2008,Zaragoza,50176,Morata de Jiloca,0,5,-5
2008,Zaragoza,50178,Moros,0,3,-3
2008,Zaragoza,50177,Morés,2,8,-6
2008,Zaragoza,50179,Moyuela,0,3,-3
2008,Zaragoza,50180,Mozota,0,2,-2
2008,Zaragoza,50181,Muel,14,11,3
2008,Zaragoza,50182,Muela (La),74,18,56
2008,Zaragoza,50183,Munébrega,0,12,-12
2008,Zaragoza,50185,Murillo de Gállego,2,1,1
2008,Zaragoza,50186,Navardún,0,1,-1
2008,Zaragoza,50187,Nigüella,0,1,-1
2008,Zaragoza,50189,Nonaspe,10,15,-5
2008,Zaragoza,50190,Novallas,6,12,-6
2008,Zaragoza,50191,Novillas,5,9,-4
2008,Zaragoza,50193,Nuez de Ebro,14,3,11
2008,Zaragoza,50192,Nuévalos,1,1,0
2008,Zaragoza,50194,Olvés,1,2,-1
2008,Zaragoza,50195,Orcajo,0,1,-1
2008,Zaragoza,50196,Orera,0,1,-1
2008,Zaragoza,50197,Orés,0,2,-2
2008,Zaragoza,50199,Osera de Ebro,5,23,-18
2008,Zaragoza,50200,Paniza,3,7,-4
2008,Zaragoza,50201,Paracuellos de Jiloca,3,11,-8
2008,Zaragoza,50202,Paracuellos de la Ribera,0,4,-4
2008,Zaragoza,50203,Pastriz,14,15,-1
2008,Zaragoza,50204,Pedrola,41,37,4
2008,Zaragoza,50205,Pedrosas (Las),0,0,0
2008,Zaragoza,50206,Perdiguera,3,10,-7
2008,Zaragoza,50207,Piedratajada,0,3,-3
2008,Zaragoza,50208,Pina de Ebro,20,21,-1
2008,Zaragoza,50209,Pinseque,48,68,-20
2008,Zaragoza,50211,Plasencia de Jalón,1,2,-1
2008,Zaragoza,50212,Pleitas,0,4,-4
2008,Zaragoza,50213,Plenas,0,3,-3
2008,Zaragoza,50216,Pozuelo de Aragón,2,7,-5
2008,Zaragoza,50217,Pradilla de Ebro,0,9,-9
2008,Zaragoza,50218,Puebla de Albortón,0,3,-3
2008,Zaragoza,50219,Puebla de Alfindén (La),119,32,87
2008,Zaragoza,50220,Puendeluna,0,1,-1
2008,Zaragoza,50221,Purujosa,1,0,1
2008,Zaragoza,50222,Quinto,20,21,-1
2008,Zaragoza,50223,Remolinos,9,23,-14
2008,Zaragoza,50224,Retascón,0,2,-2
2008,Zaragoza,50225,Ricla,30,26,4
2008,Zaragoza,50227,Romanos,0,1,-1
2008,Zaragoza,50228,Rueda de Jalón,2,3,-1
2008,Zaragoza,50229,Ruesca,0,1,-1
2008,Zaragoza,50231,Salillas de Jalón,2,5,-3
2008,Zaragoza,50232,Salvatierra de Esca,2,7,-5
2008,Zaragoza,50234,San Martín de la Virgen de Moncayo,1,2,-1
2008,Zaragoza,50235,San Mateo de Gállego,28,32,-4
2008,Zaragoza,50236,Santa Cruz de Grío,0,2,-2
2008,Zaragoza,50237,Santa Cruz de Moncayo,1,4,-3
2008,Zaragoza,50238,Santa Eulalia de Gállego,0,2,-2
2008,Zaragoza,50241,Saviñán,7,8,-1
2008,Zaragoza,50242,Sediles,0,1,-1
2008,Zaragoza,50243,Sestrica,0,5,-5
2008,Zaragoza,50244,Sierra de Luna,0,3,-3
2008,Zaragoza,50245,Sigüés,2,0,2
2008,Zaragoza,50247,Sobradiel,14,8,6
2008,Zaragoza,50248,Sos del Rey Católico,7,16,-9
2008,Zaragoza,50230,Sádaba,15,35,-20
2008,Zaragoza,50240,Sástago,2,3,-1
2008,Zaragoza,50249,Tabuenca,0,6,-6
2008,Zaragoza,50250,Talamantes,0,5,-5
2008,Zaragoza,50251,Tarazona,119,161,-42
2008,Zaragoza,50252,Tauste,70,75,-5
2008,Zaragoza,50253,Terrer,2,12,-10
2008,Zaragoza,50254,Tierga,0,6,-6
2008,Zaragoza,50255,Tobed,0,7,-7
2008,Zaragoza,50256,Torralba de los Frailes,0,2,-2
2008,Zaragoza,50257,Torralba de Ribota,1,4,-3
2008,Zaragoza,50261,Torrellas,0,6,-6
2008,Zaragoza,50262,Torres de Berrellén,16,12,4
2008,Zaragoza,50263,Torrijo de la Cañada,0,10,-10
2008,Zaragoza,50264,Tosos,2,4,-2
2008,Zaragoza,50265,Trasmoz,0,2,-2
2008,Zaragoza,50266,Trasobares,0,5,-5
2008,Zaragoza,50267,Uncastillo,4,10,-6
2008,Zaragoza,50268,Undués de Lerda,1,0,1
2008,Zaragoza,50269,Urrea de Jalón,1,10,-9
2008,Zaragoza,50270,Urriés,0,1,-1
2008,Zaragoza,50271,Used,0,3,-3
2008,Zaragoza,50272,Utebo,271,85,186
2008,Zaragoza,50274,Val de San Martín,0,1,-1
2008,Zaragoza,50273,Valdehorna,0,3,-3
2008,Zaragoza,50275,Valmadrid,0,4,-4
2008,Zaragoza,50276,Valpalmas,0,4,-4
2008,Zaragoza,50277,Valtorres,1,0,1
2008,Zaragoza,50278,Velilla de Ebro,2,6,-4
2008,Zaragoza,50279,Velilla de Jiloca,0,3,-3
2008,Zaragoza,50280,Vera de Moncayo,0,5,-5
2008,Zaragoza,50281,Vierlas,1,6,-5
2008,Zaragoza,50283,Villadoz,1,3,-2
2008,Zaragoza,50285,Villafranca de Ebro,4,8,-4
2008,Zaragoza,50286,Villalba de Perejil,0,2,-2
2008,Zaragoza,50287,Villalengua,1,4,-3
2008,Zaragoza,50903,Villamayor de Gállego,23,32,-9
2008,Zaragoza,50288,Villanueva de Gállego,49,32,17
2008,Zaragoza,50290,Villanueva de Huerva,3,8,-5
2008,Zaragoza,50289,Villanueva de Jiloca,0,2,-2
2008,Zaragoza,50292,Villarreal de Huerva,1,2,-1
2008,Zaragoza,50293,Villarroya de la Sierra,1,9,-8
2008,Zaragoza,50294,Villarroya del Campo,0,4,-4
2008,Zaragoza,50282,Vilueña (La),0,1,-1
2008,Zaragoza,50296,Zaida (La),6,7,-1
2008,Zaragoza,50297,Zaragoza,7339,5989,1350
2008,Zaragoza,50298,Zuera,80,73,7
2008,Zaragoza,50099,Épila,57,52,5
2007,Zaragoza,50001,Abanto,0,8,-8
2007,Zaragoza,50002,Acered,0,9,-9
2007,Zaragoza,50004,Aguarón,3,25,-22
2007,Zaragoza,50005,Aguilón,0,7,-7
2007,Zaragoza,50006,Ainzón,9,17,-8
2007,Zaragoza,50008,Alagón,94,72,22
2007,Zaragoza,50009,Alarba,3,1,2
2007,Zaragoza,50010,Alberite de San Juan,0,4,-4
2007,Zaragoza,50011,Albeta,0,1,-1
2007,Zaragoza,50012,Alborge,2,2,0
2007,Zaragoza,50013,Alcalá de Ebro,2,2,0
2007,Zaragoza,50014,Alcalá de Moncayo,0,0,0
2007,Zaragoza,50015,Alconchel de Ariza,1,3,-2
2007,Zaragoza,50016,Aldehuela de Liestos,0,1,-1
2007,Zaragoza,50017,Alfajarín,22,16,6
2007,Zaragoza,50018,Alfamén,9,11,-2
2007,Zaragoza,50019,Alforque,1,4,-3
2007,Zaragoza,50020,Alhama de Aragón,6,17,-11
2007,Zaragoza,50021,Almochuel,0,2,-2
2007,Zaragoza,50022,Almolda (La),2,14,-12
2007,Zaragoza,50023,Almonacid de la Cuba,1,3,-2
2007,Zaragoza,50024,Almonacid de la Sierra,7,16,-9
2007,Zaragoza,50025,Almunia de Doña Godina (La),93,71,22
2007,Zaragoza,50026,Alpartir,1,14,-13
2007,Zaragoza,50027,Ambel,0,11,-11
2007,Zaragoza,50029,Aniñón,5,12,-7
2007,Zaragoza,50031,Aranda de Moncayo,1,3,-2
2007,Zaragoza,50033,Ardisa,0,1,-1
2007,Zaragoza,50034,Ariza,22,27,-5
2007,Zaragoza,50035,Artieda,0,1,-1
2007,Zaragoza,50032,Arándiga,1,8,-7
2007,Zaragoza,50036,Asín,0,4,-4
2007,Zaragoza,50037,Atea,1,4,-3
2007,Zaragoza,50038,Ateca,12,30,-18
2007,Zaragoza,50039,Azuara,3,3,0
2007,Zaragoza,50030,Añón de Moncayo,0,6,-6
2007,Zaragoza,50040,Badules,0,3,-3
2007,Zaragoza,50042,Balconchán,0,1,-1
2007,Zaragoza,50044,Bardallur,2,2,0
2007,Zaragoza,50045,Belchite,13,16,-3
2007,Zaragoza,50046,Belmonte de Gracián,1,7,-6
2007,Zaragoza,50048,Berrueco,0,1,-1
2007,Zaragoza,50901,Biel,0,4,-4
2007,Zaragoza,50050,Bijuesca,0,1,-1
2007,Zaragoza,50051,Biota,3,13,-10
2007,Zaragoza,50052,Bisimbre,1,4,-3
2007,Zaragoza,50053,Boquiñeni,9,19,-10
2007,Zaragoza,50055,Borja,43,69,-26
2007,Zaragoza,50056,Botorrita,6,9,-3
2007,Zaragoza,50057,Brea de Aragón,18,20,-2
2007,Zaragoza,50058,Bubierca,0,3,-3
2007,Zaragoza,50059,Bujaraloz,4,12,-8
2007,Zaragoza,50060,Bulbuente,0,9,-9
2007,Zaragoza,50061,Bureta,1,9,-8
2007,Zaragoza,50062,Burgo de Ebro (El),30,24,6
2007,Zaragoza,50063,Buste (El),0,2,-2
2007,Zaragoza,50043,Bárboles,3,3,0
2007,Zaragoza,50064,Cabañas de Ebro,2,13,-11
2007,Zaragoza,50065,Cabolafuente,0,2,-2
2007,Zaragoza,50066,Cadrete,32,12,20
2007,Zaragoza,50067,Calatayud,200,217,-17
2007,Zaragoza,50068,Calatorao,28,30,-2
2007,Zaragoza,50069,Calcena,1,1,0
2007,Zaragoza,50070,Calmarza,0,3,-3
2007,Zaragoza,50071,Campillo de Aragón,0,5,-5
2007,Zaragoza,50072,Carenas,2,4,-2
2007,Zaragoza,50073,Cariñena,33,46,-13
2007,Zaragoza,50074,Caspe,69,92,-23
2007,Zaragoza,50075,Castejón de Alarba,0,2,-2
2007,Zaragoza,50076,Castejón de las Armas,0,1,-1
2007,Zaragoza,50077,Castejón de Valdejasa,1,2,-1
2007,Zaragoza,50078,Castiliscar,2,5,-3
2007,Zaragoza,50079,Cervera de la Cañada,3,5,-2
2007,Zaragoza,50081,Cetina,8,6,2
2007,Zaragoza,50092,Chiprana,3,9,-6
2007,Zaragoza,50093,Chodes,1,1,0
2007,Zaragoza,50082,Cimballa,2,1,1
2007,Zaragoza,50083,Cinco Olivas,1,3,-2
2007,Zaragoza,50084,Clarés de Ribota,0,2,-2
2007,Zaragoza,50085,Codo,0,4,-4
2007,Zaragoza,50086,Codos,1,8,-7
2007,Zaragoza,50087,Contamina,0,1,-1
2007,Zaragoza,50088,Cosuenda,1,2,-1
2007,Zaragoza,50089,Cuarte de Huerva,115,25,90
2007,Zaragoza,50090,Cubel,1,1,0
2007,Zaragoza,50094,Daroca,12,33,-21
2007,Zaragoza,50095,Ejea de los Caballeros,167,168,-1
2007,Zaragoza,50096,Embid de Ariza,0,2,-2
2007,Zaragoza,50098,Encinacorba,1,5,-4
2007,Zaragoza,50100,Erla,2,9,-7
2007,Zaragoza,50101,Escatrón,4,17,-13
2007,Zaragoza,50102,Fabara,9,13,-4
2007,Zaragoza,50104,Farlete,2,4,-2
2007,Zaragoza,50106,Fayos (Los),0,3,-3
2007,Zaragoza,50105,Fayón,1,8,-7
2007,Zaragoza,50107,Figueruelas,14,28,-14
2007,Zaragoza,50109,Frago (El),0,2,-2
2007,Zaragoza,50110,Frasno (El),1,6,-5
2007,Zaragoza,50111,Fréscano,0,3,-3
2007,Zaragoza,50113,Fuendejalón,6,14,-8
2007,Zaragoza,50114,Fuendetodos,0,1,-1
2007,Zaragoza,50115,Fuentes de Ebro,41,32,9
2007,Zaragoza,50116,Fuentes de Jiloca,4,5,-1
2007,Zaragoza,50117,Gallocanta,3,2,1
2007,Zaragoza,50118,Gallur,33,36,-3
2007,Zaragoza,50119,Gelsa,15,12,3
2007,Zaragoza,50120,Godojos,0,1,-1
2007,Zaragoza,50121,Gotor,4,4,0
2007,Zaragoza,50122,Grisel,0,4,-4
2007,Zaragoza,50123,Grisén,3,14,-11
2007,Zaragoza,50124,Herrera de los Navarros,4,10,-6
2007,Zaragoza,50125,Ibdes,2,12,-10
2007,Zaragoza,50126,Illueca,20,33,-13
2007,Zaragoza,50129,Jaraba,5,4,1
2007,Zaragoza,50130,Jarque de Moncayo,1,3,-2
2007,Zaragoza,50131,Jaulín,3,3,0
2007,Zaragoza,50132,Joyosa (La),18,10,8
2007,Zaragoza,50133,Lagata,0,5,-5
2007,Zaragoza,50134,Langa del Castillo,0,1,-1
2007,Zaragoza,50135,Layana,0,1,-1
2007,Zaragoza,50137,Leciñena,8,5,3
2007,Zaragoza,50139,Letux,1,12,-11
2007,Zaragoza,50140,Litago,0,3,-3
2007,Zaragoza,50141,Lituénigo,0,2,-2
2007,Zaragoza,50142,Lobera de Onsella,0,3,-3
2007,Zaragoza,50143,Longares,8,7,1
2007,Zaragoza,50146,Lucena de Jalón,2,4,-2
2007,Zaragoza,50147,Luceni,5,14,-9
2007,Zaragoza,50148,Luesia,0,7,-7
2007,Zaragoza,50150,Lumpiaque,10,11,-1
2007,Zaragoza,50151,Luna,4,15,-11
2007,Zaragoza,50136,Lécera,4,5,-1
2007,Zaragoza,50152,Maella,1,16,-15
2007,Zaragoza,50153,Magallón,10,14,-4
2007,Zaragoza,50154,Mainar,2,4,-2
2007,Zaragoza,50156,Maleján,1,2,-1
2007,Zaragoza,50160,Mallén,28,29,-1
2007,Zaragoza,50159,Maluenda,7,13,-6
2007,Zaragoza,50157,Malón,0,8,-8
2007,Zaragoza,50161,Manchones,1,2,-1
2007,Zaragoza,50162,Mara,3,4,-1
2007,Zaragoza,50902,Marracos,1,3,-2
2007,Zaragoza,50163,María de Huerva,91,26,65
2007,Zaragoza,50164,Mediana de Aragón,5,8,-3
2007,Zaragoza,50165,Mequinenza,22,36,-14
2007,Zaragoza,50166,Mesones de Isuela,1,3,-2
2007,Zaragoza,50167,Mezalocha,0,3,-3
2007,Zaragoza,50168,Mianos,0,1,-1
2007,Zaragoza,50169,Miedes de Aragón,1,8,-7
2007,Zaragoza,50170,Monegrillo,4,3,1
2007,Zaragoza,50171,Moneva,0,2,-2
2007,Zaragoza,50172,Monreal de Ariza,0,4,-4
2007,Zaragoza,50173,Monterde,0,1,-1
2007,Zaragoza,50174,Montón,0,4,-4
2007,Zaragoza,50175,Morata de Jalón,4,23,-19
2007,Zaragoza,50176,Morata de Jiloca,0,4,-4
2007,Zaragoza,50178,Moros,5,8,-3
2007,Zaragoza,50177,Morés,4,13,-9
2007,Zaragoza,50179,Moyuela,1,6,-5
2007,Zaragoza,50180,Mozota,0,5,-5
2007,Zaragoza,50181,Muel,8,18,-10
2007,Zaragoza,50182,Muela (La),53,16,37
2007,Zaragoza,50183,Munébrega,1,4,-3
2007,Zaragoza,50184,Murero,1,0,1
2007,Zaragoza,50185,Murillo de Gállego,1,0,1
2007,Zaragoza,50187,Nigüella,0,1,-1
2007,Zaragoza,50188,Nombrevilla,0,1,-1
2007,Zaragoza,50189,Nonaspe,9,9,0
2007,Zaragoza,50190,Novallas,5,8,-3
2007,Zaragoza,50191,Novillas,4,8,-4
2007,Zaragoza,50193,Nuez de Ebro,5,6,-1
2007,Zaragoza,50192,Nuévalos,4,5,-1
2007,Zaragoza,50194,Olvés,0,1,-1
2007,Zaragoza,50195,Orcajo,0,1,-1
2007,Zaragoza,50196,Orera,1,2,-1
2007,Zaragoza,50197,Orés,0,3,-3
2007,Zaragoza,50199,Osera de Ebro,5,18,-13
2007,Zaragoza,50200,Paniza,5,9,-4
2007,Zaragoza,50201,Paracuellos de Jiloca,2,9,-7
2007,Zaragoza,50202,Paracuellos de la Ribera,0,7,-7
2007,Zaragoza,50203,Pastriz,16,19,-3
2007,Zaragoza,50204,Pedrola,33,32,1
2007,Zaragoza,50205,Pedrosas (Las),1,0,1
2007,Zaragoza,50206,Perdiguera,6,5,1
2007,Zaragoza,50207,Piedratajada,1,3,-2
2007,Zaragoza,50208,Pina de Ebro,32,19,13
2007,Zaragoza,50209,Pinseque,52,56,-4
2007,Zaragoza,50211,Plasencia de Jalón,0,3,-3
2007,Zaragoza,50213,Plenas,0,2,-2
2007,Zaragoza,50216,Pozuelo de Aragón,2,3,-1
2007,Zaragoza,50217,Pradilla de Ebro,5,7,-2
2007,Zaragoza,50218,Puebla de Albortón,0,1,-1
2007,Zaragoza,50219,Puebla de Alfindén (La),94,32,62
2007,Zaragoza,50220,Puendeluna,0,1,-1
2007,Zaragoza,50222,Quinto,14,27,-13
2007,Zaragoza,50223,Remolinos,4,18,-14
2007,Zaragoza,50224,Retascón,0,1,-1
2007,Zaragoza,50225,Ricla,23,20,3
2007,Zaragoza,50227,Romanos,0,0,0
2007,Zaragoza,50228,Rueda de Jalón,1,6,-5
2007,Zaragoza,50229,Ruesca,0,2,-2
2007,Zaragoza,50231,Salillas de Jalón,4,5,-1
2007,Zaragoza,50232,Salvatierra de Esca,2,5,-3
2007,Zaragoza,50233,Samper del Salz,0,2,-2
2007,Zaragoza,50234,San Martín de la Virgen de Moncayo,2,5,-3
2007,Zaragoza,50235,San Mateo de Gállego,24,26,-2
2007,Zaragoza,50236,Santa Cruz de Grío,0,4,-4
2007,Zaragoza,50237,Santa Cruz de Moncayo,0,3,-3
2007,Zaragoza,50238,Santa Eulalia de Gállego,0,1,-1
2007,Zaragoza,50239,Santed,0,1,-1
2007,Zaragoza,50241,Saviñán,7,9,-2
2007,Zaragoza,50242,Sediles,1,0,1
2007,Zaragoza,50243,Sestrica,0,8,-8
2007,Zaragoza,50244,Sierra de Luna,0,1,-1
2007,Zaragoza,50245,Sigüés,0,4,-4
2007,Zaragoza,50246,Sisamón,0,1,-1
2007,Zaragoza,50247,Sobradiel,3,7,-4
2007,Zaragoza,50248,Sos del Rey Católico,3,9,-6
2007,Zaragoza,50230,Sádaba,8,31,-23
2007,Zaragoza,50240,Sástago,1,10,-9
2007,Zaragoza,50249,Tabuenca,0,5,-5
2007,Zaragoza,50251,Tarazona,130,140,-10
2007,Zaragoza,50252,Tauste,72,74,-2
2007,Zaragoza,50253,Terrer,2,12,-10
2007,Zaragoza,50254,Tierga,1,4,-3
2007,Zaragoza,50255,Tobed,1,6,-5
2007,Zaragoza,50256,Torralba de los Frailes,0,1,-1
2007,Zaragoza,50257,Torralba de Ribota,0,3,-3
2007,Zaragoza,50258,Torralbilla,0,1,-1
2007,Zaragoza,50259,Torrehermosa,0,3,-3
2007,Zaragoza,50261,Torrellas,2,2,0
2007,Zaragoza,50262,Torres de Berrellén,13,14,-1
2007,Zaragoza,50263,Torrijo de la Cañada,1,8,-7
2007,Zaragoza,50264,Tosos,1,5,-4
2007,Zaragoza,50265,Trasmoz,0,1,-1
2007,Zaragoza,50266,Trasobares,0,1,-1
2007,Zaragoza,50267,Uncastillo,2,16,-14
2007,Zaragoza,50268,Undués de Lerda,0,0,0
2007,Zaragoza,50269,Urrea de Jalón,4,9,-5
2007,Zaragoza,50271,Used,2,6,-4
2007,Zaragoza,50272,Utebo,278,65,213
2007,Zaragoza,50274,Val de San Martín,0,3,-3
2007,Zaragoza,50275,Valmadrid,1,2,-1
2007,Zaragoza,50276,Valpalmas,0,2,-2
2007,Zaragoza,50277,Valtorres,0,3,-3
2007,Zaragoza,50278,Velilla de Ebro,4,7,-3
2007,Zaragoza,50279,Velilla de Jiloca,0,1,-1
2007,Zaragoza,50280,Vera de Moncayo,0,8,-8
2007,Zaragoza,50281,Vierlas,1,0,1
2007,Zaragoza,50284,Villafeliche,0,5,-5
2007,Zaragoza,50285,Villafranca de Ebro,10,16,-6
2007,Zaragoza,50286,Villalba de Perejil,0,2,-2
2007,Zaragoza,50287,Villalengua,2,7,-5
2007,Zaragoza,50903,Villamayor de Gállego,15,19,-4
2007,Zaragoza,50288,Villanueva de Gállego,54,40,14
2007,Zaragoza,50290,Villanueva de Huerva,4,8,-4
2007,Zaragoza,50289,Villanueva de Jiloca,0,1,-1
2007,Zaragoza,50291,Villar de los Navarros,0,4,-4
2007,Zaragoza,50292,Villarreal de Huerva,2,2,0
2007,Zaragoza,50293,Villarroya de la Sierra,5,15,-10
2007,Zaragoza,50294,Villarroya del Campo,0,1,-1
2007,Zaragoza,50296,Zaida (La),3,4,-1
2007,Zaragoza,50297,Zaragoza,6958,6032,926
2007,Zaragoza,50298,Zuera,67,63,4
2007,Zaragoza,50099,Épila,54,51,3
2006,Zaragoza,50001,Abanto,0,1,-1
2006,Zaragoza,50002,Acered,1,2,-1
2006,Zaragoza,50004,Aguarón,1,22,-21
2006,Zaragoza,50005,Aguilón,0,7,-7
2006,Zaragoza,50003,Agón,1,0,1
2006,Zaragoza,50006,Ainzón,8,19,-11
2006,Zaragoza,50007,Aladrén,1,0,1
2006,Zaragoza,50008,Alagón,73,74,-1
2006,Zaragoza,50009,Alarba,0,0,0
2006,Zaragoza,50011,Albeta,0,2,-2
2006,Zaragoza,50012,Alborge,0,2,-2
2006,Zaragoza,50013,Alcalá de Ebro,3,5,-2
2006,Zaragoza,50014,Alcalá de Moncayo,1,3,-2
2006,Zaragoza,50015,Alconchel de Ariza,0,0,0
2006,Zaragoza,50017,Alfajarín,17,19,-2
2006,Zaragoza,50018,Alfamén,9,18,-9
2006,Zaragoza,50020,Alhama de Aragón,19,13,6
2006,Zaragoza,50021,Almochuel,0,2,-2
2006,Zaragoza,50022,Almolda (La),5,8,-3
2006,Zaragoza,50023,Almonacid de la Cuba,0,4,-4
2006,Zaragoza,50024,Almonacid de la Sierra,2,17,-15
2006,Zaragoza,50025,Almunia de Doña Godina (La),99,79,20
2006,Zaragoza,50026,Alpartir,1,5,-4
2006,Zaragoza,50027,Ambel,2,5,-3
2006,Zaragoza,50029,Aniñón,1,14,-13
2006,Zaragoza,50031,Aranda de Moncayo,0,4,-4
2006,Zaragoza,50033,Ardisa,0,1,-1
2006,Zaragoza,50034,Ariza,12,21,-9
2006,Zaragoza,50035,Artieda,0,2,-2
2006,Zaragoza,50032,Arándiga,1,11,-10
2006,Zaragoza,50036,Asín,0,2,-2
2006,Zaragoza,50037,Atea,0,3,-3
2006,Zaragoza,50038,Ateca,16,26,-10
2006,Zaragoza,50039,Azuara,3,5,-2
2006,Zaragoza,50030,Añón de Moncayo,0,8,-8
2006,Zaragoza,50042,Balconchán,0,1,-1
2006,Zaragoza,50044,Bardallur,2,7,-5
2006,Zaragoza,50045,Belchite,14,23,-9
2006,Zaragoza,50046,Belmonte de Gracián,0,3,-3
2006,Zaragoza,50047,Berdejo,1,0,1
2006,Zaragoza,50901,Biel,2,3,-1
2006,Zaragoza,50050,Bijuesca,0,1,-1
2006,Zaragoza,50051,Biota,12,11,1
2006,Zaragoza,50052,Bisimbre,0,1,-1
2006,Zaragoza,50053,Boquiñeni,7,11,-4
2006,Zaragoza,50054,Bordalba,0,1,-1
2006,Zaragoza,50055,Borja,56,65,-9
2006,Zaragoza,50056,Botorrita,0,5,-5
2006,Zaragoza,50057,Brea de Aragón,24,21,3
2006,Zaragoza,50058,Bubierca,0,1,-1
2006,Zaragoza,50059,Bujaraloz,11,7,4
2006,Zaragoza,50060,Bulbuente,3,4,-1
2006,Zaragoza,50061,Bureta,2,5,-3
2006,Zaragoza,50062,Burgo de Ebro (El),22,9,13
2006,Zaragoza,50063,Buste (El),0,1,-1
2006,Zaragoza,50043,Bárboles,3,1,2
2006,Zaragoza,50064,Cabañas de Ebro,4,11,-7
2006,Zaragoza,50066,Cadrete,28,18,10
2006,Zaragoza,50067,Calatayud,182,233,-51
2006,Zaragoza,50068,Calatorao,26,35,-9
2006,Zaragoza,50070,Calmarza,0,0,0
2006,Zaragoza,50071,Campillo de Aragón,0,5,-5
2006,Zaragoza,50072,Carenas,1,5,-4
2006,Zaragoza,50073,Cariñena,19,40,-21
2006,Zaragoza,50074,Caspe,83,125,-42
2006,Zaragoza,50075,Castejón de Alarba,0,2,-2
2006,Zaragoza,50076,Castejón de las Armas,0,5,-5
2006,Zaragoza,50077,Castejón de Valdejasa,0,4,-4
2006,Zaragoza,50078,Castiliscar,2,1,1
2006,Zaragoza,50079,Cervera de la Cañada,0,6,-6
2006,Zaragoza,50080,Cerveruela,1,1,0
2006,Zaragoza,50081,Cetina,3,16,-13
2006,Zaragoza,50092,Chiprana,6,8,-2
2006,Zaragoza,50093,Chodes,0,2,-2
2006,Zaragoza,50082,Cimballa,0,1,-1
2006,Zaragoza,50083,Cinco Olivas,0,2,-2
2006,Zaragoza,50084,Clarés de Ribota,0,1,-1
2006,Zaragoza,50085,Codo,0,2,-2
2006,Zaragoza,50086,Codos,0,6,-6
2006,Zaragoza,50088,Cosuenda,5,3,2
2006,Zaragoza,50089,Cuarte de Huerva,75,28,47
2006,Zaragoza,50090,Cubel,1,6,-5
2006,Zaragoza,50091,Cuerlas (Las),0,3,-3
2006,Zaragoza,50094,Daroca,11,41,-30
2006,Zaragoza,50095,Ejea de los Caballeros,150,175,-25
2006,Zaragoza,50096,Embid de Ariza,0,1,-1
2006,Zaragoza,50098,Encinacorba,1,5,-4
2006,Zaragoza,50100,Erla,0,7,-7
2006,Zaragoza,50101,Escatrón,6,19,-13
2006,Zaragoza,50102,Fabara,6,9,-3
2006,Zaragoza,50104,Farlete,3,3,0
2006,Zaragoza,50106,Fayos (Los),0,5,-5
2006,Zaragoza,50105,Fayón,0,11,-11
2006,Zaragoza,50107,Figueruelas,13,16,-3
2006,Zaragoza,50109,Frago (El),0,1,-1
2006,Zaragoza,50110,Frasno (El),3,5,-2
2006,Zaragoza,50111,Fréscano,0,2,-2
2006,Zaragoza,50113,Fuendejalón,7,2,5
2006,Zaragoza,50114,Fuendetodos,1,2,-1
2006,Zaragoza,50115,Fuentes de Ebro,38,34,4
2006,Zaragoza,50116,Fuentes de Jiloca,1,10,-9
2006,Zaragoza,50117,Gallocanta,0,3,-3
2006,Zaragoza,50118,Gallur,17,21,-4
2006,Zaragoza,50119,Gelsa,5,13,-8
2006,Zaragoza,50120,Godojos,0,0,0
2006,Zaragoza,50121,Gotor,1,2,-1
2006,Zaragoza,50123,Grisén,3,9,-6
2006,Zaragoza,50124,Herrera de los Navarros,4,4,0
2006,Zaragoza,50125,Ibdes,6,7,-1
2006,Zaragoza,50126,Illueca,27,28,-1
2006,Zaragoza,50128,Isuerre,0,2,-2
2006,Zaragoza,50129,Jaraba,4,3,1
2006,Zaragoza,50130,Jarque de Moncayo,2,4,-2
2006,Zaragoza,50131,Jaulín,1,3,-2
2006,Zaragoza,50132,Joyosa (La),16,10,6
2006,Zaragoza,50133,Lagata,0,3,-3
2006,Zaragoza,50134,Langa del Castillo,0,7,-7
2006,Zaragoza,50137,Leciñena,8,17,-9
2006,Zaragoza,50139,Letux,1,12,-11
2006,Zaragoza,50140,Litago,0,2,-2
2006,Zaragoza,50141,Lituénigo,0,2,-2
2006,Zaragoza,50142,Lobera de Onsella,0,1,-1
2006,Zaragoza,50143,Longares,9,15,-6
2006,Zaragoza,50146,Lucena de Jalón,1,3,-2
2006,Zaragoza,50147,Luceni,7,12,-5
2006,Zaragoza,50148,Luesia,1,9,-8
2006,Zaragoza,50150,Lumpiaque,4,12,-8
2006,Zaragoza,50151,Luna,3,12,-9
2006,Zaragoza,50136,Lécera,4,12,-8
2006,Zaragoza,50152,Maella,0,15,-15
2006,Zaragoza,50153,Magallón,9,19,-10
2006,Zaragoza,50154,Mainar,2,3,-1
2006,Zaragoza,50156,Maleján,2,2,0
2006,Zaragoza,50160,Mallén,30,36,-6
2006,Zaragoza,50159,Maluenda,12,17,-5
2006,Zaragoza,50157,Malón,2,9,-7
2006,Zaragoza,50162,Mara,1,1,0
2006,Zaragoza,50902,Marracos,1,0,1
2006,Zaragoza,50163,María de Huerva,75,9,66
2006,Zaragoza,50164,Mediana de Aragón,4,12,-8
2006,Zaragoza,50165,Mequinenza,14,31,-17
2006,Zaragoza,50166,Mesones de Isuela,2,3,-1
2006,Zaragoza,50167,Mezalocha,0,4,-4
2006,Zaragoza,50168,Mianos,1,1,0
2006,Zaragoza,50169,Miedes de Aragón,1,7,-6
2006,Zaragoza,50170,Monegrillo,0,7,-7
2006,Zaragoza,50171,Moneva,0,1,-1
2006,Zaragoza,50172,Monreal de Ariza,0,2,-2
2006,Zaragoza,50173,Monterde,1,4,-3
2006,Zaragoza,50174,Montón,0,2,-2
2006,Zaragoza,50175,Morata de Jalón,11,13,-2
2006,Zaragoza,50176,Morata de Jiloca,1,2,-1
2006,Zaragoza,50178,Moros,1,4,-3
2006,Zaragoza,50177,Morés,2,5,-3
2006,Zaragoza,50179,Moyuela,3,2,1
2006,Zaragoza,50180,Mozota,0,1,-1
2006,Zaragoza,50181,Muel,9,17,-8
2006,Zaragoza,50182,Muela (La),38,18,20
2006,Zaragoza,50183,Munébrega,1,6,-5
2006,Zaragoza,50185,Murillo de Gállego,5,1,4
2006,Zaragoza,50186,Navardún,0,2,-2
2006,Zaragoza,50187,Nigüella,1,1,0
2006,Zaragoza,50188,Nombrevilla,0,1,-1
2006,Zaragoza,50189,Nonaspe,5,16,-11
2006,Zaragoza,50190,Novallas,6,11,-5
2006,Zaragoza,50191,Novillas,4,9,-5
2006,Zaragoza,50193,Nuez de Ebro,8,4,4
2006,Zaragoza,50192,Nuévalos,3,2,1
2006,Zaragoza,50195,Orcajo,0,1,-1
2006,Zaragoza,50196,Orera,0,6,-6
2006,Zaragoza,50197,Orés,1,4,-3
2006,Zaragoza,50199,Osera de Ebro,2,19,-17
2006,Zaragoza,50200,Paniza,3,10,-7
2006,Zaragoza,50201,Paracuellos de Jiloca,3,9,-6
2006,Zaragoza,50202,Paracuellos de la Ribera,1,5,-4
2006,Zaragoza,50203,Pastriz,15,7,8
2006,Zaragoza,50204,Pedrola,40,36,4
2006,Zaragoza,50205,Pedrosas (Las),0,2,-2
2006,Zaragoza,50206,Perdiguera,7,7,0
2006,Zaragoza,50207,Piedratajada,0,1,-1
2006,Zaragoza,50208,Pina de Ebro,21,32,-11
2006,Zaragoza,50209,Pinseque,38,44,-6
2006,Zaragoza,50210,Pintanos (Los),0,1,-1
2006,Zaragoza,50211,Plasencia de Jalón,3,8,-5
2006,Zaragoza,50212,Pleitas,0,1,-1
2006,Zaragoza,50213,Plenas,2,3,-1
2006,Zaragoza,50214,Pomer,0,2,-2
2006,Zaragoza,50216,Pozuelo de Aragón,2,2,0
2006,Zaragoza,50217,Pradilla de Ebro,2,5,-3
2006,Zaragoza,50218,Puebla de Albortón,1,2,-1
2006,Zaragoza,50219,Puebla de Alfindén (La),104,35,69
2006,Zaragoza,50222,Quinto,19,17,2
2006,Zaragoza,50223,Remolinos,12,20,-8
2006,Zaragoza,50224,Retascón,0,2,-2
2006,Zaragoza,50225,Ricla,34,36,-2
2006,Zaragoza,50227,Romanos,0,5,-5
2006,Zaragoza,50228,Rueda de Jalón,0,4,-4
2006,Zaragoza,50229,Ruesca,0,4,-4
2006,Zaragoza,50231,Salillas de Jalón,0,4,-4
2006,Zaragoza,50232,Salvatierra de Esca,1,3,-2
2006,Zaragoza,50234,San Martín de la Virgen de Moncayo,2,8,-6
2006,Zaragoza,50235,San Mateo de Gállego,23,25,-2
2006,Zaragoza,50236,Santa Cruz de Grío,0,4,-4
2006,Zaragoza,50238,Santa Eulalia de Gállego,0,2,-2
2006,Zaragoza,50239,Santed,1,2,-1
2006,Zaragoza,50241,Saviñán,8,13,-5
2006,Zaragoza,50242,Sediles,2,2,0
2006,Zaragoza,50243,Sestrica,1,5,-4
2006,Zaragoza,50244,Sierra de Luna,3,2,1
2006,Zaragoza,50245,Sigüés,1,3,-2
2006,Zaragoza,50246,Sisamón,0,1,-1
2006,Zaragoza,50247,Sobradiel,9,8,1
2006,Zaragoza,50248,Sos del Rey Católico,3,6,-3
2006,Zaragoza,50230,Sádaba,10,28,-18
2006,Zaragoza,50240,Sástago,2,6,-4
2006,Zaragoza,50249,Tabuenca,1,8,-7
2006,Zaragoza,50250,Talamantes,0,1,-1
2006,Zaragoza,50251,Tarazona,97,114,-17
2006,Zaragoza,50252,Tauste,74,79,-5
2006,Zaragoza,50253,Terrer,0,11,-11
2006,Zaragoza,50254,Tierga,1,3,-2
2006,Zaragoza,50255,Tobed,1,5,-4
2006,Zaragoza,50256,Torralba de los Frailes,0,1,-1
2006,Zaragoza,50257,Torralba de Ribota,1,0,1
2006,Zaragoza,50260,Torrelapaja,0,1,-1
2006,Zaragoza,50261,Torrellas,0,4,-4
2006,Zaragoza,50262,Torres de Berrellén,15,12,3
2006,Zaragoza,50263,Torrijo de la Cañada,1,8,-7
2006,Zaragoza,50264,Tosos,1,3,-2
2006,Zaragoza,50265,Trasmoz,0,3,-3
2006,Zaragoza,50266,Trasobares,0,4,-4
2006,Zaragoza,50267,Uncastillo,3,15,-12
2006,Zaragoza,50268,Undués de Lerda,0,0,0
2006,Zaragoza,50269,Urrea de Jalón,3,7,-4
2006,Zaragoza,50271,Used,1,2,-1
2006,Zaragoza,50272,Utebo,266,57,209
2006,Zaragoza,50274,Val de San Martín,1,0,1
2006,Zaragoza,50275,Valmadrid,0,1,-1
2006,Zaragoza,50276,Valpalmas,0,3,-3
2006,Zaragoza,50277,Valtorres,0,1,-1
2006,Zaragoza,50278,Velilla de Ebro,0,7,-7
2006,Zaragoza,50279,Velilla de Jiloca,0,3,-3
2006,Zaragoza,50280,Vera de Moncayo,1,3,-2
2006,Zaragoza,50281,Vierlas,0,1,-1
2006,Zaragoza,50283,Villadoz,0,1,-1
2006,Zaragoza,50284,Villafeliche,0,5,-5
2006,Zaragoza,50285,Villafranca de Ebro,6,13,-7
2006,Zaragoza,50286,Villalba de Perejil,0,2,-2
2006,Zaragoza,50287,Villalengua,3,7,-4
2006,Zaragoza,50903,Villamayor de Gállego,0,11,-11
2006,Zaragoza,50288,Villanueva de Gállego,62,39,23
2006,Zaragoza,50290,Villanueva de Huerva,2,6,-4
2006,Zaragoza,50289,Villanueva de Jiloca,0,2,-2
2006,Zaragoza,50292,Villarreal de Huerva,0,2,-2
2006,Zaragoza,50293,Villarroya de la Sierra,2,15,-13
2006,Zaragoza,50282,Vilueña (La),0,1,-1
2006,Zaragoza,50296,Zaida (La),1,6,-5
2006,Zaragoza,50297,Zaragoza,6708,5817,891
2006,Zaragoza,50298,Zuera,64,58,6
2006,Zaragoza,50099,Épila,54,59,-5
2005,Zaragoza,50001,Abanto,0,4,-4
2005,Zaragoza,50002,Acered,0,2,-2
2005,Zaragoza,50004,Aguarón,6,23,-17
2005,Zaragoza,50005,Aguilón,1,1,0
2005,Zaragoza,50003,Agón,0,4,-4
2005,Zaragoza,50006,Ainzón,6,18,-12
2005,Zaragoza,50008,Alagón,47,88,-41
2005,Zaragoza,50009,Alarba,1,3,-2
2005,Zaragoza,50010,Alberite de San Juan,1,1,0
2005,Zaragoza,50011,Albeta,1,3,-2
2005,Zaragoza,50013,Alcalá de Ebro,4,9,-5
2005,Zaragoza,50014,Alcalá de Moncayo,0,3,-3
2005,Zaragoza,50015,Alconchel de Ariza,0,1,-1
2005,Zaragoza,50016,Aldehuela de Liestos,0,1,-1
2005,Zaragoza,50017,Alfajarín,16,25,-9
2005,Zaragoza,50018,Alfamén,7,14,-7
2005,Zaragoza,50019,Alforque,0,1,-1
2005,Zaragoza,50020,Alhama de Aragón,6,17,-11
2005,Zaragoza,50021,Almochuel,0,2,-2
2005,Zaragoza,50022,Almolda (La),1,11,-10
2005,Zaragoza,50023,Almonacid de la Cuba,2,6,-4
2005,Zaragoza,50024,Almonacid de la Sierra,1,22,-21
2005,Zaragoza,50025,Almunia de Doña Godina (La),76,74,2
2005,Zaragoza,50026,Alpartir,4,10,-6
2005,Zaragoza,50027,Ambel,0,4,-4
2005,Zaragoza,50028,Anento,1,0,1
2005,Zaragoza,50029,Aniñón,4,10,-6
2005,Zaragoza,50031,Aranda de Moncayo,0,2,-2
2005,Zaragoza,50033,Ardisa,0,4,-4
2005,Zaragoza,50034,Ariza,12,25,-13
2005,Zaragoza,50035,Artieda,0,1,-1
2005,Zaragoza,50032,Arándiga,1,7,-6
2005,Zaragoza,50036,Asín,0,3,-3
2005,Zaragoza,50037,Atea,0,2,-2
2005,Zaragoza,50038,Ateca,15,25,-10
2005,Zaragoza,50039,Azuara,1,11,-10
2005,Zaragoza,50030,Añón de Moncayo,1,6,-5
2005,Zaragoza,50040,Badules,0,1,-1
2005,Zaragoza,50044,Bardallur,0,4,-4
2005,Zaragoza,50045,Belchite,6,28,-22
2005,Zaragoza,50046,Belmonte de Gracián,0,4,-4
2005,Zaragoza,50047,Berdejo,0,0,0
2005,Zaragoza,50901,Biel,0,5,-5
2005,Zaragoza,50050,Bijuesca,0,1,-1
2005,Zaragoza,50051,Biota,5,18,-13
2005,Zaragoza,50052,Bisimbre,0,3,-3
2005,Zaragoza,50053,Boquiñeni,2,11,-9
2005,Zaragoza,50054,Bordalba,0,1,-1
2005,Zaragoza,50055,Borja,44,68,-24
2005,Zaragoza,50056,Botorrita,5,3,2
2005,Zaragoza,50057,Brea de Aragón,14,15,-1
2005,Zaragoza,50058,Bubierca,0,1,-1
2005,Zaragoza,50059,Bujaraloz,10,11,-1
2005,Zaragoza,50060,Bulbuente,2,3,-1
2005,Zaragoza,50061,Bureta,0,8,-8
2005,Zaragoza,50062,Burgo de Ebro (El),25,12,13
2005,Zaragoza,50063,Buste (El),0,1,-1
2005,Zaragoza,50043,Bárboles,2,5,-3
2005,Zaragoza,50064,Cabañas de Ebro,3,3,0
2005,Zaragoza,50066,Cadrete,37,17,20
2005,Zaragoza,50067,Calatayud,173,228,-55
2005,Zaragoza,50068,Calatorao,39,40,-1
2005,Zaragoza,50069,Calcena,0,1,-1
2005,Zaragoza,50070,Calmarza,0,2,-2
2005,Zaragoza,50071,Campillo de Aragón,1,3,-2
2005,Zaragoza,50072,Carenas,0,3,-3
2005,Zaragoza,50073,Cariñena,30,39,-9
2005,Zaragoza,50074,Caspe,77,113,-36
2005,Zaragoza,50075,Castejón de Alarba,0,1,-1
2005,Zaragoza,50076,Castejón de las Armas,0,1,-1
2005,Zaragoza,50078,Castiliscar,0,4,-4
2005,Zaragoza,50079,Cervera de la Cañada,1,3,-2
2005,Zaragoza,50081,Cetina,6,9,-3
2005,Zaragoza,50092,Chiprana,1,7,-6
2005,Zaragoza,50093,Chodes,1,2,-1
2005,Zaragoza,50082,Cimballa,0,2,-2
2005,Zaragoza,50083,Cinco Olivas,0,0,0
2005,Zaragoza,50084,Clarés de Ribota,0,2,-2
2005,Zaragoza,50085,Codo,1,8,-7
2005,Zaragoza,50086,Codos,0,7,-7
2005,Zaragoza,50087,Contamina,0,2,-2
2005,Zaragoza,50088,Cosuenda,3,9,-6
2005,Zaragoza,50089,Cuarte de Huerva,63,24,39
2005,Zaragoza,50090,Cubel,0,0,0
2005,Zaragoza,50091,Cuerlas (Las),0,4,-4
2005,Zaragoza,50094,Daroca,15,31,-16
2005,Zaragoza,50095,Ejea de los Caballeros,153,183,-30
2005,Zaragoza,50096,Embid de Ariza,0,1,-1
2005,Zaragoza,50098,Encinacorba,2,2,0
2005,Zaragoza,50100,Erla,4,6,-2
2005,Zaragoza,50101,Escatrón,7,16,-9
2005,Zaragoza,50102,Fabara,6,18,-12
2005,Zaragoza,50104,Farlete,5,4,1
2005,Zaragoza,50106,Fayos (Los),1,3,-2
2005,Zaragoza,50105,Fayón,2,4,-2
2005,Zaragoza,50107,Figueruelas,14,15,-1
2005,Zaragoza,50110,Frasno (El),1,10,-9
2005,Zaragoza,50111,Fréscano,0,3,-3
2005,Zaragoza,50113,Fuendejalón,7,7,0
2005,Zaragoza,50114,Fuendetodos,0,2,-2
2005,Zaragoza,50115,Fuentes de Ebro,34,37,-3
2005,Zaragoza,50116,Fuentes de Jiloca,0,6,-6
2005,Zaragoza,50117,Gallocanta,0,3,-3
2005,Zaragoza,50118,Gallur,18,23,-5
2005,Zaragoza,50119,Gelsa,6,22,-16
2005,Zaragoza,50120,Godojos,0,2,-2
2005,Zaragoza,50121,Gotor,4,2,2
2005,Zaragoza,50123,Grisén,6,10,-4
2005,Zaragoza,50124,Herrera de los Navarros,3,10,-7
2005,Zaragoza,50125,Ibdes,4,12,-8
2005,Zaragoza,50126,Illueca,22,20,2
2005,Zaragoza,50128,Isuerre,0,1,-1
2005,Zaragoza,50129,Jaraba,3,1,2
2005,Zaragoza,50130,Jarque de Moncayo,0,2,-2
2005,Zaragoza,50131,Jaulín,0,3,-3
2005,Zaragoza,50132,Joyosa (La),16,7,9
2005,Zaragoza,50134,Langa del Castillo,0,2,-2
2005,Zaragoza,50135,Layana,0,0,0
2005,Zaragoza,50138,Lechón,0,1,-1
2005,Zaragoza,50137,Leciñena,9,12,-3
2005,Zaragoza,50139,Letux,2,10,-8
2005,Zaragoza,50140,Litago,1,5,-4
2005,Zaragoza,50141,Lituénigo,0,2,-2
2005,Zaragoza,50142,Lobera de Onsella,0,2,-2
2005,Zaragoza,50143,Longares,1,12,-11
2005,Zaragoza,50146,Lucena de Jalón,0,8,-8
2005,Zaragoza,50147,Luceni,9,12,-3
2005,Zaragoza,50148,Luesia,1,11,-10
2005,Zaragoza,50150,Lumpiaque,7,17,-10
2005,Zaragoza,50151,Luna,5,18,-13
2005,Zaragoza,50136,Lécera,3,16,-13
2005,Zaragoza,50152,Maella,5,17,-12
2005,Zaragoza,50153,Magallón,6,13,-7
2005,Zaragoza,50154,Mainar,0,3,-3
2005,Zaragoza,50155,Malanquilla,0,0,0
2005,Zaragoza,50156,Maleján,2,6,-4
2005,Zaragoza,50160,Mallén,16,36,-20
2005,Zaragoza,50159,Maluenda,6,16,-10
2005,Zaragoza,50157,Malón,2,6,-4
2005,Zaragoza,50161,Manchones,0,1,-1
2005,Zaragoza,50162,Mara,0,2,-2
2005,Zaragoza,50902,Marracos,0,1,-1
2005,Zaragoza,50163,María de Huerva,64,20,44
2005,Zaragoza,50164,Mediana de Aragón,3,10,-7
2005,Zaragoza,50165,Mequinenza,16,29,-13
2005,Zaragoza,50166,Mesones de Isuela,0,6,-6
2005,Zaragoza,50167,Mezalocha,0,3,-3
2005,Zaragoza,50169,Miedes de Aragón,3,8,-5
2005,Zaragoza,50170,Monegrillo,1,5,-4
2005,Zaragoza,50171,Moneva,0,1,-1
2005,Zaragoza,50172,Monreal de Ariza,0,2,-2
2005,Zaragoza,50173,Monterde,0,3,-3
2005,Zaragoza,50174,Montón,0,3,-3
2005,Zaragoza,50175,Morata de Jalón,6,32,-26
2005,Zaragoza,50176,Morata de Jiloca,0,6,-6
2005,Zaragoza,50178,Moros,0,8,-8
2005,Zaragoza,50177,Morés,6,7,-1
2005,Zaragoza,50179,Moyuela,1,6,-5
2005,Zaragoza,50180,Mozota,0,0,0
2005,Zaragoza,50181,Muel,7,20,-13
2005,Zaragoza,50182,Muela (La),33,18,15
2005,Zaragoza,50183,Munébrega,3,6,-3
2005,Zaragoza,50184,Murero,0,1,-1
2005,Zaragoza,50185,Murillo de Gállego,2,5,-3
2005,Zaragoza,50186,Navardún,0,1,-1
2005,Zaragoza,50187,Nigüella,0,1,-1
2005,Zaragoza,50189,Nonaspe,11,10,1
2005,Zaragoza,50190,Novallas,5,17,-12
2005,Zaragoza,50191,Novillas,3,9,-6
2005,Zaragoza,50193,Nuez de Ebro,7,8,-1
2005,Zaragoza,50192,Nuévalos,2,0,2
2005,Zaragoza,50194,Olvés,0,2,-2
2005,Zaragoza,50196,Orera,1,2,-1
2005,Zaragoza,50197,Orés,0,4,-4
2005,Zaragoza,50198,Oseja,1,0,1
2005,Zaragoza,50199,Osera de Ebro,3,19,-16
2005,Zaragoza,50200,Paniza,2,7,-5
2005,Zaragoza,50201,Paracuellos de Jiloca,6,8,-2
2005,Zaragoza,50202,Paracuellos de la Ribera,0,8,-8
2005,Zaragoza,50203,Pastriz,10,11,-1
2005,Zaragoza,50204,Pedrola,40,40,0
2005,Zaragoza,50205,Pedrosas (Las),0,1,-1
2005,Zaragoza,50206,Perdiguera,6,8,-2
2005,Zaragoza,50207,Piedratajada,1,1,0
2005,Zaragoza,50208,Pina de Ebro,27,19,8
2005,Zaragoza,50209,Pinseque,33,63,-30
2005,Zaragoza,50211,Plasencia de Jalón,2,4,-2
2005,Zaragoza,50213,Plenas,1,1,0
2005,Zaragoza,50214,Pomer,0,1,-1
2005,Zaragoza,50216,Pozuelo de Aragón,1,4,-3
2005,Zaragoza,50217,Pradilla de Ebro,2,8,-6
2005,Zaragoza,50218,Puebla de Albortón,1,1,0
2005,Zaragoza,50219,Puebla de Alfindén (La),104,29,75
2005,Zaragoza,50220,Puendeluna,0,1,-1
2005,Zaragoza,50222,Quinto,24,20,4
2005,Zaragoza,50223,Remolinos,7,15,-8
2005,Zaragoza,50225,Ricla,20,17,3
2005,Zaragoza,50227,Romanos,0,1,-1
2005,Zaragoza,50228,Rueda de Jalón,2,1,1
2005,Zaragoza,50231,Salillas de Jalón,2,8,-6
2005,Zaragoza,50232,Salvatierra de Esca,0,3,-3
2005,Zaragoza,50234,San Martín de la Virgen de Moncayo,1,3,-2
2005,Zaragoza,50235,San Mateo de Gállego,20,21,-1
2005,Zaragoza,50236,Santa Cruz de Grío,0,2,-2
2005,Zaragoza,50237,Santa Cruz de Moncayo,1,4,-3
2005,Zaragoza,50238,Santa Eulalia de Gállego,0,3,-3
2005,Zaragoza,50239,Santed,0,2,-2
2005,Zaragoza,50241,Saviñán,2,15,-13
2005,Zaragoza,50242,Sediles,1,3,-2
2005,Zaragoza,50243,Sestrica,5,6,-1
2005,Zaragoza,50244,Sierra de Luna,1,2,-1
2005,Zaragoza,50245,Sigüés,0,4,-4
2005,Zaragoza,50246,Sisamón,0,1,-1
2005,Zaragoza,50247,Sobradiel,12,14,-2
2005,Zaragoza,50248,Sos del Rey Católico,3,6,-3
2005,Zaragoza,50230,Sádaba,10,31,-21
2005,Zaragoza,50240,Sástago,1,9,-8
2005,Zaragoza,50249,Tabuenca,1,7,-6
2005,Zaragoza,50250,Talamantes,0,1,-1
2005,Zaragoza,50251,Tarazona,101,127,-26
2005,Zaragoza,50252,Tauste,70,90,-20
2005,Zaragoza,50253,Terrer,0,6,-6
2005,Zaragoza,50254,Tierga,0,6,-6
2005,Zaragoza,50255,Tobed,1,5,-4
2005,Zaragoza,50256,Torralba de los Frailes,0,2,-2
2005,Zaragoza,50257,Torralba de Ribota,0,3,-3
2005,Zaragoza,50258,Torralbilla,0,1,-1
2005,Zaragoza,50259,Torrehermosa,0,3,-3
2005,Zaragoza,50260,Torrelapaja,0,1,-1
2005,Zaragoza,50261,Torrellas,1,9,-8
2005,Zaragoza,50262,Torres de Berrellén,8,18,-10
2005,Zaragoza,50263,Torrijo de la Cañada,0,9,-9
2005,Zaragoza,50264,Tosos,0,2,-2
2005,Zaragoza,50265,Trasmoz,0,1,-1
2005,Zaragoza,50266,Trasobares,0,5,-5
2005,Zaragoza,50267,Uncastillo,6,14,-8
2005,Zaragoza,50268,Undués de Lerda,0,2,-2
2005,Zaragoza,50269,Urrea de Jalón,1,3,-2
2005,Zaragoza,50270,Urriés,0,1,-1
2005,Zaragoza,50271,Used,2,4,-2
2005,Zaragoza,50272,Utebo,197,75,122
2005,Zaragoza,50273,Valdehorna,0,1,-1
2005,Zaragoza,50276,Valpalmas,0,1,-1
2005,Zaragoza,50277,Valtorres,1,2,-1
2005,Zaragoza,50278,Velilla de Ebro,1,3,-2
2005,Zaragoza,50279,Velilla de Jiloca,0,1,-1
2005,Zaragoza,50280,Vera de Moncayo,2,11,-9
2005,Zaragoza,50281,Vierlas,0,2,-2
2005,Zaragoza,50283,Villadoz,1,0,1
2005,Zaragoza,50284,Villafeliche,0,3,-3
2005,Zaragoza,50285,Villafranca de Ebro,6,18,-12
2005,Zaragoza,50286,Villalba de Perejil,0,2,-2
2005,Zaragoza,50287,Villalengua,0,9,-9
2005,Zaragoza,50288,Villanueva de Gállego,48,31,17
2005,Zaragoza,50290,Villanueva de Huerva,1,5,-4
2005,Zaragoza,50289,Villanueva de Jiloca,0,0,0
2005,Zaragoza,50291,Villar de los Navarros,0,1,-1
2005,Zaragoza,50292,Villarreal de Huerva,1,4,-3
2005,Zaragoza,50293,Villarroya de la Sierra,2,17,-15
2005,Zaragoza,50282,Vilueña (La),0,4,-4
2005,Zaragoza,50295,Vistabella,0,1,-1
2005,Zaragoza,50296,Zaida (La),4,8,-4
2005,Zaragoza,50297,Zaragoza,6454,6173,281
2005,Zaragoza,50298,Zuera,51,68,-17
2005,Zaragoza,50099,Épila,52,48,4
2004,Zaragoza,50001,Abanto,0,5,-5
2004,Zaragoza,50002,Acered,0,4,-4
2004,Zaragoza,50004,Aguarón,0,18,-18
2004,Zaragoza,50005,Aguilón,2,1,1
2004,Zaragoza,50003,Agón,1,4,-3
2004,Zaragoza,50006,Ainzón,8,19,-11
2004,Zaragoza,50007,Aladrén,1,0,1
2004,Zaragoza,50008,Alagón,61,68,-7
2004,Zaragoza,50009,Alarba,4,3,1
2004,Zaragoza,50010,Alberite de San Juan,0,2,-2
2004,Zaragoza,50011,Albeta,0,3,-3
2004,Zaragoza,50013,Alcalá de Ebro,1,5,-4
2004,Zaragoza,50015,Alconchel de Ariza,1,4,-3
2004,Zaragoza,50016,Aldehuela de Liestos,0,1,-1
2004,Zaragoza,50017,Alfajarín,15,13,2
2004,Zaragoza,50018,Alfamén,12,19,-7
2004,Zaragoza,50019,Alforque,1,1,0
2004,Zaragoza,50020,Alhama de Aragón,7,15,-8
2004,Zaragoza,50021,Almochuel,0,1,-1
2004,Zaragoza,50022,Almolda (La),0,7,-7
2004,Zaragoza,50023,Almonacid de la Cuba,2,5,-3
2004,Zaragoza,50024,Almonacid de la Sierra,4,19,-15
2004,Zaragoza,50025,Almunia de Doña Godina (La),83,74,9
2004,Zaragoza,50026,Alpartir,2,11,-9
2004,Zaragoza,50027,Ambel,4,7,-3
2004,Zaragoza,50028,Anento,1,0,1
2004,Zaragoza,50029,Aniñón,3,9,-6
2004,Zaragoza,50031,Aranda de Moncayo,0,7,-7
2004,Zaragoza,50033,Ardisa,0,1,-1
2004,Zaragoza,50034,Ariza,10,18,-8
2004,Zaragoza,50035,Artieda,1,0,1
2004,Zaragoza,50032,Arándiga,2,7,-5
2004,Zaragoza,50037,Atea,0,3,-3
2004,Zaragoza,50038,Ateca,12,28,-16
2004,Zaragoza,50039,Azuara,1,8,-7
2004,Zaragoza,50030,Añón de Moncayo,0,7,-7
2004,Zaragoza,50040,Badules,0,2,-2
2004,Zaragoza,50042,Balconchán,0,2,-2
2004,Zaragoza,50044,Bardallur,1,3,-2
2004,Zaragoza,50045,Belchite,13,19,-6
2004,Zaragoza,50046,Belmonte de Gracián,1,8,-7
2004,Zaragoza,50047,Berdejo,1,0,1
2004,Zaragoza,50048,Berrueco,0,3,-3
2004,Zaragoza,50901,Biel,0,4,-4
2004,Zaragoza,50051,Biota,8,14,-6
2004,Zaragoza,50052,Bisimbre,0,3,-3
2004,Zaragoza,50053,Boquiñeni,1,7,-6
2004,Zaragoza,50055,Borja,51,64,-13
2004,Zaragoza,50056,Botorrita,0,3,-3
2004,Zaragoza,50057,Brea de Aragón,10,16,-6
2004,Zaragoza,50058,Bubierca,0,2,-2
2004,Zaragoza,50059,Bujaraloz,11,11,0
2004,Zaragoza,50060,Bulbuente,2,4,-2
2004,Zaragoza,50061,Bureta,1,9,-8
2004,Zaragoza,50062,Burgo de Ebro (El),15,17,-2
2004,Zaragoza,50063,Buste (El),1,3,-2
2004,Zaragoza,50043,Bárboles,0,6,-6
2004,Zaragoza,50064,Cabañas de Ebro,4,6,-2
2004,Zaragoza,50065,Cabolafuente,0,1,-1
2004,Zaragoza,50066,Cadrete,36,10,26
2004,Zaragoza,50067,Calatayud,179,214,-35
2004,Zaragoza,50068,Calatorao,20,35,-15
2004,Zaragoza,50069,Calcena,0,1,-1
2004,Zaragoza,50070,Calmarza,1,3,-2
2004,Zaragoza,50071,Campillo de Aragón,2,3,-1
2004,Zaragoza,50072,Carenas,1,4,-3
2004,Zaragoza,50073,Cariñena,28,30,-2
2004,Zaragoza,50074,Caspe,83,101,-18
2004,Zaragoza,50075,Castejón de Alarba,0,3,-3
2004,Zaragoza,50076,Castejón de las Armas,0,1,-1
2004,Zaragoza,50077,Castejón de Valdejasa,0,10,-10
2004,Zaragoza,50078,Castiliscar,0,10,-10
2004,Zaragoza,50079,Cervera de la Cañada,1,2,-1
2004,Zaragoza,50080,Cerveruela,1,0,1
2004,Zaragoza,50081,Cetina,2,9,-7
2004,Zaragoza,50092,Chiprana,4,1,3
2004,Zaragoza,50093,Chodes,0,1,-1
2004,Zaragoza,50083,Cinco Olivas,0,1,-1
2004,Zaragoza,50084,Clarés de Ribota,1,1,0
2004,Zaragoza,50085,Codo,1,5,-4
2004,Zaragoza,50086,Codos,0,5,-5
2004,Zaragoza,50087,Contamina,0,1,-1
2004,Zaragoza,50088,Cosuenda,1,6,-5
2004,Zaragoza,50089,Cuarte de Huerva,49,21,28
2004,Zaragoza,50090,Cubel,2,3,-1
2004,Zaragoza,50091,Cuerlas (Las),0,1,-1
2004,Zaragoza,50094,Daroca,15,36,-21
2004,Zaragoza,50095,Ejea de los Caballeros,137,168,-31
2004,Zaragoza,50098,Encinacorba,0,4,-4
2004,Zaragoza,50100,Erla,0,6,-6
2004,Zaragoza,50101,Escatrón,5,19,-14
2004,Zaragoza,50102,Fabara,5,18,-13
2004,Zaragoza,50104,Farlete,3,3,0
2004,Zaragoza,50106,Fayos (Los),0,2,-2
2004,Zaragoza,50105,Fayón,3,9,-6
2004,Zaragoza,50107,Figueruelas,10,18,-8
2004,Zaragoza,50109,Frago (El),0,3,-3
2004,Zaragoza,50110,Frasno (El),0,10,-10
2004,Zaragoza,50111,Fréscano,1,2,-1
2004,Zaragoza,50113,Fuendejalón,5,17,-12
2004,Zaragoza,50114,Fuendetodos,0,5,-5
2004,Zaragoza,50115,Fuentes de Ebro,39,38,1
2004,Zaragoza,50116,Fuentes de Jiloca,0,4,-4
2004,Zaragoza,50117,Gallocanta,0,2,-2
2004,Zaragoza,50118,Gallur,24,44,-20
2004,Zaragoza,50119,Gelsa,8,17,-9
2004,Zaragoza,50121,Gotor,2,5,-3
2004,Zaragoza,50122,Grisel,0,1,-1
2004,Zaragoza,50123,Grisén,2,6,-4
2004,Zaragoza,50124,Herrera de los Navarros,4,13,-9
2004,Zaragoza,50125,Ibdes,4,10,-6
2004,Zaragoza,50126,Illueca,29,29,0
2004,Zaragoza,50128,Isuerre,1,1,0
2004,Zaragoza,50129,Jaraba,1,4,-3
2004,Zaragoza,50130,Jarque de Moncayo,1,7,-6
2004,Zaragoza,50131,Jaulín,2,4,-2
2004,Zaragoza,50132,Joyosa (La),10,6,4
2004,Zaragoza,50133,Lagata,1,1,0
2004,Zaragoza,50134,Langa del Castillo,0,1,-1
2004,Zaragoza,50135,Layana,1,0,1
2004,Zaragoza,50137,Leciñena,12,10,2
2004,Zaragoza,50139,Letux,3,8,-5
2004,Zaragoza,50140,Litago,0,3,-3
2004,Zaragoza,50141,Lituénigo,1,3,-2
2004,Zaragoza,50142,Lobera de Onsella,1,0,1
2004,Zaragoza,50143,Longares,6,15,-9
2004,Zaragoza,50146,Lucena de Jalón,2,1,1
2004,Zaragoza,50147,Luceni,4,14,-10
2004,Zaragoza,50148,Luesia,3,3,0
2004,Zaragoza,50150,Lumpiaque,8,12,-4
2004,Zaragoza,50151,Luna,3,15,-12
2004,Zaragoza,50136,Lécera,2,11,-9
2004,Zaragoza,50152,Maella,15,32,-17
2004,Zaragoza,50153,Magallón,7,18,-11
2004,Zaragoza,50154,Mainar,2,1,1
2004,Zaragoza,50155,Malanquilla,0,2,-2
2004,Zaragoza,50156,Maleján,1,6,-5
2004,Zaragoza,50160,Mallén,17,37,-20
2004,Zaragoza,50159,Maluenda,7,18,-11
2004,Zaragoza,50157,Malón,4,6,-2
2004,Zaragoza,50161,Manchones,1,4,-3
2004,Zaragoza,50162,Mara,1,3,-2
2004,Zaragoza,50902,Marracos,0,1,-1
2004,Zaragoza,50163,María de Huerva,43,18,25
2004,Zaragoza,50164,Mediana de Aragón,1,10,-9
2004,Zaragoza,50165,Mequinenza,15,41,-26
2004,Zaragoza,50166,Mesones de Isuela,0,5,-5
2004,Zaragoza,50167,Mezalocha,0,6,-6
2004,Zaragoza,50169,Miedes de Aragón,2,11,-9
2004,Zaragoza,50170,Monegrillo,5,3,2
2004,Zaragoza,50171,Moneva,0,2,-2
2004,Zaragoza,50172,Monreal de Ariza,0,7,-7
2004,Zaragoza,50173,Monterde,1,5,-4
2004,Zaragoza,50174,Montón,0,1,-1
2004,Zaragoza,50175,Morata de Jalón,8,18,-10
2004,Zaragoza,50176,Morata de Jiloca,0,3,-3
2004,Zaragoza,50178,Moros,2,7,-5
2004,Zaragoza,50177,Morés,1,4,-3
2004,Zaragoza,50179,Moyuela,1,10,-9
2004,Zaragoza,50180,Mozota,1,1,0
2004,Zaragoza,50181,Muel,10,17,-7
2004,Zaragoza,50182,Muela (La),27,20,7
2004,Zaragoza,50183,Munébrega,3,4,-1
2004,Zaragoza,50184,Murero,0,2,-2
2004,Zaragoza,50185,Murillo de Gállego,0,2,-2
2004,Zaragoza,50186,Navardún,0,2,-2
2004,Zaragoza,50189,Nonaspe,5,18,-13
2004,Zaragoza,50190,Novallas,2,13,-11
2004,Zaragoza,50191,Novillas,4,16,-12
2004,Zaragoza,50193,Nuez de Ebro,5,4,1
2004,Zaragoza,50192,Nuévalos,5,2,3
2004,Zaragoza,50194,Olvés,0,2,-2
2004,Zaragoza,50196,Orera,1,2,-1
2004,Zaragoza,50197,Orés,0,1,-1
2004,Zaragoza,50199,Osera de Ebro,4,21,-17
2004,Zaragoza,50200,Paniza,2,7,-5
2004,Zaragoza,50201,Paracuellos de Jiloca,2,5,-3
2004,Zaragoza,50202,Paracuellos de la Ribera,1,3,-2
2004,Zaragoza,50203,Pastriz,17,17,0
2004,Zaragoza,50204,Pedrola,28,30,-2
2004,Zaragoza,50205,Pedrosas (Las),0,1,-1
2004,Zaragoza,50206,Perdiguera,7,7,0
2004,Zaragoza,50208,Pina de Ebro,32,29,3
2004,Zaragoza,50209,Pinseque,30,64,-34
2004,Zaragoza,50211,Plasencia de Jalón,1,4,-3
2004,Zaragoza,50212,Pleitas,0,1,-1
2004,Zaragoza,50213,Plenas,0,4,-4
2004,Zaragoza,50214,Pomer,0,1,-1
2004,Zaragoza,50216,Pozuelo de Aragón,1,2,-1
2004,Zaragoza,50217,Pradilla de Ebro,8,11,-3
2004,Zaragoza,50218,Puebla de Albortón,1,1,0
2004,Zaragoza,50219,Puebla de Alfindén (La),78,24,54
2004,Zaragoza,50221,Purujosa,0,1,-1
2004,Zaragoza,50222,Quinto,8,25,-17
2004,Zaragoza,50223,Remolinos,6,14,-8
2004,Zaragoza,50225,Ricla,12,23,-11
2004,Zaragoza,50227,Romanos,0,2,-2
2004,Zaragoza,50228,Rueda de Jalón,2,7,-5
2004,Zaragoza,50229,Ruesca,0,1,-1
2004,Zaragoza,50231,Salillas de Jalón,2,2,0
2004,Zaragoza,50232,Salvatierra de Esca,1,9,-8
2004,Zaragoza,50233,Samper del Salz,1,2,-1
2004,Zaragoza,50234,San Martín de la Virgen de Moncayo,1,4,-3
2004,Zaragoza,50235,San Mateo de Gállego,23,22,1
2004,Zaragoza,50236,Santa Cruz de Grío,0,5,-5
2004,Zaragoza,50237,Santa Cruz de Moncayo,1,0,1
2004,Zaragoza,50238,Santa Eulalia de Gállego,0,3,-3
2004,Zaragoza,50239,Santed,1,1,0
2004,Zaragoza,50241,Saviñán,1,4,-3
2004,Zaragoza,50242,Sediles,1,4,-3
2004,Zaragoza,50243,Sestrica,2,7,-5
2004,Zaragoza,50244,Sierra de Luna,2,3,-1
2004,Zaragoza,50245,Sigüés,1,2,-1
2004,Zaragoza,50247,Sobradiel,9,5,4
2004,Zaragoza,50248,Sos del Rey Católico,3,4,-1
2004,Zaragoza,50230,Sádaba,4,32,-28
2004,Zaragoza,50240,Sástago,0,6,-6
2004,Zaragoza,50249,Tabuenca,3,4,-1
2004,Zaragoza,50251,Tarazona,90,145,-55
2004,Zaragoza,50252,Tauste,63,78,-15
2004,Zaragoza,50253,Terrer,1,9,-8
2004,Zaragoza,50254,Tierga,3,5,-2
2004,Zaragoza,50255,Tobed,0,4,-4
2004,Zaragoza,50256,Torralba de los Frailes,0,2,-2
2004,Zaragoza,50257,Torralba de Ribota,0,4,-4
2004,Zaragoza,50258,Torralbilla,0,1,-1
2004,Zaragoza,50259,Torrehermosa,0,2,-2
2004,Zaragoza,50260,Torrelapaja,0,1,-1
2004,Zaragoza,50261,Torrellas,2,4,-2
2004,Zaragoza,50262,Torres de Berrellén,7,15,-8
2004,Zaragoza,50263,Torrijo de la Cañada,0,4,-4
2004,Zaragoza,50264,Tosos,0,1,-1
2004,Zaragoza,50265,Trasmoz,0,1,-1
2004,Zaragoza,50266,Trasobares,1,5,-4
2004,Zaragoza,50267,Uncastillo,5,15,-10
2004,Zaragoza,50268,Undués de Lerda,1,0,1
2004,Zaragoza,50269,Urrea de Jalón,1,6,-5
2004,Zaragoza,50270,Urriés,0,2,-2
2004,Zaragoza,50271,Used,3,4,-1
2004,Zaragoza,50272,Utebo,213,55,158
2004,Zaragoza,50273,Valdehorna,0,1,-1
2004,Zaragoza,50276,Valpalmas,0,1,-1
2004,Zaragoza,50277,Valtorres,1,2,-1
2004,Zaragoza,50278,Velilla de Ebro,2,5,-3
2004,Zaragoza,50279,Velilla de Jiloca,0,0,0
2004,Zaragoza,50280,Vera de Moncayo,4,5,-1
2004,Zaragoza,50283,Villadoz,0,1,-1
2004,Zaragoza,50284,Villafeliche,0,4,-4
2004,Zaragoza,50285,Villafranca de Ebro,4,14,-10
2004,Zaragoza,50286,Villalba de Perejil,0,0,0
2004,Zaragoza,50287,Villalengua,1,4,-3
2004,Zaragoza,50288,Villanueva de Gállego,47,33,14
2004,Zaragoza,50290,Villanueva de Huerva,1,8,-7
2004,Zaragoza,50289,Villanueva de Jiloca,0,1,-1
2004,Zaragoza,50291,Villar de los Navarros,0,2,-2
2004,Zaragoza,50292,Villarreal de Huerva,1,1,0
2004,Zaragoza,50293,Villarroya de la Sierra,3,13,-10
2004,Zaragoza,50294,Villarroya del Campo,0,1,-1
2004,Zaragoza,50295,Vistabella,0,1,-1
2004,Zaragoza,50296,Zaida (La),2,8,-6
2004,Zaragoza,50297,Zaragoza,6357,6008,349
2004,Zaragoza,50298,Zuera,46,58,-12
2004,Zaragoza,50099,Épila,59,60,-1
2003,Zaragoza,50001,Abanto,1,4,-3
2003,Zaragoza,50002,Acered,0,2,-2
2003,Zaragoza,50004,Aguarón,2,21,-19
2003,Zaragoza,50005,Aguilón,0,4,-4
2003,Zaragoza,50003,Agón,0,1,-1
2003,Zaragoza,50006,Ainzón,14,16,-2
2003,Zaragoza,50008,Alagón,65,81,-16
2003,Zaragoza,50009,Alarba,1,2,-1
2003,Zaragoza,50010,Alberite de San Juan,2,0,2
2003,Zaragoza,50011,Albeta,1,0,1
2003,Zaragoza,50012,Alborge,1,3,-2
2003,Zaragoza,50013,Alcalá de Ebro,1,3,-2
2003,Zaragoza,50015,Alconchel de Ariza,1,1,0
2003,Zaragoza,50016,Aldehuela de Liestos,0,3,-3
2003,Zaragoza,50017,Alfajarín,22,20,2
2003,Zaragoza,50018,Alfamén,9,14,-5
2003,Zaragoza,50019,Alforque,1,0,1
2003,Zaragoza,50020,Alhama de Aragón,15,16,-1
2003,Zaragoza,50022,Almolda (La),1,14,-13
2003,Zaragoza,50023,Almonacid de la Cuba,2,5,-3
2003,Zaragoza,50024,Almonacid de la Sierra,0,18,-18
2003,Zaragoza,50025,Almunia de Doña Godina (La),75,77,-2
2003,Zaragoza,50026,Alpartir,6,11,-5
2003,Zaragoza,50027,Ambel,2,9,-7
2003,Zaragoza,50028,Anento,1,1,0
2003,Zaragoza,50029,Aniñón,4,18,-14
2003,Zaragoza,50031,Aranda de Moncayo,0,4,-4
2003,Zaragoza,50033,Ardisa,0,1,-1
2003,Zaragoza,50034,Ariza,10,31,-21
2003,Zaragoza,50035,Artieda,0,2,-2
2003,Zaragoza,50032,Arándiga,3,4,-1
2003,Zaragoza,50036,Asín,0,4,-4
2003,Zaragoza,50037,Atea,0,3,-3
2003,Zaragoza,50038,Ateca,11,26,-15
2003,Zaragoza,50039,Azuara,4,16,-12
2003,Zaragoza,50030,Añón de Moncayo,1,9,-8
2003,Zaragoza,50040,Badules,0,2,-2
2003,Zaragoza,50041,Bagüés,0,1,-1
2003,Zaragoza,50042,Balconchán,0,2,-2
2003,Zaragoza,50044,Bardallur,3,8,-5
2003,Zaragoza,50045,Belchite,15,22,-7
2003,Zaragoza,50046,Belmonte de Gracián,0,8,-8
2003,Zaragoza,50047,Berdejo,2,0,2
2003,Zaragoza,50048,Berrueco,0,1,-1
2003,Zaragoza,50901,Biel,1,5,-4
2003,Zaragoza,50050,Bijuesca,0,2,-2
2003,Zaragoza,50051,Biota,6,11,-5
2003,Zaragoza,50052,Bisimbre,1,3,-2
2003,Zaragoza,50053,Boquiñeni,7,17,-10
2003,Zaragoza,50054,Bordalba,0,1,-1
2003,Zaragoza,50055,Borja,42,76,-34
2003,Zaragoza,50056,Botorrita,0,2,-2
2003,Zaragoza,50057,Brea de Aragón,25,18,7
2003,Zaragoza,50058,Bubierca,0,2,-2
2003,Zaragoza,50059,Bujaraloz,6,10,-4
2003,Zaragoza,50060,Bulbuente,1,5,-4
2003,Zaragoza,50061,Bureta,0,3,-3
2003,Zaragoza,50062,Burgo de Ebro (El),19,19,0
2003,Zaragoza,50063,Buste (El),0,2,-2
2003,Zaragoza,50043,Bárboles,4,5,-1
2003,Zaragoza,50064,Cabañas de Ebro,3,6,-3
2003,Zaragoza,50065,Cabolafuente,0,1,-1
2003,Zaragoza,50066,Cadrete,26,9,17
2003,Zaragoza,50067,Calatayud,177,239,-62
2003,Zaragoza,50068,Calatorao,23,32,-9
2003,Zaragoza,50070,Calmarza,0,2,-2
2003,Zaragoza,50071,Campillo de Aragón,3,2,1
2003,Zaragoza,50072,Carenas,0,6,-6
2003,Zaragoza,50073,Cariñena,27,43,-16
2003,Zaragoza,50074,Caspe,65,97,-32
2003,Zaragoza,50075,Castejón de Alarba,0,1,-1
2003,Zaragoza,50076,Castejón de las Armas,0,3,-3
2003,Zaragoza,50077,Castejón de Valdejasa,1,3,-2
2003,Zaragoza,50078,Castiliscar,2,7,-5
2003,Zaragoza,50079,Cervera de la Cañada,2,7,-5
2003,Zaragoza,50081,Cetina,6,8,-2
2003,Zaragoza,50092,Chiprana,1,6,-5
2003,Zaragoza,50093,Chodes,0,3,-3
2003,Zaragoza,50082,Cimballa,0,3,-3
2003,Zaragoza,50083,Cinco Olivas,0,2,-2
2003,Zaragoza,50084,Clarés de Ribota,0,4,-4
2003,Zaragoza,50085,Codo,2,4,-2
2003,Zaragoza,50086,Codos,0,4,-4
2003,Zaragoza,50087,Contamina,0,1,-1
2003,Zaragoza,50088,Cosuenda,1,12,-11
2003,Zaragoza,50089,Cuarte de Huerva,33,27,6
2003,Zaragoza,50090,Cubel,1,4,-3
2003,Zaragoza,50091,Cuerlas (Las),0,1,-1
2003,Zaragoza,50094,Daroca,14,46,-32
2003,Zaragoza,50095,Ejea de los Caballeros,134,154,-20
2003,Zaragoza,50096,Embid de Ariza,0,1,-1
2003,Zaragoza,50098,Encinacorba,2,6,-4
2003,Zaragoza,50100,Erla,1,2,-1
2003,Zaragoza,50101,Escatrón,7,24,-17
2003,Zaragoza,50102,Fabara,6,17,-11
2003,Zaragoza,50104,Farlete,2,7,-5
2003,Zaragoza,50106,Fayos (Los),0,3,-3
2003,Zaragoza,50105,Fayón,1,8,-7
2003,Zaragoza,50107,Figueruelas,10,22,-12
2003,Zaragoza,50109,Frago (El),0,2,-2
2003,Zaragoza,50110,Frasno (El),1,3,-2
2003,Zaragoza,50111,Fréscano,0,4,-4
2003,Zaragoza,50113,Fuendejalón,2,13,-11
2003,Zaragoza,50114,Fuendetodos,0,1,-1
2003,Zaragoza,50115,Fuentes de Ebro,45,32,13
2003,Zaragoza,50116,Fuentes de Jiloca,2,4,-2
2003,Zaragoza,50117,Gallocanta,0,1,-1
2003,Zaragoza,50118,Gallur,14,43,-29
2003,Zaragoza,50119,Gelsa,8,10,-2
2003,Zaragoza,50120,Godojos,0,2,-2
2003,Zaragoza,50121,Gotor,4,5,-1
2003,Zaragoza,50122,Grisel,0,1,-1
2003,Zaragoza,50123,Grisén,2,8,-6
2003,Zaragoza,50124,Herrera de los Navarros,5,14,-9
2003,Zaragoza,50125,Ibdes,5,5,0
2003,Zaragoza,50126,Illueca,30,34,-4
2003,Zaragoza,50128,Isuerre,0,1,-1
2003,Zaragoza,50129,Jaraba,4,5,-1
2003,Zaragoza,50130,Jarque de Moncayo,2,15,-13
2003,Zaragoza,50131,Jaulín,2,7,-5
2003,Zaragoza,50132,Joyosa (La),9,9,0
2003,Zaragoza,50134,Langa del Castillo,0,3,-3
2003,Zaragoza,50135,Layana,1,2,-1
2003,Zaragoza,50137,Leciñena,8,12,-4
2003,Zaragoza,50139,Letux,0,13,-13
2003,Zaragoza,50141,Lituénigo,0,1,-1
2003,Zaragoza,50143,Longares,5,14,-9
2003,Zaragoza,50146,Lucena de Jalón,1,1,0
2003,Zaragoza,50147,Luceni,2,15,-13
2003,Zaragoza,50148,Luesia,0,0,0
2003,Zaragoza,50149,Luesma,0,1,-1
2003,Zaragoza,50150,Lumpiaque,2,10,-8
2003,Zaragoza,50151,Luna,3,13,-10
2003,Zaragoza,50136,Lécera,3,20,-17
2003,Zaragoza,50152,Maella,16,28,-12
2003,Zaragoza,50153,Magallón,7,19,-12
2003,Zaragoza,50154,Mainar,0,2,-2
2003,Zaragoza,50155,Malanquilla,0,2,-2
2003,Zaragoza,50156,Maleján,2,5,-3
2003,Zaragoza,50160,Mallén,32,35,-3
2003,Zaragoza,50159,Maluenda,6,17,-11
2003,Zaragoza,50157,Malón,3,3,0
2003,Zaragoza,50161,Manchones,0,2,-2
2003,Zaragoza,50162,Mara,0,1,-1
2003,Zaragoza,50902,Marracos,0,3,-3
2003,Zaragoza,50163,María de Huerva,33,12,21
2003,Zaragoza,50164,Mediana de Aragón,1,9,-8
2003,Zaragoza,50165,Mequinenza,19,35,-16
2003,Zaragoza,50166,Mesones de Isuela,1,2,-1
2003,Zaragoza,50167,Mezalocha,2,2,0
2003,Zaragoza,50169,Miedes de Aragón,3,8,-5
2003,Zaragoza,50170,Monegrillo,1,5,-4
2003,Zaragoza,50172,Monreal de Ariza,0,2,-2
2003,Zaragoza,50173,Monterde,0,5,-5
2003,Zaragoza,50174,Montón,0,2,-2
2003,Zaragoza,50175,Morata de Jalón,4,25,-21
2003,Zaragoza,50176,Morata de Jiloca,0,5,-5
2003,Zaragoza,50178,Moros,4,8,-4
2003,Zaragoza,50177,Morés,2,9,-7
2003,Zaragoza,50179,Moyuela,1,5,-4
2003,Zaragoza,50180,Mozota,0,2,-2
2003,Zaragoza,50181,Muel,11,16,-5
2003,Zaragoza,50182,Muela (La),26,14,12
2003,Zaragoza,50183,Munébrega,2,3,-1
2003,Zaragoza,50184,Murero,1,0,1
2003,Zaragoza,50185,Murillo de Gállego,1,2,-1
2003,Zaragoza,50186,Navardún,0,1,-1
2003,Zaragoza,50187,Nigüella,0,1,-1
2003,Zaragoza,50189,Nonaspe,7,15,-8
2003,Zaragoza,50190,Novallas,5,12,-7
2003,Zaragoza,50191,Novillas,2,14,-12
2003,Zaragoza,50193,Nuez de Ebro,2,6,-4
2003,Zaragoza,50192,Nuévalos,4,4,0
2003,Zaragoza,50194,Olvés,1,1,0
2003,Zaragoza,50195,Orcajo,0,1,-1
2003,Zaragoza,50196,Orera,0,3,-3
2003,Zaragoza,50197,Orés,0,3,-3
2003,Zaragoza,50198,Oseja,0,1,-1
2003,Zaragoza,50199,Osera de Ebro,3,21,-18
2003,Zaragoza,50200,Paniza,5,11,-6
2003,Zaragoza,50201,Paracuellos de Jiloca,3,7,-4
2003,Zaragoza,50202,Paracuellos de la Ribera,0,7,-7
2003,Zaragoza,50203,Pastriz,11,14,-3
2003,Zaragoza,50204,Pedrola,23,36,-13
2003,Zaragoza,50205,Pedrosas (Las),0,3,-3
2003,Zaragoza,50206,Perdiguera,2,5,-3
2003,Zaragoza,50208,Pina de Ebro,19,14,5
2003,Zaragoza,50209,Pinseque,16,56,-40
2003,Zaragoza,50210,Pintanos (Los),0,1,-1
2003,Zaragoza,50211,Plasencia de Jalón,3,6,-3
2003,Zaragoza,50213,Plenas,0,1,-1
2003,Zaragoza,50214,Pomer,0,0,0
2003,Zaragoza,50215,Pozuel de Ariza,0,1,-1
2003,Zaragoza,50216,Pozuelo de Aragón,2,4,-2
2003,Zaragoza,50217,Pradilla de Ebro,5,10,-5
2003,Zaragoza,50218,Puebla de Albortón,0,2,-2
2003,Zaragoza,50219,Puebla de Alfindén (La),36,19,17
2003,Zaragoza,50222,Quinto,6,25,-19
2003,Zaragoza,50223,Remolinos,6,18,-12
2003,Zaragoza,50224,Retascón,0,1,-1
2003,Zaragoza,50225,Ricla,21,31,-10
2003,Zaragoza,50227,Romanos,0,2,-2
2003,Zaragoza,50228,Rueda de Jalón,0,8,-8
2003,Zaragoza,50231,Salillas de Jalón,3,9,-6
2003,Zaragoza,50232,Salvatierra de Esca,4,5,-1
2003,Zaragoza,50233,Samper del Salz,1,2,-1
2003,Zaragoza,50234,San Martín de la Virgen de Moncayo,2,6,-4
2003,Zaragoza,50235,San Mateo de Gállego,22,19,3
2003,Zaragoza,50236,Santa Cruz de Grío,1,5,-4
2003,Zaragoza,50237,Santa Cruz de Moncayo,2,3,-1
2003,Zaragoza,50238,Santa Eulalia de Gállego,0,1,-1
2003,Zaragoza,50239,Santed,0,1,-1
2003,Zaragoza,50241,Saviñán,0,11,-11
2003,Zaragoza,50242,Sediles,0,1,-1
2003,Zaragoza,50243,Sestrica,0,4,-4
2003,Zaragoza,50244,Sierra de Luna,2,7,-5
2003,Zaragoza,50245,Sigüés,0,2,-2
2003,Zaragoza,50246,Sisamón,0,1,-1
2003,Zaragoza,50247,Sobradiel,3,4,-1
2003,Zaragoza,50248,Sos del Rey Católico,5,7,-2
2003,Zaragoza,50230,Sádaba,8,29,-21
2003,Zaragoza,50240,Sástago,2,13,-11
2003,Zaragoza,50249,Tabuenca,3,9,-6
2003,Zaragoza,50250,Talamantes,0,2,-2
2003,Zaragoza,50251,Tarazona,88,143,-55
2003,Zaragoza,50252,Tauste,59,92,-33
2003,Zaragoza,50253,Terrer,0,12,-12
2003,Zaragoza,50254,Tierga,2,3,-1
2003,Zaragoza,50255,Tobed,0,2,-2
2003,Zaragoza,50256,Torralba de los Frailes,0,1,-1
2003,Zaragoza,50257,Torralba de Ribota,0,5,-5
2003,Zaragoza,50258,Torralbilla,0,2,-2
2003,Zaragoza,50259,Torrehermosa,1,1,0
2003,Zaragoza,50260,Torrelapaja,0,1,-1
2003,Zaragoza,50261,Torrellas,0,4,-4
2003,Zaragoza,50262,Torres de Berrellén,11,19,-8
2003,Zaragoza,50263,Torrijo de la Cañada,2,9,-7
2003,Zaragoza,50264,Tosos,0,5,-5
2003,Zaragoza,50265,Trasmoz,0,1,-1
2003,Zaragoza,50266,Trasobares,0,6,-6
2003,Zaragoza,50267,Uncastillo,7,8,-1
2003,Zaragoza,50268,Undués de Lerda,0,1,-1
2003,Zaragoza,50269,Urrea de Jalón,4,7,-3
2003,Zaragoza,50270,Urriés,0,1,-1
2003,Zaragoza,50271,Used,0,5,-5
2003,Zaragoza,50272,Utebo,206,69,137
2003,Zaragoza,50274,Val de San Martín,0,1,-1
2003,Zaragoza,50273,Valdehorna,0,1,-1
2003,Zaragoza,50275,Valmadrid,0,2,-2
2003,Zaragoza,50276,Valpalmas,1,2,-1
2003,Zaragoza,50278,Velilla de Ebro,3,1,2
2003,Zaragoza,50279,Velilla de Jiloca,0,2,-2
2003,Zaragoza,50280,Vera de Moncayo,1,5,-4
2003,Zaragoza,50283,Villadoz,0,2,-2
2003,Zaragoza,50284,Villafeliche,2,2,0
2003,Zaragoza,50285,Villafranca de Ebro,3,9,-6
2003,Zaragoza,50286,Villalba de Perejil,0,1,-1
2003,Zaragoza,50287,Villalengua,0,5,-5
2003,Zaragoza,50288,Villanueva de Gállego,52,29,23
2003,Zaragoza,50290,Villanueva de Huerva,5,13,-8
2003,Zaragoza,50289,Villanueva de Jiloca,0,1,-1
2003,Zaragoza,50291,Villar de los Navarros,0,4,-4
2003,Zaragoza,50292,Villarreal de Huerva,4,1,3
2003,Zaragoza,50293,Villarroya de la Sierra,2,18,-16
2003,Zaragoza,50294,Villarroya del Campo,0,1,-1
2003,Zaragoza,50282,Vilueña (La),0,4,-4
2003,Zaragoza,50295,Vistabella,0,1,-1
2003,Zaragoza,50296,Zaida (La),3,7,-4
2003,Zaragoza,50297,Zaragoza,6282,6149,133
2003,Zaragoza,50298,Zuera,59,62,-3
2003,Zaragoza,50099,Épila,37,53,-16
2002,Zaragoza,50001,Abanto,0,2,-2
2002,Zaragoza,50002,Acered,1,4,-3
2002,Zaragoza,50004,Aguarón,4,20,-16
2002,Zaragoza,50005,Aguilón,0,2,-2
2002,Zaragoza,50003,Agón,3,1,2
2002,Zaragoza,50006,Ainzón,7,26,-19
2002,Zaragoza,50008,Alagón,42,80,-38
2002,Zaragoza,50009,Alarba,0,1,-1
2002,Zaragoza,50011,Albeta,1,1,0
2002,Zaragoza,50012,Alborge,2,0,2
2002,Zaragoza,50013,Alcalá de Ebro,4,1,3
2002,Zaragoza,50014,Alcalá de Moncayo,1,0,1
2002,Zaragoza,50015,Alconchel de Ariza,0,5,-5
2002,Zaragoza,50016,Aldehuela de Liestos,0,1,-1
2002,Zaragoza,50017,Alfajarín,13,22,-9
2002,Zaragoza,50018,Alfamén,8,15,-7
2002,Zaragoza,50019,Alforque,0,1,-1
2002,Zaragoza,50020,Alhama de Aragón,12,20,-8
2002,Zaragoza,50021,Almochuel,0,2,-2
2002,Zaragoza,50022,Almolda (La),4,9,-5
2002,Zaragoza,50023,Almonacid de la Cuba,1,7,-6
2002,Zaragoza,50024,Almonacid de la Sierra,5,20,-15
2002,Zaragoza,50025,Almunia de Doña Godina (La),62,70,-8
2002,Zaragoza,50026,Alpartir,3,4,-1
2002,Zaragoza,50027,Ambel,1,3,-2
2002,Zaragoza,50028,Anento,1,1,0
2002,Zaragoza,50029,Aniñón,5,13,-8
2002,Zaragoza,50031,Aranda de Moncayo,0,5,-5
2002,Zaragoza,50034,Ariza,9,15,-6
2002,Zaragoza,50035,Artieda,2,0,2
2002,Zaragoza,50032,Arándiga,0,7,-7
2002,Zaragoza,50036,Asín,0,1,-1
2002,Zaragoza,50037,Atea,0,8,-8
2002,Zaragoza,50038,Ateca,8,18,-10
2002,Zaragoza,50039,Azuara,4,10,-6
2002,Zaragoza,50030,Añón de Moncayo,0,6,-6
2002,Zaragoza,50040,Badules,0,2,-2
2002,Zaragoza,50044,Bardallur,2,5,-3
2002,Zaragoza,50045,Belchite,14,24,-10
2002,Zaragoza,50046,Belmonte de Gracián,0,5,-5
2002,Zaragoza,50048,Berrueco,0,1,-1
2002,Zaragoza,50901,Biel,0,4,-4
2002,Zaragoza,50050,Bijuesca,0,2,-2
2002,Zaragoza,50051,Biota,6,16,-10
2002,Zaragoza,50052,Bisimbre,0,1,-1
2002,Zaragoza,50053,Boquiñeni,3,15,-12
2002,Zaragoza,50055,Borja,58,73,-15
2002,Zaragoza,50056,Botorrita,3,8,-5
2002,Zaragoza,50057,Brea de Aragón,10,15,-5
2002,Zaragoza,50058,Bubierca,1,2,-1
2002,Zaragoza,50059,Bujaraloz,8,11,-3
2002,Zaragoza,50060,Bulbuente,1,8,-7
2002,Zaragoza,50061,Bureta,1,8,-7
2002,Zaragoza,50062,Burgo de Ebro (El),11,16,-5
2002,Zaragoza,50063,Buste (El),0,2,-2
2002,Zaragoza,50043,Bárboles,2,2,0
2002,Zaragoza,50064,Cabañas de Ebro,1,5,-4
2002,Zaragoza,50066,Cadrete,20,9,11
2002,Zaragoza,50067,Calatayud,168,215,-47
2002,Zaragoza,50068,Calatorao,21,26,-5
2002,Zaragoza,50069,Calcena,1,2,-1
2002,Zaragoza,50070,Calmarza,0,2,-2
2002,Zaragoza,50071,Campillo de Aragón,1,3,-2
2002,Zaragoza,50072,Carenas,2,4,-2
2002,Zaragoza,50073,Cariñena,29,35,-6
2002,Zaragoza,50074,Caspe,67,107,-40
2002,Zaragoza,50075,Castejón de Alarba,0,1,-1
2002,Zaragoza,50076,Castejón de las Armas,0,2,-2
2002,Zaragoza,50077,Castejón de Valdejasa,1,6,-5
2002,Zaragoza,50078,Castiliscar,1,8,-7
2002,Zaragoza,50079,Cervera de la Cañada,1,2,-1
2002,Zaragoza,50081,Cetina,2,15,-13
2002,Zaragoza,50092,Chiprana,3,3,0
2002,Zaragoza,50093,Chodes,1,1,0
2002,Zaragoza,50082,Cimballa,0,3,-3
2002,Zaragoza,50083,Cinco Olivas,0,3,-3
2002,Zaragoza,50084,Clarés de Ribota,0,2,-2
2002,Zaragoza,50085,Codo,1,7,-6
2002,Zaragoza,50086,Codos,0,4,-4
2002,Zaragoza,50087,Contamina,0,1,-1
2002,Zaragoza,50088,Cosuenda,0,11,-11
2002,Zaragoza,50089,Cuarte de Huerva,21,27,-6
2002,Zaragoza,50090,Cubel,1,3,-2
2002,Zaragoza,50091,Cuerlas (Las),1,1,0
2002,Zaragoza,50094,Daroca,14,27,-13
2002,Zaragoza,50095,Ejea de los Caballeros,102,145,-43
2002,Zaragoza,50098,Encinacorba,0,2,-2
2002,Zaragoza,50100,Erla,3,8,-5
2002,Zaragoza,50101,Escatrón,10,17,-7
2002,Zaragoza,50102,Fabara,7,21,-14
2002,Zaragoza,50104,Farlete,1,4,-3
2002,Zaragoza,50106,Fayos (Los),0,3,-3
2002,Zaragoza,50105,Fayón,0,6,-6
2002,Zaragoza,50107,Figueruelas,14,17,-3
2002,Zaragoza,50109,Frago (El),0,1,-1
2002,Zaragoza,50110,Frasno (El),1,7,-6
2002,Zaragoza,50111,Fréscano,0,3,-3
2002,Zaragoza,50113,Fuendejalón,4,10,-6
2002,Zaragoza,50114,Fuendetodos,0,3,-3
2002,Zaragoza,50115,Fuentes de Ebro,37,43,-6
2002,Zaragoza,50116,Fuentes de Jiloca,0,2,-2
2002,Zaragoza,50117,Gallocanta,0,2,-2
2002,Zaragoza,50118,Gallur,15,36,-21
2002,Zaragoza,50119,Gelsa,4,10,-6
2002,Zaragoza,50121,Gotor,6,0,6
2002,Zaragoza,50122,Grisel,0,1,-1
2002,Zaragoza,50123,Grisén,2,10,-8
2002,Zaragoza,50124,Herrera de los Navarros,2,12,-10
2002,Zaragoza,50125,Ibdes,6,5,1
2002,Zaragoza,50126,Illueca,34,24,10
2002,Zaragoza,50129,Jaraba,0,1,-1
2002,Zaragoza,50130,Jarque de Moncayo,4,10,-6
2002,Zaragoza,50131,Jaulín,0,8,-8
2002,Zaragoza,50132,Joyosa (La),4,8,-4
2002,Zaragoza,50133,Lagata,1,1,0
2002,Zaragoza,50134,Langa del Castillo,0,1,-1
2002,Zaragoza,50135,Layana,1,3,-2
2002,Zaragoza,50137,Leciñena,4,11,-7
2002,Zaragoza,50139,Letux,1,5,-4
2002,Zaragoza,50140,Litago,0,1,-1
2002,Zaragoza,50141,Lituénigo,0,1,-1
2002,Zaragoza,50142,Lobera de Onsella,0,1,-1
2002,Zaragoza,50143,Longares,2,12,-10
2002,Zaragoza,50146,Lucena de Jalón,2,3,-1
2002,Zaragoza,50147,Luceni,2,15,-13
2002,Zaragoza,50148,Luesia,0,2,-2
2002,Zaragoza,50149,Luesma,0,1,-1
2002,Zaragoza,50150,Lumpiaque,5,11,-6
2002,Zaragoza,50151,Luna,2,14,-12
2002,Zaragoza,50136,Lécera,6,23,-17
2002,Zaragoza,50152,Maella,11,22,-11
2002,Zaragoza,50153,Magallón,8,12,-4
2002,Zaragoza,50154,Mainar,1,3,-2
2002,Zaragoza,50155,Malanquilla,1,2,-1
2002,Zaragoza,50156,Maleján,2,2,0
2002,Zaragoza,50160,Mallén,20,38,-18
2002,Zaragoza,50159,Maluenda,6,6,0
2002,Zaragoza,50157,Malón,5,7,-2
2002,Zaragoza,50162,Mara,0,1,-1
2002,Zaragoza,50902,Marracos,0,3,-3
2002,Zaragoza,50163,María de Huerva,32,22,10
2002,Zaragoza,50164,Mediana de Aragón,2,7,-5
2002,Zaragoza,50165,Mequinenza,17,29,-12
2002,Zaragoza,50166,Mesones de Isuela,0,5,-5
2002,Zaragoza,50167,Mezalocha,4,3,1
2002,Zaragoza,50169,Miedes de Aragón,2,6,-4
2002,Zaragoza,50170,Monegrillo,1,2,-1
2002,Zaragoza,50171,Moneva,0,1,-1
2002,Zaragoza,50172,Monreal de Ariza,2,7,-5
2002,Zaragoza,50173,Monterde,1,1,0
2002,Zaragoza,50174,Montón,0,1,-1
2002,Zaragoza,50175,Morata de Jalón,4,18,-14
2002,Zaragoza,50176,Morata de Jiloca,0,3,-3
2002,Zaragoza,50178,Moros,3,7,-4
2002,Zaragoza,50177,Morés,2,4,-2
2002,Zaragoza,50179,Moyuela,0,2,-2
2002,Zaragoza,50180,Mozota,0,5,-5
2002,Zaragoza,50181,Muel,8,13,-5
2002,Zaragoza,50182,Muela (La),12,18,-6
2002,Zaragoza,50183,Munébrega,1,4,-3
2002,Zaragoza,50184,Murero,0,4,-4
2002,Zaragoza,50185,Murillo de Gállego,0,4,-4
2002,Zaragoza,50186,Navardún,0,2,-2
2002,Zaragoza,50187,Nigüella,0,1,-1
2002,Zaragoza,50189,Nonaspe,9,13,-4
2002,Zaragoza,50190,Novallas,4,8,-4
2002,Zaragoza,50191,Novillas,7,6,1
2002,Zaragoza,50193,Nuez de Ebro,5,4,1
2002,Zaragoza,50192,Nuévalos,5,1,4
2002,Zaragoza,50194,Olvés,1,2,-1
2002,Zaragoza,50196,Orera,0,2,-2
2002,Zaragoza,50199,Osera de Ebro,2,14,-12
2002,Zaragoza,50200,Paniza,2,10,-8
2002,Zaragoza,50201,Paracuellos de Jiloca,5,6,-1
2002,Zaragoza,50202,Paracuellos de la Ribera,0,2,-2
2002,Zaragoza,50203,Pastriz,11,6,5
2002,Zaragoza,50204,Pedrola,12,23,-11
2002,Zaragoza,50206,Perdiguera,12,4,8
2002,Zaragoza,50207,Piedratajada,0,4,-4
2002,Zaragoza,50208,Pina de Ebro,18,30,-12
2002,Zaragoza,50209,Pinseque,19,56,-37
2002,Zaragoza,50210,Pintanos (Los),0,1,-1
2002,Zaragoza,50211,Plasencia de Jalón,1,6,-5
2002,Zaragoza,50212,Pleitas,0,1,-1
2002,Zaragoza,50213,Plenas,1,1,0
2002,Zaragoza,50216,Pozuelo de Aragón,3,4,-1
2002,Zaragoza,50217,Pradilla de Ebro,4,9,-5
2002,Zaragoza,50218,Puebla de Albortón,0,3,-3
2002,Zaragoza,50219,Puebla de Alfindén (La),36,18,18
2002,Zaragoza,50222,Quinto,17,29,-12
2002,Zaragoza,50223,Remolinos,11,12,-1
2002,Zaragoza,50225,Ricla,17,24,-7
2002,Zaragoza,50227,Romanos,0,2,-2
2002,Zaragoza,50228,Rueda de Jalón,1,7,-6
2002,Zaragoza,50229,Ruesca,3,2,1
2002,Zaragoza,50231,Salillas de Jalón,2,8,-6
2002,Zaragoza,50232,Salvatierra de Esca,2,4,-2
2002,Zaragoza,50233,Samper del Salz,0,1,-1
2002,Zaragoza,50234,San Martín de la Virgen de Moncayo,1,2,-1
2002,Zaragoza,50235,San Mateo de Gállego,20,14,6
2002,Zaragoza,50236,Santa Cruz de Grío,0,4,-4
2002,Zaragoza,50237,Santa Cruz de Moncayo,0,0,0
2002,Zaragoza,50238,Santa Eulalia de Gállego,0,1,-1
2002,Zaragoza,50241,Saviñán,0,4,-4
2002,Zaragoza,50242,Sediles,0,2,-2
2002,Zaragoza,50243,Sestrica,2,5,-3
2002,Zaragoza,50244,Sierra de Luna,2,5,-3
2002,Zaragoza,50245,Sigüés,0,1,-1
2002,Zaragoza,50246,Sisamón,0,1,-1
2002,Zaragoza,50247,Sobradiel,8,12,-4
2002,Zaragoza,50248,Sos del Rey Católico,3,16,-13
2002,Zaragoza,50230,Sádaba,10,29,-19
2002,Zaragoza,50240,Sástago,2,14,-12
2002,Zaragoza,50249,Tabuenca,3,8,-5
2002,Zaragoza,50250,Talamantes,0,1,-1
2002,Zaragoza,50251,Tarazona,91,148,-57
2002,Zaragoza,50252,Tauste,65,92,-27
2002,Zaragoza,50253,Terrer,2,13,-11
2002,Zaragoza,50254,Tierga,0,1,-1
2002,Zaragoza,50255,Tobed,0,6,-6
2002,Zaragoza,50256,Torralba de los Frailes,1,2,-1
2002,Zaragoza,50257,Torralba de Ribota,0,4,-4
2002,Zaragoza,50258,Torralbilla,0,3,-3
2002,Zaragoza,50259,Torrehermosa,0,1,-1
2002,Zaragoza,50260,Torrelapaja,0,0,0
2002,Zaragoza,50261,Torrellas,0,5,-5
2002,Zaragoza,50262,Torres de Berrellén,14,15,-1
2002,Zaragoza,50263,Torrijo de la Cañada,1,10,-9
2002,Zaragoza,50264,Tosos,1,4,-3
2002,Zaragoza,50265,Trasmoz,0,1,-1
2002,Zaragoza,50266,Trasobares,0,6,-6
2002,Zaragoza,50267,Uncastillo,6,17,-11
2002,Zaragoza,50269,Urrea de Jalón,2,5,-3
2002,Zaragoza,50270,Urriés,0,2,-2
2002,Zaragoza,50271,Used,1,4,-3
2002,Zaragoza,50272,Utebo,151,75,76
2002,Zaragoza,50274,Val de San Martín,1,0,1
2002,Zaragoza,50273,Valdehorna,0,2,-2
2002,Zaragoza,50275,Valmadrid,1,1,0
2002,Zaragoza,50276,Valpalmas,0,1,-1
2002,Zaragoza,50277,Valtorres,0,1,-1
2002,Zaragoza,50278,Velilla de Ebro,3,1,2
2002,Zaragoza,50279,Velilla de Jiloca,0,2,-2
2002,Zaragoza,50280,Vera de Moncayo,0,7,-7
2002,Zaragoza,50281,Vierlas,2,0,2
2002,Zaragoza,50283,Villadoz,0,1,-1
2002,Zaragoza,50284,Villafeliche,2,6,-4
2002,Zaragoza,50285,Villafranca de Ebro,8,6,2
2002,Zaragoza,50286,Villalba de Perejil,0,3,-3
2002,Zaragoza,50287,Villalengua,1,9,-8
2002,Zaragoza,50288,Villanueva de Gállego,59,40,19
2002,Zaragoza,50290,Villanueva de Huerva,3,7,-4
2002,Zaragoza,50291,Villar de los Navarros,0,4,-4
2002,Zaragoza,50292,Villarreal de Huerva,2,1,1
2002,Zaragoza,50293,Villarroya de la Sierra,2,8,-6
2002,Zaragoza,50282,Vilueña (La),0,1,-1
2002,Zaragoza,50295,Vistabella,0,1,-1
2002,Zaragoza,50296,Zaida (La),2,7,-5
2002,Zaragoza,50297,Zaragoza,5952,5798,154
2002,Zaragoza,50298,Zuera,47,59,-12
2002,Zaragoza,50099,Épila,43,44,-1
2001,Zaragoza,50001,Abanto,0,4,-4
2001,Zaragoza,50002,Acered,1,3,-2
2001,Zaragoza,50004,Aguarón,2,15,-13
2001,Zaragoza,50005,Aguilón,0,4,-4
2001,Zaragoza,50003,Agón,0,1,-1
2001,Zaragoza,50006,Ainzón,7,14,-7
2001,Zaragoza,50007,Aladrén,1,3,-2
2001,Zaragoza,50008,Alagón,55,77,-22
2001,Zaragoza,50009,Alarba,0,2,-2
2001,Zaragoza,50010,Alberite de San Juan,2,2,0
2001,Zaragoza,50011,Albeta,1,3,-2
2001,Zaragoza,50012,Alborge,0,1,-1
2001,Zaragoza,50013,Alcalá de Ebro,0,6,-6
2001,Zaragoza,50014,Alcalá de Moncayo,0,2,-2
2001,Zaragoza,50015,Alconchel de Ariza,0,2,-2
2001,Zaragoza,50017,Alfajarín,13,18,-5
2001,Zaragoza,50018,Alfamén,6,13,-7
2001,Zaragoza,50019,Alforque,0,2,-2
2001,Zaragoza,50020,Alhama de Aragón,5,10,-5
2001,Zaragoza,50021,Almochuel,0,1,-1
2001,Zaragoza,50022,Almolda (La),4,9,-5
2001,Zaragoza,50023,Almonacid de la Cuba,2,5,-3
2001,Zaragoza,50024,Almonacid de la Sierra,1,10,-9
2001,Zaragoza,50025,Almunia de Doña Godina (La),67,58,9
2001,Zaragoza,50026,Alpartir,4,4,0
2001,Zaragoza,50027,Ambel,2,4,-2
2001,Zaragoza,50028,Anento,2,1,1
2001,Zaragoza,50029,Aniñón,1,14,-13
2001,Zaragoza,50031,Aranda de Moncayo,0,2,-2
2001,Zaragoza,50033,Ardisa,1,0,1
2001,Zaragoza,50034,Ariza,8,16,-8
2001,Zaragoza,50035,Artieda,1,0,1
2001,Zaragoza,50032,Arándiga,5,7,-2
2001,Zaragoza,50037,Atea,0,2,-2
2001,Zaragoza,50038,Ateca,9,20,-11
2001,Zaragoza,50039,Azuara,4,19,-15
2001,Zaragoza,50030,Añón de Moncayo,0,1,-1
2001,Zaragoza,50040,Badules,0,2,-2
2001,Zaragoza,50041,Bagüés,0,1,-1
2001,Zaragoza,50044,Bardallur,3,11,-8
2001,Zaragoza,50045,Belchite,13,26,-13
2001,Zaragoza,50046,Belmonte de Gracián,0,6,-6
2001,Zaragoza,50047,Berdejo,1,0,1
2001,Zaragoza,50901,Biel,1,4,-3
2001,Zaragoza,50050,Bijuesca,1,1,0
2001,Zaragoza,50051,Biota,9,14,-5
2001,Zaragoza,50052,Bisimbre,0,1,-1
2001,Zaragoza,50053,Boquiñeni,4,11,-7
2001,Zaragoza,50054,Bordalba,0,1,-1
2001,Zaragoza,50055,Borja,49,63,-14
2001,Zaragoza,50056,Botorrita,1,6,-5
2001,Zaragoza,50057,Brea de Aragón,17,16,1
2001,Zaragoza,50058,Bubierca,0,2,-2
2001,Zaragoza,50059,Bujaraloz,12,12,0
2001,Zaragoza,50060,Bulbuente,2,9,-7
2001,Zaragoza,50061,Bureta,3,6,-3
2001,Zaragoza,50062,Burgo de Ebro (El),21,8,13
2001,Zaragoza,50043,Bárboles,5,10,-5
2001,Zaragoza,50064,Cabañas de Ebro,1,4,-3
2001,Zaragoza,50065,Cabolafuente,1,0,1
2001,Zaragoza,50066,Cadrete,19,7,12
2001,Zaragoza,50067,Calatayud,183,208,-25
2001,Zaragoza,50068,Calatorao,19,38,-19
2001,Zaragoza,50069,Calcena,0,3,-3
2001,Zaragoza,50070,Calmarza,0,1,-1
2001,Zaragoza,50071,Campillo de Aragón,0,3,-3
2001,Zaragoza,50072,Carenas,1,5,-4
2001,Zaragoza,50073,Cariñena,28,20,8
2001,Zaragoza,50074,Caspe,70,110,-40
2001,Zaragoza,50075,Castejón de Alarba,0,2,-2
2001,Zaragoza,50076,Castejón de las Armas,0,1,-1
2001,Zaragoza,50077,Castejón de Valdejasa,3,4,-1
2001,Zaragoza,50078,Castiliscar,0,5,-5
2001,Zaragoza,50079,Cervera de la Cañada,0,5,-5
2001,Zaragoza,50081,Cetina,4,15,-11
2001,Zaragoza,50092,Chiprana,1,6,-5
2001,Zaragoza,50093,Chodes,0,2,-2
2001,Zaragoza,50082,Cimballa,1,1,0
2001,Zaragoza,50083,Cinco Olivas,0,4,-4
2001,Zaragoza,50084,Clarés de Ribota,0,3,-3
2001,Zaragoza,50085,Codo,1,3,-2
2001,Zaragoza,50086,Codos,0,5,-5
2001,Zaragoza,50087,Contamina,0,1,-1
2001,Zaragoza,50088,Cosuenda,2,9,-7
2001,Zaragoza,50089,Cuarte de Huerva,22,27,-5
2001,Zaragoza,50090,Cubel,1,3,-2
2001,Zaragoza,50094,Daroca,12,41,-29
2001,Zaragoza,50095,Ejea de los Caballeros,144,161,-17
2001,Zaragoza,50096,Embid de Ariza,0,4,-4
2001,Zaragoza,50098,Encinacorba,0,2,-2
2001,Zaragoza,50100,Erla,1,7,-6
2001,Zaragoza,50101,Escatrón,5,13,-8
2001,Zaragoza,50102,Fabara,8,13,-5
2001,Zaragoza,50104,Farlete,2,7,-5
2001,Zaragoza,50106,Fayos (Los),0,2,-2
2001,Zaragoza,50105,Fayón,3,6,-3
2001,Zaragoza,50107,Figueruelas,9,10,-1
2001,Zaragoza,50108,Fombuena,0,1,-1
2001,Zaragoza,50109,Frago (El),0,1,-1
2001,Zaragoza,50110,Frasno (El),0,6,-6
2001,Zaragoza,50111,Fréscano,0,8,-8
2001,Zaragoza,50113,Fuendejalón,6,14,-8
2001,Zaragoza,50114,Fuendetodos,0,2,-2
2001,Zaragoza,50115,Fuentes de Ebro,42,32,10
2001,Zaragoza,50116,Fuentes de Jiloca,2,2,0
2001,Zaragoza,50117,Gallocanta,0,1,-1
2001,Zaragoza,50118,Gallur,21,26,-5
2001,Zaragoza,50119,Gelsa,6,11,-5
2001,Zaragoza,50121,Gotor,3,5,-2
2001,Zaragoza,50122,Grisel,0,3,-3
2001,Zaragoza,50123,Grisén,0,6,-6
2001,Zaragoza,50124,Herrera de los Navarros,1,12,-11
2001,Zaragoza,50125,Ibdes,5,6,-1
2001,Zaragoza,50126,Illueca,30,18,12
2001,Zaragoza,50128,Isuerre,1,4,-3
2001,Zaragoza,50129,Jaraba,2,2,0
2001,Zaragoza,50130,Jarque de Moncayo,3,11,-8
2001,Zaragoza,50131,Jaulín,0,6,-6
2001,Zaragoza,50132,Joyosa (La),5,9,-4
2001,Zaragoza,50133,Lagata,0,3,-3
2001,Zaragoza,50134,Langa del Castillo,0,3,-3
2001,Zaragoza,50135,Layana,0,4,-4
2001,Zaragoza,50138,Lechón,1,1,0
2001,Zaragoza,50137,Leciñena,2,10,-8
2001,Zaragoza,50139,Letux,5,4,1
2001,Zaragoza,50140,Litago,0,2,-2
2001,Zaragoza,50141,Lituénigo,0,1,-1
2001,Zaragoza,50142,Lobera de Onsella,0,1,-1
2001,Zaragoza,50143,Longares,7,8,-1
2001,Zaragoza,50146,Lucena de Jalón,0,4,-4
2001,Zaragoza,50147,Luceni,10,13,-3
2001,Zaragoza,50148,Luesia,0,2,-2
2001,Zaragoza,50149,Luesma,1,0,1
2001,Zaragoza,50150,Lumpiaque,5,13,-8
2001,Zaragoza,50151,Luna,6,20,-14
2001,Zaragoza,50136,Lécera,6,17,-11
2001,Zaragoza,50152,Maella,7,25,-18
2001,Zaragoza,50153,Magallón,5,16,-11
2001,Zaragoza,50154,Mainar,2,3,-1
2001,Zaragoza,50155,Malanquilla,0,2,-2
2001,Zaragoza,50156,Maleján,1,7,-6
2001,Zaragoza,50160,Mallén,18,43,-25
2001,Zaragoza,50159,Maluenda,6,10,-4
2001,Zaragoza,50157,Malón,4,11,-7
2001,Zaragoza,50161,Manchones,0,2,-2
2001,Zaragoza,50162,Mara,0,4,-4
2001,Zaragoza,50163,María de Huerva,17,11,6
2001,Zaragoza,50164,Mediana de Aragón,3,7,-4
2001,Zaragoza,50165,Mequinenza,22,40,-18
2001,Zaragoza,50166,Mesones de Isuela,4,2,2
2001,Zaragoza,50167,Mezalocha,1,3,-2
2001,Zaragoza,50168,Mianos,1,1,0
2001,Zaragoza,50169,Miedes de Aragón,2,4,-2
2001,Zaragoza,50170,Monegrillo,2,2,0
2001,Zaragoza,50171,Moneva,0,1,-1
2001,Zaragoza,50172,Monreal de Ariza,1,1,0
2001,Zaragoza,50173,Monterde,1,4,-3
2001,Zaragoza,50174,Montón,0,5,-5
2001,Zaragoza,50175,Morata de Jalón,5,22,-17
2001,Zaragoza,50176,Morata de Jiloca,0,7,-7
2001,Zaragoza,50178,Moros,0,10,-10
2001,Zaragoza,50177,Morés,2,6,-4
2001,Zaragoza,50179,Moyuela,1,6,-5
2001,Zaragoza,50180,Mozota,0,2,-2
2001,Zaragoza,50181,Muel,8,12,-4
2001,Zaragoza,50182,Muela (La),16,12,4
2001,Zaragoza,50183,Munébrega,5,8,-3
2001,Zaragoza,50184,Murero,0,5,-5
2001,Zaragoza,50185,Murillo de Gállego,2,4,-2
2001,Zaragoza,50186,Navardún,0,1,-1
2001,Zaragoza,50187,Nigüella,0,2,-2
2001,Zaragoza,50189,Nonaspe,11,18,-7
2001,Zaragoza,50190,Novallas,4,9,-5
2001,Zaragoza,50191,Novillas,4,14,-10
2001,Zaragoza,50193,Nuez de Ebro,4,5,-1
2001,Zaragoza,50192,Nuévalos,3,3,0
2001,Zaragoza,50194,Olvés,0,2,-2
2001,Zaragoza,50195,Orcajo,0,2,-2
2001,Zaragoza,50196,Orera,1,0,1
2001,Zaragoza,50197,Orés,1,0,1
2001,Zaragoza,50199,Osera de Ebro,1,6,-5
2001,Zaragoza,50200,Paniza,1,7,-6
2001,Zaragoza,50201,Paracuellos de Jiloca,1,12,-11
2001,Zaragoza,50202,Paracuellos de la Ribera,1,5,-4
2001,Zaragoza,50203,Pastriz,8,5,3
2001,Zaragoza,50204,Pedrola,25,23,2
2001,Zaragoza,50206,Perdiguera,4,5,-1
2001,Zaragoza,50207,Piedratajada,0,3,-3
2001,Zaragoza,50208,Pina de Ebro,31,23,8
2001,Zaragoza,50209,Pinseque,17,57,-40
2001,Zaragoza,50211,Plasencia de Jalón,2,8,-6
2001,Zaragoza,50212,Pleitas,0,2,-2
2001,Zaragoza,50213,Plenas,0,1,-1
2001,Zaragoza,50214,Pomer,0,1,-1
2001,Zaragoza,50216,Pozuelo de Aragón,2,3,-1
2001,Zaragoza,50217,Pradilla de Ebro,4,12,-8
2001,Zaragoza,50218,Puebla de Albortón,0,2,-2
2001,Zaragoza,50219,Puebla de Alfindén (La),30,20,10
2001,Zaragoza,50221,Purujosa,0,1,-1
2001,Zaragoza,50222,Quinto,11,31,-20
2001,Zaragoza,50223,Remolinos,9,27,-18
2001,Zaragoza,50224,Retascón,0,1,-1
2001,Zaragoza,50225,Ricla,19,27,-8
2001,Zaragoza,50227,Romanos,0,2,-2
2001,Zaragoza,50228,Rueda de Jalón,0,3,-3
2001,Zaragoza,50229,Ruesca,2,2,0
2001,Zaragoza,50231,Salillas de Jalón,4,5,-1
2001,Zaragoza,50232,Salvatierra de Esca,1,5,-4
2001,Zaragoza,50234,San Martín de la Virgen de Moncayo,0,2,-2
2001,Zaragoza,50235,San Mateo de Gállego,18,21,-3
2001,Zaragoza,50236,Santa Cruz de Grío,1,5,-4
2001,Zaragoza,50237,Santa Cruz de Moncayo,0,0,0
2001,Zaragoza,50238,Santa Eulalia de Gállego,1,1,0
2001,Zaragoza,50239,Santed,0,1,-1
2001,Zaragoza,50241,Saviñán,2,7,-5
2001,Zaragoza,50243,Sestrica,6,9,-3
2001,Zaragoza,50244,Sierra de Luna,0,4,-4
2001,Zaragoza,50245,Sigüés,0,2,-2
2001,Zaragoza,50246,Sisamón,0,2,-2
2001,Zaragoza,50247,Sobradiel,5,8,-3
2001,Zaragoza,50248,Sos del Rey Católico,5,12,-7
2001,Zaragoza,50230,Sádaba,16,17,-1
2001,Zaragoza,50240,Sástago,1,6,-5
2001,Zaragoza,50249,Tabuenca,0,7,-7
2001,Zaragoza,50250,Talamantes,0,1,-1
2001,Zaragoza,50251,Tarazona,82,124,-42
2001,Zaragoza,50252,Tauste,47,83,-36
2001,Zaragoza,50253,Terrer,2,13,-11
2001,Zaragoza,50254,Tierga,1,4,-3
2001,Zaragoza,50255,Tobed,1,2,-1
2001,Zaragoza,50256,Torralba de los Frailes,0,1,-1
2001,Zaragoza,50257,Torralba de Ribota,0,3,-3
2001,Zaragoza,50258,Torralbilla,0,1,-1
2001,Zaragoza,50259,Torrehermosa,0,1,-1
2001,Zaragoza,50260,Torrelapaja,0,1,-1
2001,Zaragoza,50261,Torrellas,1,5,-4
2001,Zaragoza,50262,Torres de Berrellén,8,28,-20
2001,Zaragoza,50263,Torrijo de la Cañada,0,5,-5
2001,Zaragoza,50264,Tosos,0,7,-7
2001,Zaragoza,50265,Trasmoz,0,1,-1
2001,Zaragoza,50266,Trasobares,0,5,-5
2001,Zaragoza,50267,Uncastillo,7,19,-12
2001,Zaragoza,50269,Urrea de Jalón,0,3,-3
2001,Zaragoza,50270,Urriés,0,1,-1
2001,Zaragoza,50271,Used,0,7,-7
2001,Zaragoza,50272,Utebo,131,82,49
2001,Zaragoza,50273,Valdehorna,0,2,-2
2001,Zaragoza,50276,Valpalmas,0,3,-3
2001,Zaragoza,50277,Valtorres,1,3,-2
2001,Zaragoza,50278,Velilla de Ebro,1,2,-1
2001,Zaragoza,50280,Vera de Moncayo,1,10,-9
2001,Zaragoza,50281,Vierlas,1,0,1
2001,Zaragoza,50283,Villadoz,1,2,-1
2001,Zaragoza,50284,Villafeliche,3,4,-1
2001,Zaragoza,50285,Villafranca de Ebro,11,11,0
2001,Zaragoza,50286,Villalba de Perejil,2,0,2
2001,Zaragoza,50287,Villalengua,2,10,-8
2001,Zaragoza,50288,Villanueva de Gállego,47,33,14
2001,Zaragoza,50290,Villanueva de Huerva,5,10,-5
2001,Zaragoza,50291,Villar de los Navarros,0,4,-4
2001,Zaragoza,50292,Villarreal de Huerva,2,3,-1
2001,Zaragoza,50293,Villarroya de la Sierra,1,16,-15
2001,Zaragoza,50294,Villarroya del Campo,0,1,-1
2001,Zaragoza,50282,Vilueña (La),0,2,-2
2001,Zaragoza,50296,Zaida (La),1,9,-8
2001,Zaragoza,50297,Zaragoza,5820,5692,128
2001,Zaragoza,50298,Zuera,30,54,-24
2001,Zaragoza,50099,Épila,38,54,-16
2000,Zaragoza,50001,Abanto,0,3,-3
2000,Zaragoza,50002,Acered,0,4,-4
2000,Zaragoza,50004,Aguarón,2,11,-9
2000,Zaragoza,50005,Aguilón,0,5,-5
2000,Zaragoza,50003,Agón,4,1,3
2000,Zaragoza,50006,Ainzón,15,15,0
2000,Zaragoza,50008,Alagón,41,76,-35
2000,Zaragoza,50009,Alarba,1,1,0
2000,Zaragoza,50010,Alberite de San Juan,0,2,-2
2000,Zaragoza,50011,Albeta,2,4,-2
2000,Zaragoza,50012,Alborge,1,3,-2
2000,Zaragoza,50013,Alcalá de Ebro,2,8,-6
2000,Zaragoza,50014,Alcalá de Moncayo,0,1,-1
2000,Zaragoza,50015,Alconchel de Ariza,1,2,-1
2000,Zaragoza,50017,Alfajarín,18,11,7
2000,Zaragoza,50018,Alfamén,11,16,-5
2000,Zaragoza,50019,Alforque,0,1,-1
2000,Zaragoza,50020,Alhama de Aragón,14,10,4
2000,Zaragoza,50021,Almochuel,0,1,-1
2000,Zaragoza,50022,Almolda (La),3,9,-6
2000,Zaragoza,50023,Almonacid de la Cuba,2,3,-1
2000,Zaragoza,50024,Almonacid de la Sierra,2,11,-9
2000,Zaragoza,50025,Almunia de Doña Godina (La),44,59,-15
2000,Zaragoza,50026,Alpartir,6,9,-3
2000,Zaragoza,50027,Ambel,3,7,-4
2000,Zaragoza,50029,Aniñón,7,17,-10
2000,Zaragoza,50031,Aranda de Moncayo,1,0,1
2000,Zaragoza,50034,Ariza,4,23,-19
2000,Zaragoza,50035,Artieda,1,1,0
2000,Zaragoza,50032,Arándiga,1,11,-10
2000,Zaragoza,50037,Atea,0,1,-1
2000,Zaragoza,50038,Ateca,11,29,-18
2000,Zaragoza,50039,Azuara,2,14,-12
2000,Zaragoza,50030,Añón de Moncayo,0,1,-1
2000,Zaragoza,50040,Badules,0,1,-1
2000,Zaragoza,50042,Balconchán,0,1,-1
2000,Zaragoza,50044,Bardallur,2,5,-3
2000,Zaragoza,50045,Belchite,15,21,-6
2000,Zaragoza,50046,Belmonte de Gracián,0,1,-1
2000,Zaragoza,50047,Berdejo,0,1,-1
2000,Zaragoza,50048,Berrueco,1,0,1
2000,Zaragoza,50901,Biel,1,5,-4
2000,Zaragoza,50050,Bijuesca,0,1,-1
2000,Zaragoza,50051,Biota,13,17,-4
2000,Zaragoza,50052,Bisimbre,0,2,-2
2000,Zaragoza,50053,Boquiñeni,3,13,-10
2000,Zaragoza,50054,Bordalba,1,1,0
2000,Zaragoza,50055,Borja,35,60,-25
2000,Zaragoza,50056,Botorrita,1,6,-5
2000,Zaragoza,50057,Brea de Aragón,19,23,-4
2000,Zaragoza,50058,Bubierca,0,2,-2
2000,Zaragoza,50059,Bujaraloz,13,10,3
2000,Zaragoza,50060,Bulbuente,1,4,-3
2000,Zaragoza,50061,Bureta,1,3,-2
2000,Zaragoza,50062,Burgo de Ebro (El),12,12,0
2000,Zaragoza,50043,Bárboles,3,7,-4
2000,Zaragoza,50064,Cabañas de Ebro,1,6,-5
2000,Zaragoza,50065,Cabolafuente,0,1,-1
2000,Zaragoza,50066,Cadrete,14,14,0
2000,Zaragoza,50067,Calatayud,164,227,-63
2000,Zaragoza,50068,Calatorao,31,31,0
2000,Zaragoza,50070,Calmarza,0,1,-1
2000,Zaragoza,50071,Campillo de Aragón,1,2,-1
2000,Zaragoza,50072,Carenas,1,3,-2
2000,Zaragoza,50073,Cariñena,32,21,11
2000,Zaragoza,50074,Caspe,56,103,-47
2000,Zaragoza,50075,Castejón de Alarba,0,2,-2
2000,Zaragoza,50076,Castejón de las Armas,1,3,-2
2000,Zaragoza,50077,Castejón de Valdejasa,0,10,-10
2000,Zaragoza,50078,Castiliscar,0,6,-6
2000,Zaragoza,50079,Cervera de la Cañada,0,3,-3
2000,Zaragoza,50081,Cetina,5,19,-14
2000,Zaragoza,50092,Chiprana,1,4,-3
2000,Zaragoza,50093,Chodes,0,3,-3
2000,Zaragoza,50082,Cimballa,0,6,-6
2000,Zaragoza,50083,Cinco Olivas,0,3,-3
2000,Zaragoza,50084,Clarés de Ribota,0,1,-1
2000,Zaragoza,50085,Codo,1,4,-3
2000,Zaragoza,50086,Codos,0,7,-7
2000,Zaragoza,50087,Contamina,0,1,-1
2000,Zaragoza,50088,Cosuenda,0,6,-6
2000,Zaragoza,50089,Cuarte de Huerva,25,21,4
2000,Zaragoza,50090,Cubel,1,2,-1
2000,Zaragoza,50091,Cuerlas (Las),0,2,-2
2000,Zaragoza,50094,Daroca,17,31,-14
2000,Zaragoza,50095,Ejea de los Caballeros,124,139,-15
2000,Zaragoza,50096,Embid de Ariza,0,3,-3
2000,Zaragoza,50098,Encinacorba,2,4,-2
2000,Zaragoza,50100,Erla,3,8,-5
2000,Zaragoza,50101,Escatrón,4,11,-7
2000,Zaragoza,50102,Fabara,7,18,-11
2000,Zaragoza,50104,Farlete,2,4,-2
2000,Zaragoza,50106,Fayos (Los),0,4,-4
2000,Zaragoza,50105,Fayón,1,4,-3
2000,Zaragoza,50107,Figueruelas,7,19,-12
2000,Zaragoza,50109,Frago (El),0,1,-1
2000,Zaragoza,50110,Frasno (El),1,6,-5
2000,Zaragoza,50111,Fréscano,2,3,-1
2000,Zaragoza,50113,Fuendejalón,2,10,-8
2000,Zaragoza,50114,Fuendetodos,1,2,-1
2000,Zaragoza,50115,Fuentes de Ebro,38,41,-3
2000,Zaragoza,50116,Fuentes de Jiloca,0,2,-2
2000,Zaragoza,50117,Gallocanta,1,5,-4
2000,Zaragoza,50118,Gallur,27,32,-5
2000,Zaragoza,50119,Gelsa,7,20,-13
2000,Zaragoza,50121,Gotor,7,3,4
2000,Zaragoza,50123,Grisén,3,4,-1
2000,Zaragoza,50124,Herrera de los Navarros,6,8,-2
2000,Zaragoza,50125,Ibdes,4,5,-1
2000,Zaragoza,50126,Illueca,32,25,7
2000,Zaragoza,50128,Isuerre,0,0,0
2000,Zaragoza,50129,Jaraba,0,2,-2
2000,Zaragoza,50130,Jarque de Moncayo,6,5,1
2000,Zaragoza,50131,Jaulín,1,5,-4
2000,Zaragoza,50132,Joyosa (La),3,10,-7
2000,Zaragoza,50133,Lagata,0,6,-6
2000,Zaragoza,50134,Langa del Castillo,0,2,-2
2000,Zaragoza,50135,Layana,1,3,-2
2000,Zaragoza,50138,Lechón,1,0,1
2000,Zaragoza,50137,Leciñena,7,12,-5
2000,Zaragoza,50139,Letux,0,5,-5
2000,Zaragoza,50141,Lituénigo,0,3,-3
2000,Zaragoza,50142,Lobera de Onsella,0,3,-3
2000,Zaragoza,50143,Longares,6,13,-7
2000,Zaragoza,50144,Longás,0,1,-1
2000,Zaragoza,50146,Lucena de Jalón,0,3,-3
2000,Zaragoza,50147,Luceni,5,9,-4
2000,Zaragoza,50148,Luesia,2,15,-13
2000,Zaragoza,50149,Luesma,0,1,-1
2000,Zaragoza,50150,Lumpiaque,9,11,-2
2000,Zaragoza,50151,Luna,1,12,-11
2000,Zaragoza,50136,Lécera,0,11,-11
2000,Zaragoza,50152,Maella,16,22,-6
2000,Zaragoza,50153,Magallón,11,24,-13
2000,Zaragoza,50154,Mainar,0,2,-2
2000,Zaragoza,50155,Malanquilla,0,1,-1
2000,Zaragoza,50156,Maleján,1,1,0
2000,Zaragoza,50160,Mallén,17,17,0
2000,Zaragoza,50159,Maluenda,4,18,-14
2000,Zaragoza,50157,Malón,3,3,0
2000,Zaragoza,50161,Manchones,2,3,-1
2000,Zaragoza,50162,Mara,1,4,-3
2000,Zaragoza,50902,Marracos,1,4,-3
2000,Zaragoza,50163,María de Huerva,11,17,-6
2000,Zaragoza,50164,Mediana de Aragón,1,10,-9
2000,Zaragoza,50165,Mequinenza,26,39,-13
2000,Zaragoza,50166,Mesones de Isuela,1,7,-6
2000,Zaragoza,50167,Mezalocha,0,3,-3
2000,Zaragoza,50169,Miedes de Aragón,4,7,-3
2000,Zaragoza,50170,Monegrillo,1,7,-6
2000,Zaragoza,50172,Monreal de Ariza,0,6,-6
2000,Zaragoza,50173,Monterde,2,5,-3
2000,Zaragoza,50175,Morata de Jalón,6,17,-11
2000,Zaragoza,50176,Morata de Jiloca,0,6,-6
2000,Zaragoza,50178,Moros,9,11,-2
2000,Zaragoza,50177,Morés,4,6,-2
2000,Zaragoza,50179,Moyuela,0,5,-5
2000,Zaragoza,50180,Mozota,1,1,0
2000,Zaragoza,50181,Muel,10,14,-4
2000,Zaragoza,50182,Muela (La),9,11,-2
2000,Zaragoza,50183,Munébrega,3,6,-3
2000,Zaragoza,50184,Murero,0,1,-1
2000,Zaragoza,50185,Murillo de Gállego,0,2,-2
2000,Zaragoza,50186,Navardún,0,1,-1
2000,Zaragoza,50187,Nigüella,0,1,-1
2000,Zaragoza,50189,Nonaspe,7,20,-13
2000,Zaragoza,50190,Novallas,6,8,-2
2000,Zaragoza,50191,Novillas,3,12,-9
2000,Zaragoza,50193,Nuez de Ebro,6,4,2
2000,Zaragoza,50192,Nuévalos,2,3,-1
2000,Zaragoza,50194,Olvés,1,2,-1
2000,Zaragoza,50195,Orcajo,0,1,-1
2000,Zaragoza,50196,Orera,0,3,-3
2000,Zaragoza,50197,Orés,0,2,-2
2000,Zaragoza,50199,Osera de Ebro,2,8,-6
2000,Zaragoza,50200,Paniza,4,11,-7
2000,Zaragoza,50201,Paracuellos de Jiloca,3,10,-7
2000,Zaragoza,50202,Paracuellos de la Ribera,0,8,-8
2000,Zaragoza,50203,Pastriz,14,13,1
2000,Zaragoza,50204,Pedrola,22,23,-1
2000,Zaragoza,50205,Pedrosas (Las),0,1,-1
2000,Zaragoza,50206,Perdiguera,7,8,-1
2000,Zaragoza,50207,Piedratajada,2,1,1
2000,Zaragoza,50208,Pina de Ebro,23,17,6
2000,Zaragoza,50209,Pinseque,14,54,-40
2000,Zaragoza,50210,Pintanos (Los),0,1,-1
2000,Zaragoza,50211,Plasencia de Jalón,4,8,-4
2000,Zaragoza,50212,Pleitas,0,1,-1
2000,Zaragoza,50213,Plenas,0,1,-1
2000,Zaragoza,50216,Pozuelo de Aragón,1,5,-4
2000,Zaragoza,50217,Pradilla de Ebro,3,8,-5
2000,Zaragoza,50218,Puebla de Albortón,1,0,1
2000,Zaragoza,50219,Puebla de Alfindén (La),18,15,3
2000,Zaragoza,50222,Quinto,13,19,-6
2000,Zaragoza,50223,Remolinos,15,12,3
2000,Zaragoza,50224,Retascón,0,1,-1
2000,Zaragoza,50225,Ricla,15,18,-3
2000,Zaragoza,50227,Romanos,0,3,-3
2000,Zaragoza,50228,Rueda de Jalón,1,3,-2
2000,Zaragoza,50229,Ruesca,0,1,-1
2000,Zaragoza,50231,Salillas de Jalón,0,3,-3
2000,Zaragoza,50232,Salvatierra de Esca,4,5,-1
2000,Zaragoza,50234,San Martín de la Virgen de Moncayo,0,2,-2
2000,Zaragoza,50235,San Mateo de Gállego,19,32,-13
2000,Zaragoza,50236,Santa Cruz de Grío,0,4,-4
2000,Zaragoza,50237,Santa Cruz de Moncayo,2,3,-1
2000,Zaragoza,50238,Santa Eulalia de Gállego,0,3,-3
2000,Zaragoza,50239,Santed,1,0,1
2000,Zaragoza,50241,Saviñán,0,5,-5
2000,Zaragoza,50242,Sediles,0,2,-2
2000,Zaragoza,50243,Sestrica,5,12,-7
2000,Zaragoza,50244,Sierra de Luna,2,1,1
2000,Zaragoza,50245,Sigüés,1,1,0
2000,Zaragoza,50247,Sobradiel,8,6,2
2000,Zaragoza,50248,Sos del Rey Católico,5,7,-2
2000,Zaragoza,50230,Sádaba,12,14,-2
2000,Zaragoza,50240,Sástago,0,12,-12
2000,Zaragoza,50249,Tabuenca,2,9,-7
2000,Zaragoza,50250,Talamantes,1,1,0
2000,Zaragoza,50251,Tarazona,86,120,-34
2000,Zaragoza,50252,Tauste,44,91,-47
2000,Zaragoza,50253,Terrer,2,7,-5
2000,Zaragoza,50254,Tierga,1,5,-4
2000,Zaragoza,50255,Tobed,2,2,0
2000,Zaragoza,50257,Torralba de Ribota,0,3,-3
2000,Zaragoza,50258,Torralbilla,0,1,-1
2000,Zaragoza,50259,Torrehermosa,0,2,-2
2000,Zaragoza,50260,Torrelapaja,0,2,-2
2000,Zaragoza,50261,Torrellas,0,3,-3
2000,Zaragoza,50262,Torres de Berrellén,8,15,-7
2000,Zaragoza,50263,Torrijo de la Cañada,1,8,-7
2000,Zaragoza,50264,Tosos,0,1,-1
2000,Zaragoza,50265,Trasmoz,0,1,-1
2000,Zaragoza,50266,Trasobares,2,4,-2
2000,Zaragoza,50267,Uncastillo,5,19,-14
2000,Zaragoza,50269,Urrea de Jalón,3,8,-5
2000,Zaragoza,50270,Urriés,0,1,-1
2000,Zaragoza,50271,Used,4,5,-1
2000,Zaragoza,50272,Utebo,115,59,56
2000,Zaragoza,50274,Val de San Martín,0,0,0
2000,Zaragoza,50273,Valdehorna,0,1,-1
2000,Zaragoza,50275,Valmadrid,1,1,0
2000,Zaragoza,50276,Valpalmas,0,4,-4
2000,Zaragoza,50277,Valtorres,0,2,-2
2000,Zaragoza,50278,Velilla de Ebro,0,6,-6
2000,Zaragoza,50279,Velilla de Jiloca,0,1,-1
2000,Zaragoza,50280,Vera de Moncayo,1,6,-5
2000,Zaragoza,50281,Vierlas,1,4,-3
2000,Zaragoza,50283,Villadoz,0,1,-1
2000,Zaragoza,50284,Villafeliche,1,7,-6
2000,Zaragoza,50285,Villafranca de Ebro,5,8,-3
2000,Zaragoza,50286,Villalba de Perejil,0,2,-2
2000,Zaragoza,50287,Villalengua,3,2,1
2000,Zaragoza,50288,Villanueva de Gállego,40,45,-5
2000,Zaragoza,50290,Villanueva de Huerva,3,5,-2
2000,Zaragoza,50289,Villanueva de Jiloca,0,2,-2
2000,Zaragoza,50291,Villar de los Navarros,0,1,-1
2000,Zaragoza,50292,Villarreal de Huerva,2,0,2
2000,Zaragoza,50293,Villarroya de la Sierra,1,19,-18
2000,Zaragoza,50294,Villarroya del Campo,0,1,-1
2000,Zaragoza,50282,Vilueña (La),0,2,-2
2000,Zaragoza,50295,Vistabella,0,1,-1
2000,Zaragoza,50296,Zaida (La),4,8,-4
2000,Zaragoza,50297,Zaragoza,5464,5619,-155
2000,Zaragoza,50298,Zuera,54,60,-6
2000,Zaragoza,50099,Épila,37,52,-15
1999,Zaragoza,50001,Abanto,0,3,-3
1999,Zaragoza,50002,Acered,1,3,-2
1999,Zaragoza,50004,Aguarón,3,20,-17
1999,Zaragoza,50005,Aguilón,0,7,-7
1999,Zaragoza,50003,Agón,1,2,-1
1999,Zaragoza,50006,Ainzón,13,18,-5
1999,Zaragoza,50007,Aladrén,0,1,-1
1999,Zaragoza,50008,Alagón,34,93,-59
1999,Zaragoza,50009,Alarba,2,0,2
1999,Zaragoza,50010,Alberite de San Juan,0,1,-1
1999,Zaragoza,50011,Albeta,0,2,-2
1999,Zaragoza,50012,Alborge,1,2,-1
1999,Zaragoza,50013,Alcalá de Ebro,0,8,-8
1999,Zaragoza,50015,Alconchel de Ariza,0,2,-2
1999,Zaragoza,50016,Aldehuela de Liestos,0,2,-2
1999,Zaragoza,50017,Alfajarín,8,17,-9
1999,Zaragoza,50018,Alfamén,8,12,-4
1999,Zaragoza,50019,Alforque,0,3,-3
1999,Zaragoza,50020,Alhama de Aragón,9,24,-15
1999,Zaragoza,50021,Almochuel,0,1,-1
1999,Zaragoza,50022,Almolda (La),3,10,-7
1999,Zaragoza,50023,Almonacid de la Cuba,1,10,-9
1999,Zaragoza,50024,Almonacid de la Sierra,8,18,-10
1999,Zaragoza,50025,Almunia de Doña Godina (La),69,55,14
1999,Zaragoza,50026,Alpartir,3,8,-5
1999,Zaragoza,50027,Ambel,0,4,-4
1999,Zaragoza,50028,Anento,0,1,-1
1999,Zaragoza,50029,Aniñón,6,14,-8
1999,Zaragoza,50031,Aranda de Moncayo,1,5,-4
1999,Zaragoza,50034,Ariza,10,23,-13
1999,Zaragoza,50035,Artieda,0,2,-2
1999,Zaragoza,50032,Arándiga,1,9,-8
1999,Zaragoza,50036,Asín,0,4,-4
1999,Zaragoza,50037,Atea,0,5,-5
1999,Zaragoza,50038,Ateca,13,18,-5
1999,Zaragoza,50039,Azuara,4,9,-5
1999,Zaragoza,50030,Añón de Moncayo,2,2,0
1999,Zaragoza,50040,Badules,0,2,-2
1999,Zaragoza,50042,Balconchán,0,1,-1
1999,Zaragoza,50044,Bardallur,1,9,-8
1999,Zaragoza,50045,Belchite,14,17,-3
1999,Zaragoza,50046,Belmonte de Gracián,0,5,-5
1999,Zaragoza,50047,Berdejo,0,2,-2
1999,Zaragoza,50048,Berrueco,0,3,-3
1999,Zaragoza,50901,Biel,0,2,-2
1999,Zaragoza,50050,Bijuesca,1,4,-3
1999,Zaragoza,50051,Biota,9,26,-17
1999,Zaragoza,50052,Bisimbre,0,1,-1
1999,Zaragoza,50053,Boquiñeni,6,16,-10
1999,Zaragoza,50055,Borja,27,81,-54
1999,Zaragoza,50056,Botorrita,2,5,-3
1999,Zaragoza,50057,Brea de Aragón,13,16,-3
1999,Zaragoza,50058,Bubierca,0,3,-3
1999,Zaragoza,50059,Bujaraloz,6,15,-9
1999,Zaragoza,50060,Bulbuente,3,5,-2
1999,Zaragoza,50061,Bureta,0,8,-8
1999,Zaragoza,50062,Burgo de Ebro (El),7,17,-10
1999,Zaragoza,50063,Buste (El),0,1,-1
1999,Zaragoza,50043,Bárboles,1,8,-7
1999,Zaragoza,50064,Cabañas de Ebro,6,6,0
1999,Zaragoza,50065,Cabolafuente,0,1,-1
1999,Zaragoza,50066,Cadrete,14,16,-2
1999,Zaragoza,50067,Calatayud,142,209,-67
1999,Zaragoza,50068,Calatorao,25,29,-4
1999,Zaragoza,50069,Calcena,1,3,-2
1999,Zaragoza,50070,Calmarza,0,2,-2
1999,Zaragoza,50071,Campillo de Aragón,1,3,-2
1999,Zaragoza,50072,Carenas,0,3,-3
1999,Zaragoza,50073,Cariñena,20,25,-5
1999,Zaragoza,50074,Caspe,70,115,-45
1999,Zaragoza,50075,Castejón de Alarba,0,3,-3
1999,Zaragoza,50076,Castejón de las Armas,0,1,-1
1999,Zaragoza,50077,Castejón de Valdejasa,0,3,-3
1999,Zaragoza,50078,Castiliscar,3,4,-1
1999,Zaragoza,50079,Cervera de la Cañada,1,6,-5
1999,Zaragoza,50081,Cetina,4,8,-4
1999,Zaragoza,50092,Chiprana,4,6,-2
1999,Zaragoza,50093,Chodes,0,4,-4
1999,Zaragoza,50082,Cimballa,0,2,-2
1999,Zaragoza,50083,Cinco Olivas,0,1,-1
1999,Zaragoza,50084,Clarés de Ribota,0,1,-1
1999,Zaragoza,50085,Codo,1,5,-4
1999,Zaragoza,50086,Codos,1,5,-4
1999,Zaragoza,50087,Contamina,0,1,-1
1999,Zaragoza,50088,Cosuenda,0,7,-7
1999,Zaragoza,50089,Cuarte de Huerva,24,28,-4
1999,Zaragoza,50090,Cubel,0,3,-3
1999,Zaragoza,50091,Cuerlas (Las),0,2,-2
1999,Zaragoza,50094,Daroca,15,25,-10
1999,Zaragoza,50095,Ejea de los Caballeros,121,172,-51
1999,Zaragoza,50098,Encinacorba,3,4,-1
1999,Zaragoza,50100,Erla,2,5,-3
1999,Zaragoza,50101,Escatrón,4,21,-17
1999,Zaragoza,50102,Fabara,8,21,-13
1999,Zaragoza,50104,Farlete,3,7,-4
1999,Zaragoza,50106,Fayos (Los),0,2,-2
1999,Zaragoza,50105,Fayón,0,4,-4
1999,Zaragoza,50107,Figueruelas,10,10,0
1999,Zaragoza,50109,Frago (El),1,1,0
1999,Zaragoza,50110,Frasno (El),3,8,-5
1999,Zaragoza,50111,Fréscano,2,1,1
1999,Zaragoza,50113,Fuendejalón,5,14,-9
1999,Zaragoza,50114,Fuendetodos,0,4,-4
1999,Zaragoza,50115,Fuentes de Ebro,38,37,1
1999,Zaragoza,50116,Fuentes de Jiloca,4,3,1
1999,Zaragoza,50117,Gallocanta,0,4,-4
1999,Zaragoza,50118,Gallur,13,36,-23
1999,Zaragoza,50119,Gelsa,8,19,-11
1999,Zaragoza,50121,Gotor,5,5,0
1999,Zaragoza,50122,Grisel,0,1,-1
1999,Zaragoza,50123,Grisén,0,6,-6
1999,Zaragoza,50124,Herrera de los Navarros,6,15,-9
1999,Zaragoza,50125,Ibdes,3,8,-5
1999,Zaragoza,50126,Illueca,25,31,-6
1999,Zaragoza,50128,Isuerre,0,1,-1
1999,Zaragoza,50129,Jaraba,0,7,-7
1999,Zaragoza,50130,Jarque de Moncayo,4,13,-9
1999,Zaragoza,50131,Jaulín,1,4,-3
1999,Zaragoza,50132,Joyosa (La),3,8,-5
1999,Zaragoza,50133,Lagata,0,4,-4
1999,Zaragoza,50134,Langa del Castillo,0,1,-1
1999,Zaragoza,50135,Layana,0,1,-1
1999,Zaragoza,50137,Leciñena,6,18,-12
1999,Zaragoza,50139,Letux,2,5,-3
1999,Zaragoza,50141,Lituénigo,0,3,-3
1999,Zaragoza,50142,Lobera de Onsella,0,1,-1
1999,Zaragoza,50143,Longares,8,12,-4
1999,Zaragoza,50146,Lucena de Jalón,0,5,-5
1999,Zaragoza,50147,Luceni,2,11,-9
1999,Zaragoza,50148,Luesia,2,4,-2
1999,Zaragoza,50149,Luesma,0,0,0
1999,Zaragoza,50150,Lumpiaque,3,9,-6
1999,Zaragoza,50151,Luna,4,21,-17
1999,Zaragoza,50136,Lécera,6,12,-6
1999,Zaragoza,50152,Maella,14,26,-12
1999,Zaragoza,50153,Magallón,7,14,-7
1999,Zaragoza,50154,Mainar,0,3,-3
1999,Zaragoza,50155,Malanquilla,0,1,-1
1999,Zaragoza,50156,Maleján,1,7,-6
1999,Zaragoza,50160,Mallén,22,47,-25
1999,Zaragoza,50159,Maluenda,7,15,-8
1999,Zaragoza,50157,Malón,4,6,-2
1999,Zaragoza,50161,Manchones,1,2,-1
1999,Zaragoza,50162,Mara,2,4,-2
1999,Zaragoza,50902,Marracos,0,1,-1
1999,Zaragoza,50163,María de Huerva,9,25,-16
1999,Zaragoza,50164,Mediana de Aragón,2,8,-6
1999,Zaragoza,50165,Mequinenza,24,36,-12
1999,Zaragoza,50166,Mesones de Isuela,1,4,-3
1999,Zaragoza,50167,Mezalocha,0,5,-5
1999,Zaragoza,50168,Mianos,1,0,1
1999,Zaragoza,50169,Miedes de Aragón,2,6,-4
1999,Zaragoza,50170,Monegrillo,4,10,-6
1999,Zaragoza,50171,Moneva,0,1,-1
1999,Zaragoza,50172,Monreal de Ariza,2,3,-1
1999,Zaragoza,50173,Monterde,0,10,-10
1999,Zaragoza,50175,Morata de Jalón,5,26,-21
1999,Zaragoza,50176,Morata de Jiloca,0,9,-9
1999,Zaragoza,50178,Moros,3,9,-6
1999,Zaragoza,50177,Morés,1,9,-8
1999,Zaragoza,50179,Moyuela,0,6,-6
1999,Zaragoza,50181,Muel,6,13,-7
1999,Zaragoza,50182,Muela (La),11,9,2
1999,Zaragoza,50183,Munébrega,2,8,-6
1999,Zaragoza,50184,Murero,0,3,-3
1999,Zaragoza,50185,Murillo de Gállego,0,2,-2
1999,Zaragoza,50186,Navardún,0,1,-1
1999,Zaragoza,50187,Nigüella,0,2,-2
1999,Zaragoza,50188,Nombrevilla,0,1,-1
1999,Zaragoza,50189,Nonaspe,11,24,-13
1999,Zaragoza,50190,Novallas,3,12,-9
1999,Zaragoza,50191,Novillas,4,8,-4
1999,Zaragoza,50193,Nuez de Ebro,3,2,1
1999,Zaragoza,50192,Nuévalos,7,2,5
1999,Zaragoza,50194,Olvés,0,3,-3
1999,Zaragoza,50196,Orera,1,0,1
1999,Zaragoza,50197,Orés,0,2,-2
1999,Zaragoza,50199,Osera de Ebro,3,14,-11
1999,Zaragoza,50200,Paniza,2,17,-15
1999,Zaragoza,50201,Paracuellos de Jiloca,3,10,-7
1999,Zaragoza,50202,Paracuellos de la Ribera,0,4,-4
1999,Zaragoza,50203,Pastriz,5,13,-8
1999,Zaragoza,50204,Pedrola,26,36,-10
1999,Zaragoza,50205,Pedrosas (Las),0,1,-1
1999,Zaragoza,50206,Perdiguera,3,3,0
1999,Zaragoza,50207,Piedratajada,1,4,-3
1999,Zaragoza,50208,Pina de Ebro,26,27,-1
1999,Zaragoza,50209,Pinseque,23,50,-27
1999,Zaragoza,50210,Pintanos (Los),0,1,-1
1999,Zaragoza,50211,Plasencia de Jalón,2,6,-4
1999,Zaragoza,50212,Pleitas,0,2,-2
1999,Zaragoza,50213,Plenas,0,4,-4
1999,Zaragoza,50216,Pozuelo de Aragón,0,7,-7
1999,Zaragoza,50217,Pradilla de Ebro,0,8,-8
1999,Zaragoza,50218,Puebla de Albortón,0,2,-2
1999,Zaragoza,50219,Puebla de Alfindén (La),13,17,-4
1999,Zaragoza,50220,Puendeluna,0,1,-1
1999,Zaragoza,50222,Quinto,13,28,-15
1999,Zaragoza,50223,Remolinos,8,17,-9
1999,Zaragoza,50225,Ricla,23,24,-1
1999,Zaragoza,50227,Romanos,0,1,-1
1999,Zaragoza,50228,Rueda de Jalón,0,7,-7
1999,Zaragoza,50229,Ruesca,0,2,-2
1999,Zaragoza,50231,Salillas de Jalón,1,4,-3
1999,Zaragoza,50232,Salvatierra de Esca,4,1,3
1999,Zaragoza,50233,Samper del Salz,0,1,-1
1999,Zaragoza,50234,San Martín de la Virgen de Moncayo,2,5,-3
1999,Zaragoza,50235,San Mateo de Gállego,22,24,-2
1999,Zaragoza,50236,Santa Cruz de Grío,0,6,-6
1999,Zaragoza,50237,Santa Cruz de Moncayo,0,1,-1
1999,Zaragoza,50238,Santa Eulalia de Gállego,1,3,-2
1999,Zaragoza,50241,Saviñán,1,12,-11
1999,Zaragoza,50242,Sediles,1,2,-1
1999,Zaragoza,50243,Sestrica,3,10,-7
1999,Zaragoza,50244,Sierra de Luna,1,7,-6
1999,Zaragoza,50245,Sigüés,0,2,-2
1999,Zaragoza,50246,Sisamón,0,2,-2
1999,Zaragoza,50247,Sobradiel,3,11,-8
1999,Zaragoza,50248,Sos del Rey Católico,6,15,-9
1999,Zaragoza,50230,Sádaba,11,25,-14
1999,Zaragoza,50240,Sástago,2,19,-17
1999,Zaragoza,50249,Tabuenca,3,9,-6
1999,Zaragoza,50251,Tarazona,60,140,-80
1999,Zaragoza,50252,Tauste,61,96,-35
1999,Zaragoza,50253,Terrer,1,17,-16
1999,Zaragoza,50254,Tierga,4,5,-1
1999,Zaragoza,50255,Tobed,2,5,-3
1999,Zaragoza,50256,Torralba de los Frailes,0,1,-1
1999,Zaragoza,50257,Torralba de Ribota,0,2,-2
1999,Zaragoza,50259,Torrehermosa,0,1,-1
1999,Zaragoza,50260,Torrelapaja,2,1,1
1999,Zaragoza,50261,Torrellas,4,7,-3
1999,Zaragoza,50262,Torres de Berrellén,4,17,-13
1999,Zaragoza,50263,Torrijo de la Cañada,0,10,-10
1999,Zaragoza,50264,Tosos,1,4,-3
1999,Zaragoza,50265,Trasmoz,0,3,-3
1999,Zaragoza,50266,Trasobares,0,5,-5
1999,Zaragoza,50267,Uncastillo,5,11,-6
1999,Zaragoza,50269,Urrea de Jalón,0,8,-8
1999,Zaragoza,50270,Urriés,0,2,-2
1999,Zaragoza,50271,Used,1,5,-4
1999,Zaragoza,50272,Utebo,131,57,74
1999,Zaragoza,50275,Valmadrid,0,3,-3
1999,Zaragoza,50276,Valpalmas,2,4,-2
1999,Zaragoza,50278,Velilla de Ebro,1,4,-3
1999,Zaragoza,50279,Velilla de Jiloca,1,0,1
1999,Zaragoza,50280,Vera de Moncayo,1,9,-8
1999,Zaragoza,50281,Vierlas,2,1,1
1999,Zaragoza,50283,Villadoz,0,2,-2
1999,Zaragoza,50284,Villafeliche,0,5,-5
1999,Zaragoza,50285,Villafranca de Ebro,5,8,-3
1999,Zaragoza,50286,Villalba de Perejil,0,2,-2
1999,Zaragoza,50287,Villalengua,2,7,-5
1999,Zaragoza,50288,Villanueva de Gállego,35,32,3
1999,Zaragoza,50290,Villanueva de Huerva,2,6,-4
1999,Zaragoza,50289,Villanueva de Jiloca,0,1,-1
1999,Zaragoza,50291,Villar de los Navarros,0,4,-4
1999,Zaragoza,50292,Villarreal de Huerva,0,2,-2
1999,Zaragoza,50293,Villarroya de la Sierra,2,8,-6
1999,Zaragoza,50282,Vilueña (La),0,4,-4
1999,Zaragoza,50295,Vistabella,0,1,-1
1999,Zaragoza,50296,Zaida (La),1,7,-6
1999,Zaragoza,50297,Zaragoza,5296,5892,-596
1999,Zaragoza,50298,Zuera,54,58,-4
1999,Zaragoza,50099,Épila,54,58,-4
1998,Zaragoza,50001,Abanto,0,5,-5
1998,Zaragoza,50002,Acered,0,5,-5
1998,Zaragoza,50004,Aguarón,3,6,-3
1998,Zaragoza,50005,Aguilón,1,1,0
1998,Zaragoza,50003,Agón,2,4,-2
1998,Zaragoza,50006,Ainzón,10,15,-5
1998,Zaragoza,50007,Aladrén,0,2,-2
1998,Zaragoza,50008,Alagón,34,60,-26
1998,Zaragoza,50009,Alarba,0,1,-1
1998,Zaragoza,50010,Alberite de San Juan,1,6,-5
1998,Zaragoza,50011,Albeta,0,2,-2
1998,Zaragoza,50012,Alborge,1,1,0
1998,Zaragoza,50013,Alcalá de Ebro,1,4,-3
1998,Zaragoza,50014,Alcalá de Moncayo,1,4,-3
1998,Zaragoza,50015,Alconchel de Ariza,0,6,-6
1998,Zaragoza,50016,Aldehuela de Liestos,0,1,-1
1998,Zaragoza,50017,Alfajarín,11,16,-5
1998,Zaragoza,50018,Alfamén,6,17,-11
1998,Zaragoza,50019,Alforque,0,2,-2
1998,Zaragoza,50020,Alhama de Aragón,6,19,-13
1998,Zaragoza,50022,Almolda (La),6,10,-4
1998,Zaragoza,50023,Almonacid de la Cuba,2,4,-2
1998,Zaragoza,50024,Almonacid de la Sierra,2,16,-14
1998,Zaragoza,50025,Almunia de Doña Godina (La),57,40,17
1998,Zaragoza,50026,Alpartir,3,7,-4
1998,Zaragoza,50027,Ambel,3,5,-2
1998,Zaragoza,50028,Anento,0,0,0
1998,Zaragoza,50029,Aniñón,8,7,1
1998,Zaragoza,50031,Aranda de Moncayo,1,3,-2
1998,Zaragoza,50033,Ardisa,0,3,-3
1998,Zaragoza,50034,Ariza,6,10,-4
1998,Zaragoza,50035,Artieda,0,1,-1
1998,Zaragoza,50032,Arándiga,1,10,-9
1998,Zaragoza,50036,Asín,1,0,1
1998,Zaragoza,50037,Atea,2,3,-1
1998,Zaragoza,50038,Ateca,15,22,-7
1998,Zaragoza,50039,Azuara,1,16,-15
1998,Zaragoza,50030,Añón de Moncayo,1,2,-1
1998,Zaragoza,50040,Badules,1,2,-1
1998,Zaragoza,50044,Bardallur,0,4,-4
1998,Zaragoza,50045,Belchite,15,24,-9
1998,Zaragoza,50046,Belmonte de Gracián,1,7,-6
1998,Zaragoza,50901,Biel,0,7,-7
1998,Zaragoza,50050,Bijuesca,0,2,-2
1998,Zaragoza,50051,Biota,5,18,-13
1998,Zaragoza,50052,Bisimbre,0,2,-2
1998,Zaragoza,50053,Boquiñeni,8,20,-12
1998,Zaragoza,50055,Borja,37,80,-43
1998,Zaragoza,50056,Botorrita,2,3,-1
1998,Zaragoza,50057,Brea de Aragón,25,17,8
1998,Zaragoza,50058,Bubierca,0,1,-1
1998,Zaragoza,50059,Bujaraloz,8,10,-2
1998,Zaragoza,50060,Bulbuente,0,4,-4
1998,Zaragoza,50061,Bureta,1,8,-7
1998,Zaragoza,50062,Burgo de Ebro (El),10,18,-8
1998,Zaragoza,50063,Buste (El),0,1,-1
1998,Zaragoza,50043,Bárboles,1,7,-6
1998,Zaragoza,50064,Cabañas de Ebro,3,5,-2
1998,Zaragoza,50065,Cabolafuente,0,2,-2
1998,Zaragoza,50066,Cadrete,11,7,4
1998,Zaragoza,50067,Calatayud,150,249,-99
1998,Zaragoza,50068,Calatorao,13,25,-12
1998,Zaragoza,50069,Calcena,0,1,-1
1998,Zaragoza,50070,Calmarza,0,3,-3
1998,Zaragoza,50071,Campillo de Aragón,0,1,-1
1998,Zaragoza,50072,Carenas,0,4,-4
1998,Zaragoza,50073,Cariñena,26,26,0
1998,Zaragoza,50074,Caspe,62,129,-67
1998,Zaragoza,50075,Castejón de Alarba,0,4,-4
1998,Zaragoza,50076,Castejón de las Armas,0,5,-5
1998,Zaragoza,50077,Castejón de Valdejasa,0,2,-2
1998,Zaragoza,50078,Castiliscar,2,5,-3
1998,Zaragoza,50079,Cervera de la Cañada,1,5,-4
1998,Zaragoza,50081,Cetina,5,9,-4
1998,Zaragoza,50092,Chiprana,2,5,-3
1998,Zaragoza,50093,Chodes,1,3,-2
1998,Zaragoza,50082,Cimballa,2,3,-1
1998,Zaragoza,50083,Cinco Olivas,0,4,-4
1998,Zaragoza,50085,Codo,2,5,-3
1998,Zaragoza,50086,Codos,0,4,-4
1998,Zaragoza,50087,Contamina,0,2,-2
1998,Zaragoza,50088,Cosuenda,0,7,-7
1998,Zaragoza,50089,Cuarte de Huerva,14,34,-20
1998,Zaragoza,50090,Cubel,0,1,-1
1998,Zaragoza,50091,Cuerlas (Las),0,3,-3
1998,Zaragoza,50094,Daroca,7,29,-22
1998,Zaragoza,50095,Ejea de los Caballeros,133,154,-21
1998,Zaragoza,50098,Encinacorba,0,3,-3
1998,Zaragoza,50100,Erla,0,4,-4
1998,Zaragoza,50101,Escatrón,8,25,-17
1998,Zaragoza,50102,Fabara,7,15,-8
1998,Zaragoza,50104,Farlete,2,3,-1
1998,Zaragoza,50106,Fayos (Los),1,3,-2
1998,Zaragoza,50105,Fayón,1,11,-10
1998,Zaragoza,50107,Figueruelas,9,14,-5
1998,Zaragoza,50108,Fombuena,0,1,-1
1998,Zaragoza,50109,Frago (El),0,2,-2
1998,Zaragoza,50110,Frasno (El),3,8,-5
1998,Zaragoza,50111,Fréscano,0,3,-3
1998,Zaragoza,50113,Fuendejalón,5,19,-14
1998,Zaragoza,50114,Fuendetodos,1,0,1
1998,Zaragoza,50115,Fuentes de Ebro,30,40,-10
1998,Zaragoza,50116,Fuentes de Jiloca,2,6,-4
1998,Zaragoza,50117,Gallocanta,0,2,-2
1998,Zaragoza,50118,Gallur,20,30,-10
1998,Zaragoza,50119,Gelsa,5,20,-15
1998,Zaragoza,50120,Godojos,0,1,-1
1998,Zaragoza,50121,Gotor,2,3,-1
1998,Zaragoza,50123,Grisén,1,6,-5
1998,Zaragoza,50124,Herrera de los Navarros,4,10,-6
1998,Zaragoza,50125,Ibdes,4,14,-10
1998,Zaragoza,50126,Illueca,47,30,17
1998,Zaragoza,50128,Isuerre,0,1,-1
1998,Zaragoza,50129,Jaraba,8,6,2
1998,Zaragoza,50130,Jarque de Moncayo,6,6,0
1998,Zaragoza,50131,Jaulín,2,6,-4
1998,Zaragoza,50132,Joyosa (La),3,9,-6
1998,Zaragoza,50134,Langa del Castillo,0,3,-3
1998,Zaragoza,50135,Layana,0,2,-2
1998,Zaragoza,50137,Leciñena,5,15,-10
1998,Zaragoza,50139,Letux,2,7,-5
1998,Zaragoza,50140,Litago,0,2,-2
1998,Zaragoza,50142,Lobera de Onsella,0,1,-1
1998,Zaragoza,50143,Longares,7,15,-8
1998,Zaragoza,50144,Longás,1,0,1
1998,Zaragoza,50146,Lucena de Jalón,0,6,-6
1998,Zaragoza,50147,Luceni,7,15,-8
1998,Zaragoza,50148,Luesia,3,13,-10
1998,Zaragoza,50150,Lumpiaque,6,12,-6
1998,Zaragoza,50151,Luna,4,18,-14
1998,Zaragoza,50136,Lécera,7,13,-6
1998,Zaragoza,50152,Maella,16,31,-15
1998,Zaragoza,50153,Magallón,8,14,-6
1998,Zaragoza,50154,Mainar,2,4,-2
1998,Zaragoza,50155,Malanquilla,0,2,-2
1998,Zaragoza,50156,Maleján,3,7,-4
1998,Zaragoza,50160,Mallén,27,37,-10
1998,Zaragoza,50159,Maluenda,7,21,-14
1998,Zaragoza,50157,Malón,3,6,-3
1998,Zaragoza,50161,Manchones,1,2,-1
1998,Zaragoza,50162,Mara,0,4,-4
1998,Zaragoza,50163,María de Huerva,9,26,-17
1998,Zaragoza,50164,Mediana de Aragón,2,5,-3
1998,Zaragoza,50165,Mequinenza,24,33,-9
1998,Zaragoza,50166,Mesones de Isuela,2,6,-4
1998,Zaragoza,50167,Mezalocha,1,3,-2
1998,Zaragoza,50168,Mianos,0,0,0
1998,Zaragoza,50169,Miedes de Aragón,1,2,-1
1998,Zaragoza,50170,Monegrillo,2,6,-4
1998,Zaragoza,50172,Monreal de Ariza,0,3,-3
1998,Zaragoza,50173,Monterde,2,4,-2
1998,Zaragoza,50174,Montón,0,1,-1
1998,Zaragoza,50175,Morata de Jalón,6,26,-20
1998,Zaragoza,50176,Morata de Jiloca,2,3,-1
1998,Zaragoza,50178,Moros,6,9,-3
1998,Zaragoza,50177,Morés,0,5,-5
1998,Zaragoza,50179,Moyuela,2,4,-2
1998,Zaragoza,50180,Mozota,2,0,2
1998,Zaragoza,50181,Muel,3,20,-17
1998,Zaragoza,50182,Muela (La),11,19,-8
1998,Zaragoza,50183,Munébrega,1,5,-4
1998,Zaragoza,50184,Murero,1,1,0
1998,Zaragoza,50185,Murillo de Gállego,0,1,-1
1998,Zaragoza,50187,Nigüella,0,4,-4
1998,Zaragoza,50189,Nonaspe,10,15,-5
1998,Zaragoza,50190,Novallas,2,12,-10
1998,Zaragoza,50191,Novillas,4,8,-4
1998,Zaragoza,50193,Nuez de Ebro,6,6,0
1998,Zaragoza,50192,Nuévalos,4,5,-1
1998,Zaragoza,50194,Olvés,0,1,-1
1998,Zaragoza,50196,Orera,0,2,-2
1998,Zaragoza,50197,Orés,0,1,-1
1998,Zaragoza,50198,Oseja,1,1,0
1998,Zaragoza,50199,Osera de Ebro,1,10,-9
1998,Zaragoza,50200,Paniza,4,7,-3
1998,Zaragoza,50201,Paracuellos de Jiloca,3,8,-5
1998,Zaragoza,50202,Paracuellos de la Ribera,0,6,-6
1998,Zaragoza,50203,Pastriz,4,10,-6
1998,Zaragoza,50204,Pedrola,19,38,-19
1998,Zaragoza,50205,Pedrosas (Las),0,1,-1
1998,Zaragoza,50206,Perdiguera,0,4,-4
1998,Zaragoza,50207,Piedratajada,2,2,0
1998,Zaragoza,50208,Pina de Ebro,16,24,-8
1998,Zaragoza,50209,Pinseque,8,44,-36
1998,Zaragoza,50210,Pintanos (Los),0,1,-1
1998,Zaragoza,50211,Plasencia de Jalón,1,3,-2
1998,Zaragoza,50212,Pleitas,0,4,-4
1998,Zaragoza,50213,Plenas,0,1,-1
1998,Zaragoza,50216,Pozuelo de Aragón,3,5,-2
1998,Zaragoza,50217,Pradilla de Ebro,1,12,-11
1998,Zaragoza,50218,Puebla de Albortón,0,3,-3
1998,Zaragoza,50219,Puebla de Alfindén (La),16,5,11
1998,Zaragoza,50222,Quinto,9,30,-21
1998,Zaragoza,50223,Remolinos,13,22,-9
1998,Zaragoza,50224,Retascón,0,1,-1
1998,Zaragoza,50225,Ricla,15,24,-9
1998,Zaragoza,50227,Romanos,0,1,-1
1998,Zaragoza,50228,Rueda de Jalón,6,6,0
1998,Zaragoza,50229,Ruesca,1,1,0
1998,Zaragoza,50231,Salillas de Jalón,1,4,-3
1998,Zaragoza,50232,Salvatierra de Esca,2,5,-3
1998,Zaragoza,50233,Samper del Salz,0,1,-1
1998,Zaragoza,50234,San Martín de la Virgen de Moncayo,2,5,-3
1998,Zaragoza,50235,San Mateo de Gállego,18,16,2
1998,Zaragoza,50236,Santa Cruz de Grío,5,3,2
1998,Zaragoza,50237,Santa Cruz de Moncayo,1,1,0
1998,Zaragoza,50238,Santa Eulalia de Gállego,0,1,-1
1998,Zaragoza,50239,Santed,0,1,-1
1998,Zaragoza,50241,Saviñán,2,16,-14
1998,Zaragoza,50242,Sediles,0,4,-4
1998,Zaragoza,50243,Sestrica,2,13,-11
1998,Zaragoza,50244,Sierra de Luna,1,5,-4
1998,Zaragoza,50245,Sigüés,0,3,-3
1998,Zaragoza,50246,Sisamón,0,1,-1
1998,Zaragoza,50247,Sobradiel,2,7,-5
1998,Zaragoza,50248,Sos del Rey Católico,2,11,-9
1998,Zaragoza,50230,Sádaba,15,23,-8
1998,Zaragoza,50240,Sástago,5,19,-14
1998,Zaragoza,50249,Tabuenca,1,7,-6
1998,Zaragoza,50250,Talamantes,0,2,-2
1998,Zaragoza,50251,Tarazona,67,123,-56
1998,Zaragoza,50252,Tauste,45,63,-18
1998,Zaragoza,50253,Terrer,3,9,-6
1998,Zaragoza,50254,Tierga,0,1,-1
1998,Zaragoza,50255,Tobed,1,5,-4
1998,Zaragoza,50256,Torralba de los Frailes,0,1,-1
1998,Zaragoza,50257,Torralba de Ribota,0,5,-5
1998,Zaragoza,50258,Torralbilla,0,2,-2
1998,Zaragoza,50259,Torrehermosa,0,2,-2
1998,Zaragoza,50260,Torrelapaja,0,1,-1
1998,Zaragoza,50261,Torrellas,0,3,-3
1998,Zaragoza,50262,Torres de Berrellén,8,16,-8
1998,Zaragoza,50263,Torrijo de la Cañada,0,8,-8
1998,Zaragoza,50264,Tosos,1,4,-3
1998,Zaragoza,50265,Trasmoz,0,2,-2
1998,Zaragoza,50266,Trasobares,0,4,-4
1998,Zaragoza,50267,Uncastillo,4,10,-6
1998,Zaragoza,50269,Urrea de Jalón,0,4,-4
1998,Zaragoza,50270,Urriés,0,0,0
1998,Zaragoza,50271,Used,2,5,-3
1998,Zaragoza,50272,Utebo,89,68,21
1998,Zaragoza,50274,Val de San Martín,0,1,-1
1998,Zaragoza,50275,Valmadrid,0,2,-2
1998,Zaragoza,50276,Valpalmas,1,1,0
1998,Zaragoza,50278,Velilla de Ebro,1,8,-7
1998,Zaragoza,50279,Velilla de Jiloca,1,1,0
1998,Zaragoza,50280,Vera de Moncayo,1,13,-12
1998,Zaragoza,50283,Villadoz,1,1,0
1998,Zaragoza,50284,Villafeliche,1,1,0
1998,Zaragoza,50285,Villafranca de Ebro,4,6,-2
1998,Zaragoza,50286,Villalba de Perejil,0,2,-2
1998,Zaragoza,50287,Villalengua,2,5,-3
1998,Zaragoza,50288,Villanueva de Gállego,20,30,-10
1998,Zaragoza,50290,Villanueva de Huerva,1,8,-7
1998,Zaragoza,50289,Villanueva de Jiloca,0,3,-3
1998,Zaragoza,50292,Villarreal de Huerva,2,3,-1
1998,Zaragoza,50293,Villarroya de la Sierra,1,18,-17
1998,Zaragoza,50294,Villarroya del Campo,0,2,-2
1998,Zaragoza,50282,Vilueña (La),0,2,-2
1998,Zaragoza,50296,Zaida (La),4,7,-3
1998,Zaragoza,50297,Zaragoza,4965,5653,-688
1998,Zaragoza,50298,Zuera,45,62,-17
1998,Zaragoza,50099,Épila,30,71,-41
1997,Zaragoza,50001,Abanto,0,3,-3
1997,Zaragoza,50002,Acered,1,6,-5
1997,Zaragoza,50004,Aguarón,3,8,-5
1997,Zaragoza,50005,Aguilón,0,4,-4
1997,Zaragoza,50003,Agón,0,1,-1
1997,Zaragoza,50006,Ainzón,14,6,8
1997,Zaragoza,50007,Aladrén,0,2,-2
1997,Zaragoza,50008,Alagón,35,67,-32
1997,Zaragoza,50009,Alarba,1,0,1
1997,Zaragoza,50010,Alberite de San Juan,0,2,-2
1997,Zaragoza,50011,Albeta,0,5,-5
1997,Zaragoza,50012,Alborge,2,0,2
1997,Zaragoza,50013,Alcalá de Ebro,2,5,-3
1997,Zaragoza,50014,Alcalá de Moncayo,0,1,-1
1997,Zaragoza,50015,Alconchel de Ariza,0,1,-1
1997,Zaragoza,50016,Aldehuela de Liestos,0,3,-3
1997,Zaragoza,50017,Alfajarín,18,19,-1
1997,Zaragoza,50018,Alfamén,8,11,-3
1997,Zaragoza,50019,Alforque,0,2,-2
1997,Zaragoza,50020,Alhama de Aragón,10,14,-4
1997,Zaragoza,50021,Almochuel,0,2,-2
1997,Zaragoza,50022,Almolda (La),4,9,-5
1997,Zaragoza,50023,Almonacid de la Cuba,1,2,-1
1997,Zaragoza,50024,Almonacid de la Sierra,5,17,-12
1997,Zaragoza,50025,Almunia de Doña Godina (La),46,52,-6
1997,Zaragoza,50026,Alpartir,5,8,-3
1997,Zaragoza,50027,Ambel,0,6,-6
1997,Zaragoza,50029,Aniñón,5,13,-8
1997,Zaragoza,50031,Aranda de Moncayo,1,2,-1
1997,Zaragoza,50034,Ariza,6,16,-10
1997,Zaragoza,50035,Artieda,0,1,-1
1997,Zaragoza,50032,Arándiga,1,8,-7
1997,Zaragoza,50036,Asín,0,3,-3
1997,Zaragoza,50037,Atea,1,5,-4
1997,Zaragoza,50038,Ateca,6,23,-17
1997,Zaragoza,50039,Azuara,3,7,-4
1997,Zaragoza,50040,Badules,0,2,-2
1997,Zaragoza,50042,Balconchán,0,1,-1
1997,Zaragoza,50044,Bardallur,2,4,-2
1997,Zaragoza,50045,Belchite,16,25,-9
1997,Zaragoza,50046,Belmonte de Gracián,0,7,-7
1997,Zaragoza,50050,Bijuesca,1,2,-1
1997,Zaragoza,50051,Biota,16,12,4
1997,Zaragoza,50052,Bisimbre,0,2,-2
1997,Zaragoza,50053,Boquiñeni,3,17,-14
1997,Zaragoza,50055,Borja,39,63,-24
1997,Zaragoza,50056,Botorrita,1,1,0
1997,Zaragoza,50057,Brea de Aragón,13,18,-5
1997,Zaragoza,50058,Bubierca,0,4,-4
1997,Zaragoza,50059,Bujaraloz,13,14,-1
1997,Zaragoza,50060,Bulbuente,2,7,-5
1997,Zaragoza,50061,Bureta,3,6,-3
1997,Zaragoza,50062,Burgo de Ebro (El),16,14,2
1997,Zaragoza,50063,Buste (El),0,2,-2
1997,Zaragoza,50043,Bárboles,2,9,-7
1997,Zaragoza,50064,Cabañas de Ebro,4,5,-1
1997,Zaragoza,50065,Cabolafuente,0,0,0
1997,Zaragoza,50066,Cadrete,11,11,0
1997,Zaragoza,50067,Calatayud,142,207,-65
1997,Zaragoza,50068,Calatorao,17,28,-11
1997,Zaragoza,50069,Calcena,0,1,-1
1997,Zaragoza,50070,Calmarza,0,1,-1
1997,Zaragoza,50071,Campillo de Aragón,3,4,-1
1997,Zaragoza,50072,Carenas,0,5,-5
1997,Zaragoza,50073,Cariñena,20,26,-6
1997,Zaragoza,50074,Caspe,74,115,-41
1997,Zaragoza,50075,Castejón de Alarba,0,1,-1
1997,Zaragoza,50076,Castejón de las Armas,0,4,-4
1997,Zaragoza,50077,Castejón de Valdejasa,0,2,-2
1997,Zaragoza,50078,Castiliscar,0,7,-7
1997,Zaragoza,50079,Cervera de la Cañada,1,4,-3
1997,Zaragoza,50081,Cetina,3,15,-12
1997,Zaragoza,50092,Chiprana,1,7,-6
1997,Zaragoza,50093,Chodes,0,7,-7
1997,Zaragoza,50082,Cimballa,0,2,-2
1997,Zaragoza,50083,Cinco Olivas,0,3,-3
1997,Zaragoza,50084,Clarés de Ribota,1,1,0
1997,Zaragoza,50085,Codo,1,5,-4
1997,Zaragoza,50086,Codos,4,8,-4
1997,Zaragoza,50087,Contamina,0,1,-1
1997,Zaragoza,50088,Cosuenda,0,8,-8
1997,Zaragoza,50089,Cuarte de Huerva,12,27,-15
1997,Zaragoza,50090,Cubel,3,2,1
1997,Zaragoza,50091,Cuerlas (Las),0,1,-1
1997,Zaragoza,50094,Daroca,21,24,-3
1997,Zaragoza,50095,Ejea de los Caballeros,117,147,-30
1997,Zaragoza,50096,Embid de Ariza,0,1,-1
1997,Zaragoza,50098,Encinacorba,2,6,-4
1997,Zaragoza,50100,Erla,5,5,0
1997,Zaragoza,50101,Escatrón,8,16,-8
1997,Zaragoza,50102,Fabara,4,10,-6
1997,Zaragoza,50104,Farlete,3,1,2
1997,Zaragoza,50106,Fayos (Los),1,7,-6
1997,Zaragoza,50105,Fayón,2,4,-2
1997,Zaragoza,50107,Figueruelas,9,6,3
1997,Zaragoza,50109,Frago (El),0,1,-1
1997,Zaragoza,50110,Frasno (El),3,9,-6
1997,Zaragoza,50111,Fréscano,2,5,-3
1997,Zaragoza,50113,Fuendejalón,14,10,4
1997,Zaragoza,50114,Fuendetodos,1,2,-1
1997,Zaragoza,50115,Fuentes de Ebro,26,34,-8
1997,Zaragoza,50116,Fuentes de Jiloca,1,8,-7
1997,Zaragoza,50117,Gallocanta,0,4,-4
1997,Zaragoza,50118,Gallur,16,25,-9
1997,Zaragoza,50119,Gelsa,2,19,-17
1997,Zaragoza,50120,Godojos,0,3,-3
1997,Zaragoza,50121,Gotor,2,4,-2
1997,Zaragoza,50122,Grisel,0,1,-1
1997,Zaragoza,50123,Grisén,1,4,-3
1997,Zaragoza,50124,Herrera de los Navarros,3,4,-1
1997,Zaragoza,50125,Ibdes,4,8,-4
1997,Zaragoza,50126,Illueca,31,24,7
1997,Zaragoza,50128,Isuerre,1,1,0
1997,Zaragoza,50129,Jaraba,0,7,-7
1997,Zaragoza,50130,Jarque de Moncayo,4,7,-3
1997,Zaragoza,50131,Jaulín,1,4,-3
1997,Zaragoza,50132,Joyosa (La),1,7,-6
1997,Zaragoza,50133,Lagata,0,1,-1
1997,Zaragoza,50134,Langa del Castillo,1,0,1
1997,Zaragoza,50135,Layana,2,3,-1
1997,Zaragoza,50137,Leciñena,5,11,-6
1997,Zaragoza,50139,Letux,2,3,-1
1997,Zaragoza,50140,Litago,0,3,-3
1997,Zaragoza,50141,Lituénigo,0,1,-1
1997,Zaragoza,50143,Longares,4,17,-13
1997,Zaragoza,50144,Longás,0,1,-1
1997,Zaragoza,50146,Lucena de Jalón,0,1,-1
1997,Zaragoza,50147,Luceni,3,14,-11
1997,Zaragoza,50148,Luesia,2,6,-4
1997,Zaragoza,50150,Lumpiaque,8,21,-13
1997,Zaragoza,50151,Luna,9,13,-4
1997,Zaragoza,50136,Lécera,7,10,-3
1997,Zaragoza,50152,Maella,10,28,-18
1997,Zaragoza,50153,Magallón,3,18,-15
1997,Zaragoza,50154,Mainar,3,2,1
1997,Zaragoza,50155,Malanquilla,0,3,-3
1997,Zaragoza,50156,Maleján,2,6,-4
1997,Zaragoza,50160,Mallén,25,43,-18
1997,Zaragoza,50159,Maluenda,8,25,-17
1997,Zaragoza,50157,Malón,2,8,-6
1997,Zaragoza,50161,Manchones,2,2,0
1997,Zaragoza,50162,Mara,1,0,1
1997,Zaragoza,50163,María de Huerva,4,26,-22
1997,Zaragoza,50164,Mediana de Aragón,4,9,-5
1997,Zaragoza,50165,Mequinenza,19,31,-12
1997,Zaragoza,50166,Mesones de Isuela,3,3,0
1997,Zaragoza,50167,Mezalocha,1,5,-4
1997,Zaragoza,50169,Miedes de Aragón,1,3,-2
1997,Zaragoza,50170,Monegrillo,2,4,-2
1997,Zaragoza,50171,Moneva,0,4,-4
1997,Zaragoza,50172,Monreal de Ariza,0,6,-6
1997,Zaragoza,50173,Monterde,1,3,-2
1997,Zaragoza,50175,Morata de Jalón,7,17,-10
1997,Zaragoza,50176,Morata de Jiloca,1,5,-4
1997,Zaragoza,50178,Moros,8,12,-4
1997,Zaragoza,50177,Morés,5,1,4
1997,Zaragoza,50179,Moyuela,0,6,-6
1997,Zaragoza,50180,Mozota,0,2,-2
1997,Zaragoza,50181,Muel,6,13,-7
1997,Zaragoza,50182,Muela (La),4,11,-7
1997,Zaragoza,50183,Munébrega,1,7,-6
1997,Zaragoza,50184,Murero,0,4,-4
1997,Zaragoza,50185,Murillo de Gállego,0,1,-1
1997,Zaragoza,50186,Navardún,1,1,0
1997,Zaragoza,50187,Nigüella,0,2,-2
1997,Zaragoza,50188,Nombrevilla,0,1,-1
1997,Zaragoza,50189,Nonaspe,6,23,-17
1997,Zaragoza,50190,Novallas,5,10,-5
1997,Zaragoza,50191,Novillas,4,9,-5
1997,Zaragoza,50193,Nuez de Ebro,6,7,-1
1997,Zaragoza,50192,Nuévalos,3,3,0
1997,Zaragoza,50194,Olvés,0,1,-1
1997,Zaragoza,50196,Orera,1,2,-1
1997,Zaragoza,50197,Orés,0,2,-2
1997,Zaragoza,50199,Osera de Ebro,0,5,-5
1997,Zaragoza,50200,Paniza,2,8,-6
1997,Zaragoza,50201,Paracuellos de Jiloca,1,7,-6
1997,Zaragoza,50202,Paracuellos de la Ribera,1,3,-2
1997,Zaragoza,50203,Pastriz,8,10,-2
1997,Zaragoza,50204,Pedrola,13,33,-20
1997,Zaragoza,50205,Pedrosas (Las),1,0,1
1997,Zaragoza,50206,Perdiguera,5,5,0
1997,Zaragoza,50207,Piedratajada,1,3,-2
1997,Zaragoza,50208,Pina de Ebro,19,24,-5
1997,Zaragoza,50209,Pinseque,9,44,-35
1997,Zaragoza,50210,Pintanos (Los),0,1,-1
1997,Zaragoza,50211,Plasencia de Jalón,2,3,-1
1997,Zaragoza,50213,Plenas,0,1,-1
1997,Zaragoza,50215,Pozuel de Ariza,0,1,-1
1997,Zaragoza,50216,Pozuelo de Aragón,1,2,-1
1997,Zaragoza,50217,Pradilla de Ebro,5,6,-1
1997,Zaragoza,50218,Puebla de Albortón,1,4,-3
1997,Zaragoza,50219,Puebla de Alfindén (La),11,15,-4
1997,Zaragoza,50222,Quinto,11,22,-11
1997,Zaragoza,50223,Remolinos,5,11,-6
1997,Zaragoza,50225,Ricla,8,27,-19
1997,Zaragoza,50227,Romanos,0,4,-4
1997,Zaragoza,50228,Rueda de Jalón,2,4,-2
1997,Zaragoza,50229,Ruesca,1,0,1
1997,Zaragoza,50231,Salillas de Jalón,1,5,-4
1997,Zaragoza,50232,Salvatierra de Esca,1,4,-3
1997,Zaragoza,50233,Samper del Salz,0,1,-1
1997,Zaragoza,50234,San Martín de la Virgen de Moncayo,0,4,-4
1997,Zaragoza,50235,San Mateo de Gállego,13,28,-15
1997,Zaragoza,50236,Santa Cruz de Grío,0,2,-2
1997,Zaragoza,50237,Santa Cruz de Moncayo,3,0,3
1997,Zaragoza,50238,Santa Eulalia de Gállego,0,2,-2
1997,Zaragoza,50239,Santed,0,1,-1
1997,Zaragoza,50241,Saviñán,0,6,-6
1997,Zaragoza,50242,Sediles,0,1,-1
1997,Zaragoza,50243,Sestrica,3,6,-3
1997,Zaragoza,50244,Sierra de Luna,1,7,-6
1997,Zaragoza,50245,Sigüés,0,3,-3
1997,Zaragoza,50246,Sisamón,0,4,-4
1997,Zaragoza,50247,Sobradiel,1,7,-6
1997,Zaragoza,50248,Sos del Rey Católico,8,10,-2
1997,Zaragoza,50230,Sádaba,13,30,-17
1997,Zaragoza,50240,Sástago,8,27,-19
1997,Zaragoza,50249,Tabuenca,1,9,-8
1997,Zaragoza,50250,Talamantes,1,1,0
1997,Zaragoza,50251,Tarazona,85,112,-27
1997,Zaragoza,50252,Tauste,59,74,-15
1997,Zaragoza,50253,Terrer,1,9,-8
1997,Zaragoza,50254,Tierga,1,2,-1
1997,Zaragoza,50255,Tobed,0,5,-5
1997,Zaragoza,50256,Torralba de los Frailes,0,1,-1
1997,Zaragoza,50257,Torralba de Ribota,0,7,-7
1997,Zaragoza,50258,Torralbilla,0,1,-1
1997,Zaragoza,50259,Torrehermosa,1,4,-3
1997,Zaragoza,50260,Torrelapaja,0,1,-1
1997,Zaragoza,50261,Torrellas,1,5,-4
1997,Zaragoza,50262,Torres de Berrellén,11,16,-5
1997,Zaragoza,50263,Torrijo de la Cañada,0,8,-8
1997,Zaragoza,50264,Tosos,1,6,-5
1997,Zaragoza,50266,Trasobares,2,6,-4
1997,Zaragoza,50267,Uncastillo,3,22,-19
1997,Zaragoza,50269,Urrea de Jalón,1,2,-1
1997,Zaragoza,50270,Urriés,0,1,-1
1997,Zaragoza,50271,Used,4,5,-1
1997,Zaragoza,50272,Utebo,101,64,37
1997,Zaragoza,50274,Val de San Martín,0,1,-1
1997,Zaragoza,50273,Valdehorna,0,1,-1
1997,Zaragoza,50275,Valmadrid,0,1,-1
1997,Zaragoza,50276,Valpalmas,0,3,-3
1997,Zaragoza,50277,Valtorres,0,4,-4
1997,Zaragoza,50278,Velilla de Ebro,2,6,-4
1997,Zaragoza,50279,Velilla de Jiloca,0,1,-1
1997,Zaragoza,50280,Vera de Moncayo,3,7,-4
1997,Zaragoza,50281,Vierlas,0,1,-1
1997,Zaragoza,50284,Villafeliche,0,2,-2
1997,Zaragoza,50285,Villafranca de Ebro,5,7,-2
1997,Zaragoza,50286,Villalba de Perejil,0,1,-1
1997,Zaragoza,50287,Villalengua,2,11,-9
1997,Zaragoza,50288,Villanueva de Gállego,28,34,-6
1997,Zaragoza,50290,Villanueva de Huerva,6,10,-4
1997,Zaragoza,50289,Villanueva de Jiloca,0,3,-3
1997,Zaragoza,50291,Villar de los Navarros,0,2,-2
1997,Zaragoza,50292,Villarreal de Huerva,2,1,1
1997,Zaragoza,50293,Villarroya de la Sierra,5,13,-8
1997,Zaragoza,50282,Vilueña (La),0,4,-4
1997,Zaragoza,50296,Zaida (La),5,10,-5
1997,Zaragoza,50297,Zaragoza,5114,5557,-443
1997,Zaragoza,50298,Zuera,42,60,-18
1997,Zaragoza,50099,Épila,39,54,-15
1996,Zaragoza,50001,Abanto,0,1,-1
1996,Zaragoza,50002,Acered,0,5,-5
1996,Zaragoza,50004,Aguarón,2,11,-9
1996,Zaragoza,50005,Aguilón,0,4,-4
1996,Zaragoza,50003,Agón,1,4,-3
1996,Zaragoza,50006,Ainzón,8,13,-5
1996,Zaragoza,50007,Aladrén,0,3,-3
1996,Zaragoza,50008,Alagón,45,64,-19
1996,Zaragoza,50009,Alarba,0,1,-1
1996,Zaragoza,50010,Alberite de San Juan,0,2,-2
1996,Zaragoza,50012,Alborge,2,1,1
1996,Zaragoza,50013,Alcalá de Ebro,1,5,-4
1996,Zaragoza,50015,Alconchel de Ariza,0,1,-1
1996,Zaragoza,50016,Aldehuela de Liestos,0,1,-1
1996,Zaragoza,50017,Alfajarín,10,17,-7
1996,Zaragoza,50018,Alfamén,7,12,-5
1996,Zaragoza,50019,Alforque,1,0,1
1996,Zaragoza,50020,Alhama de Aragón,14,21,-7
1996,Zaragoza,50021,Almochuel,0,1,-1
1996,Zaragoza,50022,Almolda (La),5,12,-7
1996,Zaragoza,50023,Almonacid de la Cuba,0,5,-5
1996,Zaragoza,50024,Almonacid de la Sierra,6,9,-3
1996,Zaragoza,50025,Almunia de Doña Godina (La),44,46,-2
1996,Zaragoza,50026,Alpartir,3,9,-6
1996,Zaragoza,50027,Ambel,2,5,-3
1996,Zaragoza,50029,Aniñón,8,13,-5
1996,Zaragoza,50031,Aranda de Moncayo,1,4,-3
1996,Zaragoza,50033,Ardisa,0,3,-3
1996,Zaragoza,50034,Ariza,8,9,-1
1996,Zaragoza,50035,Artieda,0,1,-1
1996,Zaragoza,50032,Arándiga,7,12,-5
1996,Zaragoza,50036,Asín,1,0,1
1996,Zaragoza,50037,Atea,1,4,-3
1996,Zaragoza,50038,Ateca,18,28,-10
1996,Zaragoza,50039,Azuara,5,15,-10
1996,Zaragoza,50030,Añón de Moncayo,0,6,-6
1996,Zaragoza,50040,Badules,0,1,-1
1996,Zaragoza,50042,Balconchán,0,2,-2
1996,Zaragoza,50044,Bardallur,0,5,-5
1996,Zaragoza,50045,Belchite,13,22,-9
1996,Zaragoza,50046,Belmonte de Gracián,1,10,-9
1996,Zaragoza,50047,Berdejo,0,2,-2
1996,Zaragoza,50048,Berrueco,0,2,-2
1996,Zaragoza,50901,Biel,0,1,-1
1996,Zaragoza,50050,Bijuesca,2,0,2
1996,Zaragoza,50051,Biota,6,16,-10
1996,Zaragoza,50052,Bisimbre,0,2,-2
1996,Zaragoza,50053,Boquiñeni,6,12,-6
1996,Zaragoza,50055,Borja,43,65,-22
1996,Zaragoza,50056,Botorrita,2,5,-3
1996,Zaragoza,50057,Brea de Aragón,16,19,-3
1996,Zaragoza,50058,Bubierca,0,3,-3
1996,Zaragoza,50059,Bujaraloz,8,7,1
1996,Zaragoza,50060,Bulbuente,1,3,-2
1996,Zaragoza,50061,Bureta,0,5,-5
1996,Zaragoza,50062,Burgo de Ebro (El),5,12,-7
1996,Zaragoza,50063,Buste (El),0,5,-5
1996,Zaragoza,50043,Bárboles,1,4,-3
1996,Zaragoza,50064,Cabañas de Ebro,3,4,-1
1996,Zaragoza,50065,Cabolafuente,0,2,-2
1996,Zaragoza,50066,Cadrete,11,6,5
1996,Zaragoza,50067,Calatayud,130,210,-80
1996,Zaragoza,50068,Calatorao,9,31,-22
1996,Zaragoza,50070,Calmarza,0,4,-4
1996,Zaragoza,50071,Campillo de Aragón,0,4,-4
1996,Zaragoza,50072,Carenas,0,7,-7
1996,Zaragoza,50073,Cariñena,26,30,-4
1996,Zaragoza,50074,Caspe,51,134,-83
1996,Zaragoza,50075,Castejón de Alarba,0,1,-1
1996,Zaragoza,50076,Castejón de las Armas,0,1,-1
1996,Zaragoza,50077,Castejón de Valdejasa,1,4,-3
1996,Zaragoza,50078,Castiliscar,3,4,-1
1996,Zaragoza,50079,Cervera de la Cañada,1,7,-6
1996,Zaragoza,50081,Cetina,5,7,-2
1996,Zaragoza,50092,Chiprana,4,7,-3
1996,Zaragoza,50093,Chodes,1,2,-1
1996,Zaragoza,50082,Cimballa,0,1,-1
1996,Zaragoza,50083,Cinco Olivas,1,8,-7
1996,Zaragoza,50085,Codo,0,6,-6
1996,Zaragoza,50086,Codos,0,6,-6
1996,Zaragoza,50087,Contamina,0,3,-3
1996,Zaragoza,50088,Cosuenda,2,6,-4
1996,Zaragoza,50089,Cuarte de Huerva,36,22,14
1996,Zaragoza,50090,Cubel,0,5,-5
1996,Zaragoza,50091,Cuerlas (Las),0,1,-1
1996,Zaragoza,50094,Daroca,13,39,-26
1996,Zaragoza,50095,Ejea de los Caballeros,137,152,-15
1996,Zaragoza,50096,Embid de Ariza,0,1,-1
1996,Zaragoza,50098,Encinacorba,4,5,-1
1996,Zaragoza,50100,Erla,2,6,-4
1996,Zaragoza,50101,Escatrón,7,24,-17
1996,Zaragoza,50102,Fabara,9,16,-7
1996,Zaragoza,50104,Farlete,3,9,-6
1996,Zaragoza,50106,Fayos (Los),2,0,2
1996,Zaragoza,50105,Fayón,2,10,-8
1996,Zaragoza,50107,Figueruelas,10,6,4
1996,Zaragoza,50109,Frago (El),0,3,-3
1996,Zaragoza,50110,Frasno (El),0,18,-18
1996,Zaragoza,50111,Fréscano,2,3,-1
1996,Zaragoza,50113,Fuendejalón,2,12,-10
1996,Zaragoza,50114,Fuendetodos,0,3,-3
1996,Zaragoza,50115,Fuentes de Ebro,31,44,-13
1996,Zaragoza,50116,Fuentes de Jiloca,1,2,-1
1996,Zaragoza,50117,Gallocanta,2,0,2
1996,Zaragoza,50118,Gallur,20,35,-15
1996,Zaragoza,50119,Gelsa,6,16,-10
1996,Zaragoza,50120,Godojos,1,2,-1
1996,Zaragoza,50121,Gotor,6,9,-3
1996,Zaragoza,50122,Grisel,0,2,-2
1996,Zaragoza,50123,Grisén,4,5,-1
1996,Zaragoza,50124,Herrera de los Navarros,2,10,-8
1996,Zaragoza,50125,Ibdes,2,9,-7
1996,Zaragoza,50126,Illueca,33,20,13
1996,Zaragoza,50129,Jaraba,1,8,-7
1996,Zaragoza,50130,Jarque de Moncayo,2,9,-7
1996,Zaragoza,50131,Jaulín,1,3,-2
1996,Zaragoza,50132,Joyosa (La),3,4,-1
1996,Zaragoza,50133,Lagata,1,3,-2
1996,Zaragoza,50134,Langa del Castillo,0,4,-4
1996,Zaragoza,50135,Layana,0,1,-1
1996,Zaragoza,50138,Lechón,0,1,-1
1996,Zaragoza,50137,Leciñena,6,15,-9
1996,Zaragoza,50139,Letux,0,6,-6
1996,Zaragoza,50140,Litago,0,2,-2
1996,Zaragoza,50141,Lituénigo,0,4,-4
1996,Zaragoza,50142,Lobera de Onsella,0,2,-2
1996,Zaragoza,50143,Longares,5,9,-4
1996,Zaragoza,50144,Longás,0,1,-1
1996,Zaragoza,50146,Lucena de Jalón,1,3,-2
1996,Zaragoza,50147,Luceni,8,12,-4
1996,Zaragoza,50148,Luesia,1,8,-7
1996,Zaragoza,50150,Lumpiaque,3,16,-13
1996,Zaragoza,50151,Luna,4,11,-7
1996,Zaragoza,50136,Lécera,4,8,-4
1996,Zaragoza,50152,Maella,14,24,-10
1996,Zaragoza,50153,Magallón,13,15,-2
1996,Zaragoza,50154,Mainar,0,6,-6
1996,Zaragoza,50155,Malanquilla,0,2,-2
1996,Zaragoza,50156,Maleján,2,6,-4
1996,Zaragoza,50160,Mallén,26,42,-16
1996,Zaragoza,50159,Maluenda,4,10,-6
1996,Zaragoza,50157,Malón,3,4,-1
1996,Zaragoza,50161,Manchones,1,1,0
1996,Zaragoza,50162,Mara,1,6,-5
1996,Zaragoza,50163,María de Huerva,7,16,-9
1996,Zaragoza,50164,Mediana de Aragón,1,7,-6
1996,Zaragoza,50165,Mequinenza,18,25,-7
1996,Zaragoza,50166,Mesones de Isuela,1,9,-8
1996,Zaragoza,50167,Mezalocha,3,10,-7
1996,Zaragoza,50169,Miedes de Aragón,0,5,-5
1996,Zaragoza,50170,Monegrillo,6,5,1
1996,Zaragoza,50171,Moneva,0,1,-1
1996,Zaragoza,50172,Monreal de Ariza,1,4,-3
1996,Zaragoza,50173,Monterde,1,5,-4
1996,Zaragoza,50174,Montón,0,1,-1
1996,Zaragoza,50175,Morata de Jalón,8,18,-10
1996,Zaragoza,50176,Morata de Jiloca,2,4,-2
1996,Zaragoza,50178,Moros,2,12,-10
1996,Zaragoza,50177,Morés,1,7,-6
1996,Zaragoza,50179,Moyuela,1,10,-9
1996,Zaragoza,50181,Muel,5,14,-9
1996,Zaragoza,50182,Muela (La),17,10,7
1996,Zaragoza,50183,Munébrega,6,4,2
1996,Zaragoza,50184,Murero,1,1,0
1996,Zaragoza,50185,Murillo de Gállego,1,0,1
1996,Zaragoza,50186,Navardún,0,1,-1
1996,Zaragoza,50187,Nigüella,1,7,-6
1996,Zaragoza,50189,Nonaspe,4,14,-10
1996,Zaragoza,50190,Novallas,3,11,-8
1996,Zaragoza,50191,Novillas,6,4,2
1996,Zaragoza,50193,Nuez de Ebro,2,8,-6
1996,Zaragoza,50192,Nuévalos,5,3,2
1996,Zaragoza,50194,Olvés,1,2,-1
1996,Zaragoza,50197,Orés,0,2,-2
1996,Zaragoza,50198,Oseja,0,1,-1
1996,Zaragoza,50199,Osera de Ebro,1,5,-4
1996,Zaragoza,50200,Paniza,4,6,-2
1996,Zaragoza,50201,Paracuellos de Jiloca,2,6,-4
1996,Zaragoza,50202,Paracuellos de la Ribera,1,6,-5
1996,Zaragoza,50203,Pastriz,5,11,-6
1996,Zaragoza,50204,Pedrola,18,19,-1
1996,Zaragoza,50205,Pedrosas (Las),0,5,-5
1996,Zaragoza,50206,Perdiguera,4,9,-5
1996,Zaragoza,50207,Piedratajada,1,2,-1
1996,Zaragoza,50208,Pina de Ebro,36,17,19
1996,Zaragoza,50209,Pinseque,11,52,-41
1996,Zaragoza,50210,Pintanos (Los),0,2,-2
1996,Zaragoza,50211,Plasencia de Jalón,2,5,-3
1996,Zaragoza,50212,Pleitas,0,1,-1
1996,Zaragoza,50213,Plenas,0,3,-3
1996,Zaragoza,50214,Pomer,0,1,-1
1996,Zaragoza,50216,Pozuelo de Aragón,1,11,-10
1996,Zaragoza,50217,Pradilla de Ebro,2,11,-9
1996,Zaragoza,50218,Puebla de Albortón,0,2,-2
1996,Zaragoza,50219,Puebla de Alfindén (La),12,10,2
1996,Zaragoza,50220,Puendeluna,1,0,1
1996,Zaragoza,50222,Quinto,25,24,1
1996,Zaragoza,50223,Remolinos,7,18,-11
1996,Zaragoza,50224,Retascón,0,3,-3
1996,Zaragoza,50225,Ricla,22,22,0
1996,Zaragoza,50227,Romanos,0,2,-2
1996,Zaragoza,50228,Rueda de Jalón,1,2,-1
1996,Zaragoza,50231,Salillas de Jalón,1,5,-4
1996,Zaragoza,50232,Salvatierra de Esca,5,3,2
1996,Zaragoza,50233,Samper del Salz,0,1,-1
1996,Zaragoza,50234,San Martín de la Virgen de Moncayo,3,2,1
1996,Zaragoza,50235,San Mateo de Gállego,20,22,-2
1996,Zaragoza,50236,Santa Cruz de Grío,1,1,0
1996,Zaragoza,50237,Santa Cruz de Moncayo,1,0,1
1996,Zaragoza,50238,Santa Eulalia de Gállego,0,4,-4
1996,Zaragoza,50239,Santed,1,0,1
1996,Zaragoza,50241,Saviñán,3,12,-9
1996,Zaragoza,50242,Sediles,0,1,-1
1996,Zaragoza,50243,Sestrica,0,7,-7
1996,Zaragoza,50244,Sierra de Luna,1,6,-5
1996,Zaragoza,50245,Sigüés,0,1,-1
1996,Zaragoza,50247,Sobradiel,1,12,-11
1996,Zaragoza,50248,Sos del Rey Católico,5,11,-6
1996,Zaragoza,50230,Sádaba,11,25,-14
1996,Zaragoza,50240,Sástago,10,23,-13
1996,Zaragoza,50249,Tabuenca,0,7,-7
1996,Zaragoza,50250,Talamantes,1,0,1
1996,Zaragoza,50251,Tarazona,84,116,-32
1996,Zaragoza,50252,Tauste,62,78,-16
1996,Zaragoza,50253,Terrer,2,9,-7
1996,Zaragoza,50254,Tierga,1,2,-1
1996,Zaragoza,50255,Tobed,0,5,-5
1996,Zaragoza,50256,Torralba de los Frailes,0,2,-2
1996,Zaragoza,50257,Torralba de Ribota,2,4,-2
1996,Zaragoza,50258,Torralbilla,0,1,-1
1996,Zaragoza,50259,Torrehermosa,0,1,-1
1996,Zaragoza,50260,Torrelapaja,0,1,-1
1996,Zaragoza,50261,Torrellas,2,4,-2
1996,Zaragoza,50262,Torres de Berrellén,9,16,-7
1996,Zaragoza,50263,Torrijo de la Cañada,2,7,-5
1996,Zaragoza,50264,Tosos,1,2,-1
1996,Zaragoza,50265,Trasmoz,0,1,-1
1996,Zaragoza,50266,Trasobares,1,3,-2
1996,Zaragoza,50267,Uncastillo,5,24,-19
1996,Zaragoza,50268,Undués de Lerda,0,2,-2
1996,Zaragoza,50269,Urrea de Jalón,0,3,-3
1996,Zaragoza,50270,Urriés,0,1,-1
1996,Zaragoza,50271,Used,1,7,-6
1996,Zaragoza,50272,Utebo,90,51,39
1996,Zaragoza,50274,Val de San Martín,1,0,1
1996,Zaragoza,50276,Valpalmas,2,1,1
1996,Zaragoza,50277,Valtorres,0,2,-2
1996,Zaragoza,50278,Velilla de Ebro,2,1,1
1996,Zaragoza,50279,Velilla de Jiloca,0,7,-7
1996,Zaragoza,50280,Vera de Moncayo,2,8,-6
1996,Zaragoza,50283,Villadoz,0,2,-2
1996,Zaragoza,50284,Villafeliche,0,9,-9
1996,Zaragoza,50285,Villafranca de Ebro,7,9,-2
1996,Zaragoza,50287,Villalengua,2,6,-4
1996,Zaragoza,50288,Villanueva de Gállego,16,43,-27
1996,Zaragoza,50290,Villanueva de Huerva,2,5,-3
1996,Zaragoza,50289,Villanueva de Jiloca,0,2,-2
1996,Zaragoza,50291,Villar de los Navarros,0,8,-8
1996,Zaragoza,50292,Villarreal de Huerva,1,7,-6
1996,Zaragoza,50293,Villarroya de la Sierra,3,11,-8
1996,Zaragoza,50294,Villarroya del Campo,0,1,-1
1996,Zaragoza,50282,Vilueña (La),0,0,0
1996,Zaragoza,50295,Vistabella,0,1,-1
1996,Zaragoza,50296,Zaida (La),7,8,-1
1996,Zaragoza,50297,Zaragoza,4950,5307,-357
1996,Zaragoza,50298,Zuera,37,65,-28
1996,Zaragoza,50099,Épila,39,48,-9
