year,name,cp,nacidos,defunciones,saldo
2017,Teruel,Ababuj (44001),0,1,-1
2017,Teruel,Aguaviva (44004),3,8,-5
2017,Teruel,Aguilar del Alfambra (44005),1,3,-2
2017,Teruel,Alacón (44006),2,8,-6
2017,Teruel,Alba (44007),0,4,-4
2017,Teruel,Albalate del Arzobispo (44008),17,35,-18
2017,Teruel,Albarracín (44009),6,17,-11
2017,Teruel,Albentosa (44010),3,3,0
2017,Teruel,Alcalá de la Selva (44012),1,3,-2
2017,Teruel,Alcañiz (44013),147,125,22
2017,Teruel,Alcorisa (44014),25,44,-19
2017,Teruel,Alfambra (44016),0,12,-12
2017,Teruel,Aliaga (44017),2,4,-2
2017,Teruel,Allepuz (44021),1,3,-2
2017,Teruel,Alloza (44022),4,9,-5
2017,Teruel,Allueva (44023),1,1,0
2017,Teruel,Anadón (44024),0,1,-1
2017,Teruel,Andorra (44025),53,79,-26
2017,Teruel,Arcos de las Salinas (44026),0,2,-2
2017,Teruel,Arens de Lledó (44027),2,2,0
2017,Teruel,Argente (44028),1,8,-7
2017,Teruel,Ariño (44029),5,12,-7
2017,Teruel,Azaila (44031),2,7,-5
2017,Teruel,Barrachina (44035),0,3,-3
2017,Teruel,Bañón (44034),0,3,-3
2017,Teruel,Beceite (44037),0,8,-8
2017,Teruel,Bello (44039),1,10,-9
2017,Teruel,Belmonte de San José (44038),1,1,0
2017,Teruel,Blancas (44042),0,2,-2
2017,Teruel,Blesa (44043),1,2,-1
2017,Teruel,Bronchales (44045),3,5,-2
2017,Teruel,Bueña (44046),0,1,-1
2017,Teruel,Burbáguena (44047),1,4,-3
2017,Teruel,Báguena (44033),1,5,-4
2017,Teruel,Cabra de Mora (44048),0,2,-2
2017,Teruel,Calaceite (44049),5,21,-16
2017,Teruel,Calamocha (44050),30,53,-23
2017,Teruel,Calanda (44051),23,55,-32
2017,Teruel,Calomarde (44052),0,2,-2
2017,Teruel,Camarena de la Sierra (44054),1,1,0
2017,Teruel,Camarillas (44055),2,1,1
2017,Teruel,Camañas (44053),0,4,-4
2017,Teruel,Caminreal (44056),3,14,-11
2017,Teruel,Cantavieja (44059),5,4,1
2017,Teruel,Cascante del Río (44064),0,1,-1
2017,Teruel,Castejón de Tornos (44065),0,3,-3
2017,Teruel,Castel de Cabra (44066),0,3,-3
2017,Teruel,Castellote (44071),0,12,-12
2017,Teruel,Castelnou (44067),1,1,0
2017,Teruel,Castelserás (44068),11,14,-3
2017,Teruel,Cañada de Benatanduz (44060),0,1,-1
2017,Teruel,Cedrillas (44074),6,7,-1
2017,Teruel,Celadas (44075),0,10,-10
2017,Teruel,Cella (44076),18,41,-23
2017,Teruel,Codoñera (La) (44080),1,8,-7
2017,Teruel,Cortes de Aragón (44084),0,1,-1
2017,Teruel,Cosa (44085),0,1,-1
2017,Teruel,Cretas (44086),3,4,-1
2017,Teruel,Crivillén (44087),0,1,-1
2017,Teruel,Cubla (44089),0,1,-1
2017,Teruel,Cucalón (44090),0,3,-3
2017,Teruel,Cuervo (El) (44092),0,3,-3
2017,Teruel,Cuevas de Almudén (44093),2,,2
2017,Teruel,Cuevas Labradas (44094),0,2,-2
2017,Teruel,Ejulve (44096),1,5,-4
2017,Teruel,Escorihuela (44097),0,4,-4
2017,Teruel,Escucha (44099),9,9,0
2017,Teruel,Estercuel (44100),0,3,-3
2017,Teruel,Ferreruela de Huerva (44101),0,1,-1
2017,Teruel,Fonfría (44102),0,2,-2
2017,Teruel,Formiche Alto (44103),0,4,-4
2017,Teruel,Fortanete (44106),2,2,0
2017,Teruel,Foz-Calanda (44107),1,4,-3
2017,Teruel,Fresneda (La) (44108),1,9,-8
2017,Teruel,Frías de Albarracín (44109),0,5,-5
2017,Teruel,Fuenferrada (44110),0,1,-1
2017,Teruel,Fuentes Calientes (44111),0,2,-2
2017,Teruel,Fuentes Claras (44112),2,10,-8
2017,Teruel,Fuentes de Rubielos (44113),1,2,-1
2017,Teruel,Fuentespalda (44114),1,4,-3
2017,Teruel,Fórnoles (44105),1,,1
2017,Teruel,Galve (44115),1,1,0
2017,Teruel,Gargallo (44116),0,1,-1
2017,Teruel,Gea de Albarracín (44117),1,,1
2017,Teruel,Ginebrosa (La) (44118),0,2,-2
2017,Teruel,Griegos (44119),0,2,-2
2017,Teruel,Guadalaviar (44120),0,5,-5
2017,Teruel,Gúdar (44121),0,1,-1
2017,Teruel,Hinojosa de Jarque (44123),1,1,0
2017,Teruel,Hoz de la Vieja (La) (44124),0,1,-1
2017,Teruel,Huesa del Común (44125),0,1,-1
2017,Teruel,Híjar (44122),17,23,-6
2017,Teruel,Iglesuela del Cid (La) (44126),1,12,-11
2017,Teruel,Jabaloyas (44127),0,3,-3
2017,Teruel,Jarque de la Val (44128),0,2,-2
2017,Teruel,Josa (44131),0,1,-1
2017,Teruel,Lagueruela (44132),0,1,-1
2017,Teruel,Lanzuela (44133),1,,1
2017,Teruel,Libros (44135),0,3,-3
2017,Teruel,Linares de Mora (44137),2,3,-1
2017,Teruel,Lledó (44141),0,1,-1
2017,Teruel,Loscos (44138),0,5,-5
2017,Teruel,Manzanera (44143),1,7,-6
2017,Teruel,Martín del Río (44144),2,13,-11
2017,Teruel,Mas de las Matas (44145),6,24,-18
2017,Teruel,Mata de los Olmos (La) (44146),1,6,-5
2017,Teruel,Mazaleón (44147),7,8,-1
2017,Teruel,Mezquita de Jarque (44148),3,2,1
2017,Teruel,Mirambel (44149),2,,2
2017,Teruel,Molinos (44151),2,3,-1
2017,Teruel,Monforte de Moyuela (44152),0,1,-1
2017,Teruel,Monreal del Campo (44153),25,33,-8
2017,Teruel,Monroyo (44154),5,7,-2
2017,Teruel,Montalbán (44155),7,18,-11
2017,Teruel,Mora de Rubielos (44158),5,19,-14
2017,Teruel,Moscardón (44159),0,3,-3
2017,Teruel,Mosqueruela (44160),3,11,-8
2017,Teruel,Muniesa (44161),7,18,-11
2017,Teruel,Nogueras (44164),0,1,-1
2017,Teruel,Nogueruelas (44165),0,2,-2
2017,Teruel,Obón (44167),0,1,-1
2017,Teruel,Odón (44168),0,4,-4
2017,Teruel,Ojos Negros (44169),1,9,-8
2017,Teruel,Olba (44171),1,,1
2017,Teruel,Oliete (44172),4,4,0
2017,Teruel,Olmos (Los) (44173),1,2,-1
2017,Teruel,Orihuela del Tremedal (44174),3,5,-2
2017,Teruel,Orrios (44175),0,1,-1
2017,Teruel,Palomar de Arroyos (44176),2,2,0
2017,Teruel,Pancrudo (44177),0,1,-1
2017,Teruel,Parras de Castellote (Las) (44178),1,2,-1
2017,Teruel,Peracense (44180),0,2,-2
2017,Teruel,Peralejos (44181),0,1,-1
2017,Teruel,Perales del Alfambra (44182),0,7,-7
2017,Teruel,Peñarroya de Tastavins (44179),2,9,-7
2017,Teruel,Pitarque (44183),0,1,-1
2017,Teruel,Plou (44184),0,1,-1
2017,Teruel,Pobo (El) (44185),0,3,-3
2017,Teruel,Portellada (La) (44187),1,1,0
2017,Teruel,Pozondón (44189),0,4,-4
2017,Teruel,Pozuel del Campo (44190),0,1,-1
2017,Teruel,Puebla de Híjar (La) (44191),1,15,-14
2017,Teruel,Puebla de Valverde (La) (44192),1,8,-7
2017,Teruel,Puertomingalvo (44193),2,1,1
2017,Teruel,Rillo (44195),0,5,-5
2017,Teruel,Riodeva (44196),2,3,-1
2017,Teruel,Royuela (44198),0,3,-3
2017,Teruel,Rubiales (44199),1,,1
2017,Teruel,Rubielos de Mora (44201),7,10,-3
2017,Teruel,Ráfales (44194),0,3,-3
2017,Teruel,Ródenas (44197),0,4,-4
2017,Teruel,Salcedillo (44203),0,1,-1
2017,Teruel,Samper de Calanda (44205),6,17,-11
2017,Teruel,San Agustín (44206),0,2,-2
2017,Teruel,San Martín del Río (44207),0,5,-5
2017,Teruel,Santa Cruz de Nogueras (44208),1,2,-1
2017,Teruel,Santa Eulalia (44209),4,21,-17
2017,Teruel,Sarrión (44210),12,12,0
2017,Teruel,Segura de los Baños (44211),0,2,-2
2017,Teruel,Seno (44212),0,1,-1
2017,Teruel,Singra (44213),0,2,-2
2017,Teruel,Terriente (44215),0,3,-3
2017,Teruel,Teruel (44216),291,329,-38
2017,Teruel,Tornos (44219),0,2,-2
2017,Teruel,Torralba de los Sisones (44220),0,1,-1
2017,Teruel,Torre de Arcas (44223),0,2,-2
2017,Teruel,Torre del Compte (44225),1,3,-2
2017,Teruel,Torrecilla de Alcañiz (44221),1,4,-3
2017,Teruel,Torrelacárcel (44226),0,7,-7
2017,Teruel,Torremocha de Jiloca (44228),1,2,-1
2017,Teruel,Torres de Albarracín (44229),2,1,1
2017,Teruel,Torrevelilla (44230),1,1,0
2017,Teruel,Torrijas (44231),1,1,0
2017,Teruel,Torrijo del Campo (44232),5,9,-4
2017,Teruel,Tramacastiel (44234),0,2,-2
2017,Teruel,Tramacastilla (44235),0,2,-2
2017,Teruel,Tronchón (44236),0,3,-3
2017,Teruel,Urrea de Gaén (44237),2,11,-9
2017,Teruel,Utrillas (44238),25,33,-8
2017,Teruel,Valbona (44240),0,4,-4
2017,Teruel,Valdealgorfa (44241),3,9,-6
2017,Teruel,Valdecuenca (44243),1,,1
2017,Teruel,Valdelinares (44244),1,,1
2017,Teruel,Valdeltormo (44245),2,2,0
2017,Teruel,Valderrobres (44246),22,28,-6
2017,Teruel,Valjunquera (44247),1,5,-4
2017,Teruel,Vallecillo (El) (44249),0,1,-1
2017,Teruel,Veguillas de la Sierra (44250),0,1,-1
2017,Teruel,Villafranca del Campo (44251),1,5,-4
2017,Teruel,Villahermosa del Campo (44252),0,1,-1
2017,Teruel,Villanueva del Rebollar de la Sierra (44256),1,,1
2017,Teruel,Villar del Cobo (44257),0,3,-3
2017,Teruel,Villar del Salz (44258),0,2,-2
2017,Teruel,Villarluengo (44260),2,1,1
2017,Teruel,Villarquemado (44261),7,9,-2
2017,Teruel,Villarroya de los Pinares (44262),0,1,-1
2017,Teruel,Villastar (44263),5,8,-3
2017,Teruel,Villel (44264),1,9,-8
2017,Teruel,Vinaceite (44265),0,5,-5
2017,Teruel,Visiedo (44266),2,4,-2
2016,Teruel,Aguaviva (44004),2,12,-10
2016,Teruel,Aguilar del Alfambra (44005),0,2,-2
2016,Teruel,Alacón (44006),0,8,-8
2016,Teruel,Alba (44007),1,6,-5
2016,Teruel,Albalate del Arzobispo (44008),10,19,-9
2016,Teruel,Albarracín (44009),7,14,-7
2016,Teruel,Albentosa (44010),0,3,-3
2016,Teruel,Alcaine (44011),0,1,-1
2016,Teruel,Alcalá de la Selva (44012),0,4,-4
2016,Teruel,Alcañiz (44013),148,141,7
2016,Teruel,Alcorisa (44014),29,34,-5
2016,Teruel,Alfambra (44016),3,6,-3
2016,Teruel,Aliaga (44017),4,5,-1
2016,Teruel,Allepuz (44021),2,2,0
2016,Teruel,Alloza (44022),4,5,-1
2016,Teruel,Almohaja (44018),0,1,-1
2016,Teruel,Alobras (44019),0,1,-1
2016,Teruel,Alpeñés (44020),0,1,-1
2016,Teruel,Andorra (44025),81,81,0
2016,Teruel,Arcos de las Salinas (44026),3,1,2
2016,Teruel,Arens de Lledó (44027),1,5,-4
2016,Teruel,Argente (44028),1,5,-4
2016,Teruel,Ariño (44029),3,7,-4
2016,Teruel,Azaila (44031),1,2,-1
2016,Teruel,Barrachina (44035),0,4,-4
2016,Teruel,Bañón (44034),1,5,-4
2016,Teruel,Beceite (44037),2,5,-3
2016,Teruel,Bello (44039),0,4,-4
2016,Teruel,Belmonte de San José (44038),2,3,-1
2016,Teruel,Berge (44040),2,5,-3
2016,Teruel,Bezas (44041),0,1,-1
2016,Teruel,Blancas (44042),0,6,-6
2016,Teruel,Blesa (44043),0,4,-4
2016,Teruel,Bordón (44044),0,4,-4
2016,Teruel,Bronchales (44045),2,2,0
2016,Teruel,Bueña (44046),0,3,-3
2016,Teruel,Bádenas (44032),0,1,-1
2016,Teruel,Báguena (44033),1,7,-6
2016,Teruel,Cabra de Mora (44048),0,2,-2
2016,Teruel,Calaceite (44049),9,12,-3
2016,Teruel,Calamocha (44050),41,56,-15
2016,Teruel,Calanda (44051),20,56,-36
2016,Teruel,Calomarde (44052),0,1,-1
2016,Teruel,Camarena de la Sierra (44054),0,2,-2
2016,Teruel,Camarillas (44055),2,3,-1
2016,Teruel,Camañas (44053),1,2,-1
2016,Teruel,Caminreal (44056),3,12,-9
2016,Teruel,Cantavieja (44059),3,9,-6
2016,Teruel,Cascante del Río (44064),0,1,-1
2016,Teruel,Castejón de Tornos (44065),0,1,-1
2016,Teruel,Castel de Cabra (44066),1,5,-4
2016,Teruel,Castellar (El) (44070),0,2,-2
2016,Teruel,Castellote (44071),2,9,-7
2016,Teruel,Castelnou (44067),5,2,3
2016,Teruel,Castelserás (44068),6,11,-5
2016,Teruel,Cañada de Benatanduz (44060),0,,0
2016,Teruel,Cañada de Verich (La) (44061),0,2,-2
2016,Teruel,Cañada Vellida (44062),0,2,-2
2016,Teruel,Cañizar del Olivar (44063),3,1,2
2016,Teruel,Cedrillas (44074),5,6,-1
2016,Teruel,Celadas (44075),4,4,0
2016,Teruel,Cella (44076),21,26,-5
2016,Teruel,Cerollera (La) (44077),2,1,1
2016,Teruel,Codoñera (La) (44080),2,4,-2
2016,Teruel,Corbalán (44082),1,2,-1
2016,Teruel,Cortes de Aragón (44084),1,2,-1
2016,Teruel,Cretas (44086),1,11,-10
2016,Teruel,Crivillén (44087),0,1,-1
2016,Teruel,Cuba (La) (44088),0,1,-1
2016,Teruel,Cubla (44089),0,1,-1
2016,Teruel,Cucalón (44090),0,1,-1
2016,Teruel,Cuervo (El) (44092),0,2,-2
2016,Teruel,Cuevas de Almudén (44093),2,2,0
2016,Teruel,Cuevas Labradas (44094),0,2,-2
2016,Teruel,Ejulve (44096),0,4,-4
2016,Teruel,Escorihuela (44097),0,8,-8
2016,Teruel,Escucha (44099),7,8,-1
2016,Teruel,Estercuel (44100),0,3,-3
2016,Teruel,Formiche Alto (44103),1,4,-3
2016,Teruel,Fortanete (44106),1,3,-2
2016,Teruel,Foz-Calanda (44107),1,2,-1
2016,Teruel,Fresneda (La) (44108),2,8,-6
2016,Teruel,Frías de Albarracín (44109),1,1,0
2016,Teruel,Fuenferrada (44110),0,1,-1
2016,Teruel,Fuentes Claras (44112),0,9,-9
2016,Teruel,Fuentes de Rubielos (44113),2,1,1
2016,Teruel,Fuentespalda (44114),2,5,-3
2016,Teruel,Fórnoles (44105),1,2,-1
2016,Teruel,Gargallo (44116),1,3,-2
2016,Teruel,Gea de Albarracín (44117),2,10,-8
2016,Teruel,Ginebrosa (La) (44118),3,2,1
2016,Teruel,Griegos (44119),0,2,-2
2016,Teruel,Guadalaviar (44120),2,3,-1
2016,Teruel,Gúdar (44121),1,,1
2016,Teruel,Hinojosa de Jarque (44123),2,1,1
2016,Teruel,Hoz de la Vieja (La) (44124),0,2,-2
2016,Teruel,Huesa del Común (44125),0,3,-3
2016,Teruel,Híjar (44122),8,25,-17
2016,Teruel,Iglesuela del Cid (La) (44126),1,3,-2
2016,Teruel,Jabaloyas (44127),0,2,-2
2016,Teruel,Jarque de la Val (44128),0,2,-2
2016,Teruel,Jatiel (44129),1,1,0
2016,Teruel,Jorcas (44130),1,,1
2016,Teruel,Josa (44131),1,,1
2016,Teruel,Lagueruela (44132),4,2,2
2016,Teruel,Libros (44135),0,5,-5
2016,Teruel,Lidón (44136),0,1,-1
2016,Teruel,Linares de Mora (44137),3,4,-1
2016,Teruel,Lledó (44141),3,3,0
2016,Teruel,Loscos (44138),0,2,-2
2016,Teruel,Manzanera (44143),7,5,2
2016,Teruel,Martín del Río (44144),5,2,3
2016,Teruel,Mas de las Matas (44145),5,22,-17
2016,Teruel,Mata de los Olmos (La) (44146),3,1,2
2016,Teruel,Mazaleón (44147),4,7,-3
2016,Teruel,Mezquita de Jarque (44148),1,3,-2
2016,Teruel,Mirambel (44149),0,2,-2
2016,Teruel,Molinos (44151),2,7,-5
2016,Teruel,Monforte de Moyuela (44152),0,1,-1
2016,Teruel,Monreal del Campo (44153),13,34,-21
2016,Teruel,Monroyo (44154),3,6,-3
2016,Teruel,Montalbán (44155),6,15,-9
2016,Teruel,Monteagudo del Castillo (44156),1,,1
2016,Teruel,Monterde de Albarracín (44157),0,4,-4
2016,Teruel,Mora de Rubielos (44158),16,19,-3
2016,Teruel,Mosqueruela (44160),4,10,-6
2016,Teruel,Muniesa (44161),3,11,-8
2016,Teruel,Noguera de Albarracín (44163),0,3,-3
2016,Teruel,Nogueruelas (44165),1,3,-2
2016,Teruel,Odón (44168),1,4,-3
2016,Teruel,Ojos Negros (44169),1,7,-6
2016,Teruel,Olba (44171),0,7,-7
2016,Teruel,Oliete (44172),0,5,-5
2016,Teruel,Olmos (Los) (44173),1,2,-1
2016,Teruel,Orihuela del Tremedal (44174),2,4,-2
2016,Teruel,Orrios (44175),1,3,-2
2016,Teruel,Palomar de Arroyos (44176),0,4,-4
2016,Teruel,Pancrudo (44177),2,4,-2
2016,Teruel,Parras de Castellote (Las) (44178),0,2,-2
2016,Teruel,Peralejos (44181),1,6,-5
2016,Teruel,Perales del Alfambra (44182),0,4,-4
2016,Teruel,Peñarroya de Tastavins (44179),3,6,-3
2016,Teruel,Plou (44184),1,,1
2016,Teruel,Pobo (El) (44185),1,4,-3
2016,Teruel,Portellada (La) (44187),1,4,-3
2016,Teruel,Pozondón (44189),0,2,-2
2016,Teruel,Pozuel del Campo (44190),0,1,-1
2016,Teruel,Puebla de Híjar (La) (44191),12,13,-1
2016,Teruel,Puebla de Valverde (La) (44192),6,9,-3
2016,Teruel,Puertomingalvo (44193),1,5,-4
2016,Teruel,Rillo (44195),0,2,-2
2016,Teruel,Riodeva (44196),0,2,-2
2016,Teruel,Royuela (44198),0,2,-2
2016,Teruel,Rubielos de la Cérida (44200),0,1,-1
2016,Teruel,Rubielos de Mora (44201),4,7,-3
2016,Teruel,Ráfales (44194),2,2,0
2016,Teruel,Ródenas (44197),0,2,-2
2016,Teruel,Salcedillo (44203),0,1,-1
2016,Teruel,Saldón (44204),0,1,-1
2016,Teruel,Samper de Calanda (44205),1,14,-13
2016,Teruel,San Agustín (44206),1,1,0
2016,Teruel,San Martín del Río (44207),0,3,-3
2016,Teruel,Santa Cruz de Nogueras (44208),0,,0
2016,Teruel,Santa Eulalia (44209),8,19,-11
2016,Teruel,Sarrión (44210),16,15,1
2016,Teruel,Seno (44212),0,3,-3
2016,Teruel,Singra (44213),0,1,-1
2016,Teruel,Terriente (44215),1,,1
2016,Teruel,Teruel (44216),330,316,14
2016,Teruel,Tormón (44218),0,1,-1
2016,Teruel,Tornos (44219),1,6,-5
2016,Teruel,Torralba de los Sisones (44220),0,2,-2
2016,Teruel,Torre del Compte (44225),0,1,-1
2016,Teruel,Torre los Negros (44227),0,2,-2
2016,Teruel,Torrecilla de Alcañiz (44221),2,4,-2
2016,Teruel,Torrecilla del Rebollar (44222),0,1,-1
2016,Teruel,Torrelacárcel (44226),1,5,-4
2016,Teruel,Torremocha de Jiloca (44228),0,3,-3
2016,Teruel,Torres de Albarracín (44229),1,3,-2
2016,Teruel,Torrevelilla (44230),3,4,-1
2016,Teruel,Torrijas (44231),0,1,-1
2016,Teruel,Torrijo del Campo (44232),1,5,-4
2016,Teruel,Tramacastilla (44235),0,1,-1
2016,Teruel,Tronchón (44236),0,1,-1
2016,Teruel,Urrea de Gaén (44237),2,5,-3
2016,Teruel,Utrillas (44238),17,28,-11
2016,Teruel,Valbona (44240),2,4,-2
2016,Teruel,Valdealgorfa (44241),3,9,-6
2016,Teruel,Valdelinares (44244),0,1,-1
2016,Teruel,Valdeltormo (44245),4,6,-2
2016,Teruel,Valderrobres (44246),25,30,-5
2016,Teruel,Valjunquera (44247),3,10,-7
2016,Teruel,Villafranca del Campo (44251),2,6,-4
2016,Teruel,Villar del Cobo (44257),1,,1
2016,Teruel,Villar del Salz (44258),0,1,-1
2016,Teruel,Villarluengo (44260),0,2,-2
2016,Teruel,Villarquemado (44261),8,11,-3
2016,Teruel,Villarroya de los Pinares (44262),1,3,-2
2016,Teruel,Villastar (44263),7,8,-1
2016,Teruel,Villel (44264),1,4,-3
2016,Teruel,Vinaceite (44265),3,4,-1
2016,Teruel,Visiedo (44266),3,6,-3
2016,Teruel,Vivel del Río Martín (44267),1,1,0
2015,Teruel,Aguaviva (44004),4,7,-3
2015,Teruel,Aguilar del Alfambra (44005),2,2,0
2015,Teruel,Alacón (44006),0,6,-6
2015,Teruel,Alba (44007),1,7,-6
2015,Teruel,Albalate del Arzobispo (44008),15,28,-13
2015,Teruel,Albarracín (44009),8,17,-9
2015,Teruel,Albentosa (44010),1,3,-2
2015,Teruel,Alcaine (44011),1,3,-2
2015,Teruel,Alcalá de la Selva (44012),0,,0
2015,Teruel,Alcañiz (44013),156,148,8
2015,Teruel,Alcorisa (44014),29,37,-8
2015,Teruel,Alfambra (44016),2,5,-3
2015,Teruel,Aliaga (44017),1,2,-1
2015,Teruel,Allepuz (44021),0,,0
2015,Teruel,Alloza (44022),4,8,-4
2015,Teruel,Alobras (44019),0,4,-4
2015,Teruel,Andorra (44025),43,77,-34
2015,Teruel,Arcos de las Salinas (44026),0,1,-1
2015,Teruel,Arens de Lledó (44027),1,4,-3
2015,Teruel,Argente (44028),0,4,-4
2015,Teruel,Ariño (44029),7,15,-8
2015,Teruel,Azaila (44031),0,2,-2
2015,Teruel,Barrachina (44035),0,1,-1
2015,Teruel,Beceite (44037),7,4,3
2015,Teruel,Bello (44039),0,1,-1
2015,Teruel,Belmonte de San José (44038),0,5,-5
2015,Teruel,Berge (44040),6,,6
2015,Teruel,Bezas (44041),0,3,-3
2015,Teruel,Blancas (44042),0,1,-1
2015,Teruel,Blesa (44043),0,2,-2
2015,Teruel,Bordón (44044),1,1,0
2015,Teruel,Bronchales (44045),1,4,-3
2015,Teruel,Bueña (44046),0,1,-1
2015,Teruel,Burbáguena (44047),0,12,-12
2015,Teruel,Bádenas (44032),0,1,-1
2015,Teruel,Báguena (44033),0,9,-9
2015,Teruel,Cabra de Mora (44048),0,2,-2
2015,Teruel,Calaceite (44049),7,10,-3
2015,Teruel,Calamocha (44050),30,69,-39
2015,Teruel,Calanda (44051),23,45,-22
2015,Teruel,Calomarde (44052),0,1,-1
2015,Teruel,Camarena de la Sierra (44054),2,3,-1
2015,Teruel,Camarillas (44055),0,2,-2
2015,Teruel,Camañas (44053),1,3,-2
2015,Teruel,Caminreal (44056),0,17,-17
2015,Teruel,Cantavieja (44059),4,8,-4
2015,Teruel,Cascante del Río (44064),0,2,-2
2015,Teruel,Castejón de Tornos (44065),0,1,-1
2015,Teruel,Castel de Cabra (44066),1,2,-1
2015,Teruel,Castellar (El) (44070),0,2,-2
2015,Teruel,Castellote (44071),2,11,-9
2015,Teruel,Castelnou (44067),2,5,-3
2015,Teruel,Castelserás (44068),2,14,-12
2015,Teruel,Cañada de Verich (La) (44061),0,2,-2
2015,Teruel,Cañada Vellida (44062),0,1,-1
2015,Teruel,Cañizar del Olivar (44063),2,,2
2015,Teruel,Cedrillas (44074),5,6,-1
2015,Teruel,Celadas (44075),2,8,-6
2015,Teruel,Cella (44076),18,45,-27
2015,Teruel,Cerollera (La) (44077),0,6,-6
2015,Teruel,Codoñera (La) (44080),0,3,-3
2015,Teruel,Cortes de Aragón (44084),1,3,-2
2015,Teruel,Cosa (44085),0,1,-1
2015,Teruel,Cretas (44086),5,8,-3
2015,Teruel,Crivillén (44087),0,1,-1
2015,Teruel,Cuba (La) (44088),1,1,0
2015,Teruel,Cubla (44089),0,2,-2
2015,Teruel,Cuervo (El) (44092),0,1,-1
2015,Teruel,Cuevas de Almudén (44093),0,3,-3
2015,Teruel,Cuevas Labradas (44094),1,5,-4
2015,Teruel,Ejulve (44096),0,2,-2
2015,Teruel,Escorihuela (44097),0,3,-3
2015,Teruel,Escucha (44099),12,7,5
2015,Teruel,Estercuel (44100),1,6,-5
2015,Teruel,Formiche Alto (44103),0,,0
2015,Teruel,Fortanete (44106),2,3,-1
2015,Teruel,Foz-Calanda (44107),1,4,-3
2015,Teruel,Fresneda (La) (44108),3,7,-4
2015,Teruel,Fuenferrada (44110),0,2,-2
2015,Teruel,Fuentes Calientes (44111),2,2,0
2015,Teruel,Fuentes Claras (44112),5,14,-9
2015,Teruel,Fuentes de Rubielos (44113),0,2,-2
2015,Teruel,Fuentespalda (44114),2,3,-1
2015,Teruel,Fórnoles (44105),0,2,-2
2015,Teruel,Galve (44115),0,4,-4
2015,Teruel,Gargallo (44116),0,1,-1
2015,Teruel,Gea de Albarracín (44117),1,6,-5
2015,Teruel,Ginebrosa (La) (44118),1,4,-3
2015,Teruel,Griegos (44119),0,3,-3
2015,Teruel,Guadalaviar (44120),1,4,-3
2015,Teruel,Gúdar (44121),1,1,0
2015,Teruel,Hinojosa de Jarque (44123),0,1,-1
2015,Teruel,Hoz de la Vieja (La) (44124),1,2,-1
2015,Teruel,Huesa del Común (44125),0,4,-4
2015,Teruel,Híjar (44122),6,28,-22
2015,Teruel,Iglesuela del Cid (La) (44126),2,11,-9
2015,Teruel,Jarque de la Val (44128),0,3,-3
2015,Teruel,Jorcas (44130),1,2,-1
2015,Teruel,Josa (44131),0,1,-1
2015,Teruel,Lagueruela (44132),2,,2
2015,Teruel,Libros (44135),0,4,-4
2015,Teruel,Lidón (44136),0,1,-1
2015,Teruel,Linares de Mora (44137),0,4,-4
2015,Teruel,Lledó (44141),0,,0
2015,Teruel,Loscos (44138),0,4,-4
2015,Teruel,Manzanera (44143),4,5,-1
2015,Teruel,Martín del Río (44144),2,5,-3
2015,Teruel,Mas de las Matas (44145),8,17,-9
2015,Teruel,Mata de los Olmos (La) (44146),1,2,-1
2015,Teruel,Mazaleón (44147),1,8,-7
2015,Teruel,Mezquita de Jarque (44148),0,2,-2
2015,Teruel,Mirambel (44149),0,3,-3
2015,Teruel,Molinos (44151),0,4,-4
2015,Teruel,Monforte de Moyuela (44152),0,1,-1
2015,Teruel,Monreal del Campo (44153),31,53,-22
2015,Teruel,Monroyo (44154),2,3,-1
2015,Teruel,Montalbán (44155),9,21,-12
2015,Teruel,Monterde de Albarracín (44157),0,3,-3
2015,Teruel,Mora de Rubielos (44158),11,23,-12
2015,Teruel,Mosqueruela (44160),6,7,-1
2015,Teruel,Muniesa (44161),4,12,-8
2015,Teruel,Noguera de Albarracín (44163),0,1,-1
2015,Teruel,Nogueruelas (44165),1,2,-1
2015,Teruel,Obón (44167),0,3,-3
2015,Teruel,Ojos Negros (44169),3,6,-3
2015,Teruel,Olba (44171),1,3,-2
2015,Teruel,Oliete (44172),2,7,-5
2015,Teruel,Olmos (Los) (44173),1,1,0
2015,Teruel,Orihuela del Tremedal (44174),1,5,-4
2015,Teruel,Orrios (44175),0,3,-3
2015,Teruel,Palomar de Arroyos (44176),3,3,0
2015,Teruel,Pancrudo (44177),0,4,-4
2015,Teruel,Peralejos (44181),1,6,-5
2015,Teruel,Perales del Alfambra (44182),1,5,-4
2015,Teruel,Peñarroya de Tastavins (44179),2,8,-6
2015,Teruel,Pitarque (44183),0,2,-2
2015,Teruel,Pobo (El) (44185),1,,1
2015,Teruel,Portellada (La) (44187),1,3,-2
2015,Teruel,Pozondón (44189),0,3,-3
2015,Teruel,Pozuel del Campo (44190),0,4,-4
2015,Teruel,Puebla de Híjar (La) (44191),5,6,-1
2015,Teruel,Puebla de Valverde (La) (44192),3,7,-4
2015,Teruel,Puertomingalvo (44193),0,5,-5
2015,Teruel,Rillo (44195),0,5,-5
2015,Teruel,Riodeva (44196),0,5,-5
2015,Teruel,Royuela (44198),0,6,-6
2015,Teruel,Rubielos de Mora (44201),3,6,-3
2015,Teruel,Ráfales (44194),3,2,1
2015,Teruel,Ródenas (44197),1,3,-2
2015,Teruel,Samper de Calanda (44205),5,13,-8
2015,Teruel,San Agustín (44206),0,3,-3
2015,Teruel,San Martín del Río (44207),0,4,-4
2015,Teruel,Santa Cruz de Nogueras (44208),0,1,-1
2015,Teruel,Santa Eulalia (44209),3,16,-13
2015,Teruel,Sarrión (44210),17,14,3
2015,Teruel,Segura de los Baños (44211),0,1,-1
2015,Teruel,Seno (44212),0,3,-3
2015,Teruel,Singra (44213),0,3,-3
2015,Teruel,Terriente (44215),0,4,-4
2015,Teruel,Teruel (44216),325,338,-13
2015,Teruel,Tormón (44218),0,1,-1
2015,Teruel,Tornos (44219),0,6,-6
2015,Teruel,Torralba de los Sisones (44220),1,2,-1
2015,Teruel,Torre de las Arcas (44224),0,1,-1
2015,Teruel,Torre del Compte (44225),1,7,-6
2015,Teruel,Torrecilla de Alcañiz (44221),1,3,-2
2015,Teruel,Torrecilla del Rebollar (44222),0,1,-1
2015,Teruel,Torrelacárcel (44226),1,5,-4
2015,Teruel,Torremocha de Jiloca (44228),0,2,-2
2015,Teruel,Torres de Albarracín (44229),0,5,-5
2015,Teruel,Torrevelilla (44230),1,1,0
2015,Teruel,Torrijo del Campo (44232),1,6,-5
2015,Teruel,Tramacastiel (44234),0,1,-1
2015,Teruel,Tramacastilla (44235),0,3,-3
2015,Teruel,Tronchón (44236),0,3,-3
2015,Teruel,Urrea de Gaén (44237),0,9,-9
2015,Teruel,Utrillas (44238),20,38,-18
2015,Teruel,Valacloche (44239),0,1,-1
2015,Teruel,Valbona (44240),1,5,-4
2015,Teruel,Valdealgorfa (44241),2,11,-9
2015,Teruel,Valdecuenca (44243),0,1,-1
2015,Teruel,Valdelinares (44244),1,1,0
2015,Teruel,Valdeltormo (44245),1,10,-9
2015,Teruel,Valderrobres (44246),22,27,-5
2015,Teruel,Valjunquera (44247),2,5,-3
2015,Teruel,Veguillas de la Sierra (44250),0,1,-1
2015,Teruel,Villafranca del Campo (44251),2,4,-2
2015,Teruel,Villahermosa del Campo (44252),0,2,-2
2015,Teruel,Villar del Cobo (44257),2,4,-2
2015,Teruel,Villar del Salz (44258),1,1,0
2015,Teruel,Villarluengo (44260),2,3,-1
2015,Teruel,Villarquemado (44261),6,16,-10
2015,Teruel,Villarroya de los Pinares (44262),0,3,-3
2015,Teruel,Villastar (44263),6,4,2
2015,Teruel,Villel (44264),5,5,0
2015,Teruel,Vinaceite (44265),2,3,-1
2015,Teruel,Vivel del Río Martín (44267),0,4,-4
2014,Teruel,Ababuj (44001),1,,1
2014,Teruel,Abejuela (44002),1,,1
2014,Teruel,Aguaviva (44004),4,8,-4
2014,Teruel,Alacón (44006),0,8,-8
2014,Teruel,Alba (44007),0,1,-1
2014,Teruel,Albalate del Arzobispo (44008),12,23,-11
2014,Teruel,Albarracín (44009),8,13,-5
2014,Teruel,Albentosa (44010),4,4,0
2014,Teruel,Alcaine (44011),2,,2
2014,Teruel,Alcalá de la Selva (44012),0,3,-3
2014,Teruel,Alcañiz (44013),163,158,5
2014,Teruel,Alcorisa (44014),27,47,-20
2014,Teruel,Alfambra (44016),3,4,-1
2014,Teruel,Aliaga (44017),1,6,-5
2014,Teruel,Allepuz (44021),0,3,-3
2014,Teruel,Alloza (44022),3,5,-2
2014,Teruel,Almohaja (44018),0,1,-1
2014,Teruel,Alobras (44019),0,2,-2
2014,Teruel,Alpeñés (44020),0,1,-1
2014,Teruel,Andorra (44025),64,73,-9
2014,Teruel,Arcos de las Salinas (44026),1,,1
2014,Teruel,Arens de Lledó (44027),0,2,-2
2014,Teruel,Argente (44028),2,4,-2
2014,Teruel,Ariño (44029),6,14,-8
2014,Teruel,Azaila (44031),0,5,-5
2014,Teruel,Barrachina (44035),0,2,-2
2014,Teruel,Bañón (44034),0,6,-6
2014,Teruel,Bea (44036),0,1,-1
2014,Teruel,Beceite (44037),3,12,-9
2014,Teruel,Bello (44039),0,6,-6
2014,Teruel,Belmonte de San José (44038),0,2,-2
2014,Teruel,Berge (44040),0,3,-3
2014,Teruel,Blancas (44042),1,3,-2
2014,Teruel,Blesa (44043),0,1,-1
2014,Teruel,Bordón (44044),2,1,1
2014,Teruel,Bronchales (44045),0,4,-4
2014,Teruel,Bueña (44046),0,3,-3
2014,Teruel,Burbáguena (44047),1,20,-19
2014,Teruel,Báguena (44033),0,2,-2
2014,Teruel,Calaceite (44049),7,19,-12
2014,Teruel,Calamocha (44050),42,57,-15
2014,Teruel,Calanda (44051),33,56,-23
2014,Teruel,Calomarde (44052),0,3,-3
2014,Teruel,Camarena de la Sierra (44054),0,1,-1
2014,Teruel,Camarillas (44055),0,3,-3
2014,Teruel,Camañas (44053),0,1,-1
2014,Teruel,Caminreal (44056),2,11,-9
2014,Teruel,Cantavieja (44059),11,9,2
2014,Teruel,Cascante del Río (44064),0,1,-1
2014,Teruel,Castel de Cabra (44066),1,4,-3
2014,Teruel,Castellar (El) (44070),0,,0
2014,Teruel,Castellote (44071),2,9,-7
2014,Teruel,Castelnou (44067),1,1,0
2014,Teruel,Castelserás (44068),13,6,7
2014,Teruel,Cañada de Verich (La) (44061),0,5,-5
2014,Teruel,Cañada Vellida (44062),0,3,-3
2014,Teruel,Cañizar del Olivar (44063),1,2,-1
2014,Teruel,Cedrillas (44074),2,9,-7
2014,Teruel,Celadas (44075),1,4,-3
2014,Teruel,Cella (44076),14,40,-26
2014,Teruel,Cerollera (La) (44077),1,1,0
2014,Teruel,Codoñera (La) (44080),3,11,-8
2014,Teruel,Corbalán (44082),0,3,-3
2014,Teruel,Cortes de Aragón (44084),0,4,-4
2014,Teruel,Cosa (44085),0,3,-3
2014,Teruel,Cretas (44086),2,7,-5
2014,Teruel,Crivillén (44087),0,1,-1
2014,Teruel,Cuba (La) (44088),1,2,-1
2014,Teruel,Cubla (44089),0,2,-2
2014,Teruel,Cucalón (44090),0,1,-1
2014,Teruel,Cuervo (El) (44092),0,3,-3
2014,Teruel,Cuevas de Almudén (44093),1,1,0
2014,Teruel,Cuevas Labradas (44094),0,2,-2
2014,Teruel,Ejulve (44096),2,2,0
2014,Teruel,Escorihuela (44097),0,4,-4
2014,Teruel,Escucha (44099),6,10,-4
2014,Teruel,Estercuel (44100),0,3,-3
2014,Teruel,Ferreruela de Huerva (44101),0,2,-2
2014,Teruel,Formiche Alto (44103),0,1,-1
2014,Teruel,Fortanete (44106),2,5,-3
2014,Teruel,Foz-Calanda (44107),1,3,-2
2014,Teruel,Fresneda (La) (44108),5,5,0
2014,Teruel,Frías de Albarracín (44109),2,4,-2
2014,Teruel,Fuentes Calientes (44111),0,4,-4
2014,Teruel,Fuentes Claras (44112),0,10,-10
2014,Teruel,Fuentes de Rubielos (44113),0,2,-2
2014,Teruel,Fuentespalda (44114),0,6,-6
2014,Teruel,Galve (44115),1,1,0
2014,Teruel,Gargallo (44116),1,2,-1
2014,Teruel,Gea de Albarracín (44117),0,7,-7
2014,Teruel,Ginebrosa (La) (44118),1,3,-2
2014,Teruel,Griegos (44119),1,,1
2014,Teruel,Guadalaviar (44120),2,2,0
2014,Teruel,Hinojosa de Jarque (44123),0,3,-3
2014,Teruel,Hoz de la Vieja (La) (44124),1,,1
2014,Teruel,Huesa del Común (44125),0,2,-2
2014,Teruel,Híjar (44122),12,27,-15
2014,Teruel,Iglesuela del Cid (La) (44126),2,8,-6
2014,Teruel,Jabaloyas (44127),0,1,-1
2014,Teruel,Jarque de la Val (44128),1,2,-1
2014,Teruel,Jatiel (44129),0,2,-2
2014,Teruel,Jorcas (44130),0,1,-1
2014,Teruel,Libros (44135),0,4,-4
2014,Teruel,Linares de Mora (44137),2,3,-1
2014,Teruel,Lledó (44141),2,3,-1
2014,Teruel,Loscos (44138),1,1,0
2014,Teruel,Manzanera (44143),3,7,-4
2014,Teruel,Martín del Río (44144),3,3,0
2014,Teruel,Mas de las Matas (44145),15,16,-1
2014,Teruel,Mata de los Olmos (La) (44146),4,2,2
2014,Teruel,Mazaleón (44147),3,4,-1
2014,Teruel,Mezquita de Jarque (44148),1,6,-5
2014,Teruel,Mirambel (44149),1,2,-1
2014,Teruel,Miravete de la Sierra (44150),0,2,-2
2014,Teruel,Molinos (44151),1,,1
2014,Teruel,Monreal del Campo (44153),30,33,-3
2014,Teruel,Monroyo (44154),1,,1
2014,Teruel,Montalbán (44155),13,17,-4
2014,Teruel,Monteagudo del Castillo (44156),0,2,-2
2014,Teruel,Monterde de Albarracín (44157),0,1,-1
2014,Teruel,Mora de Rubielos (44158),18,15,3
2014,Teruel,Moscardón (44159),0,1,-1
2014,Teruel,Mosqueruela (44160),3,4,-1
2014,Teruel,Muniesa (44161),7,12,-5
2014,Teruel,Nogueruelas (44165),0,1,-1
2014,Teruel,Odón (44168),2,7,-5
2014,Teruel,Ojos Negros (44169),2,13,-11
2014,Teruel,Olba (44171),1,1,0
2014,Teruel,Oliete (44172),1,9,-8
2014,Teruel,Olmos (Los) (44173),2,4,-2
2014,Teruel,Orihuela del Tremedal (44174),4,8,-4
2014,Teruel,Orrios (44175),0,2,-2
2014,Teruel,Palomar de Arroyos (44176),1,,1
2014,Teruel,Pancrudo (44177),1,3,-2
2014,Teruel,Peracense (44180),0,1,-1
2014,Teruel,Perales del Alfambra (44182),0,3,-3
2014,Teruel,Peñarroya de Tastavins (44179),4,4,0
2014,Teruel,Pitarque (44183),0,2,-2
2014,Teruel,Pobo (El) (44185),0,1,-1
2014,Teruel,Portellada (La) (44187),3,3,0
2014,Teruel,Pozondón (44189),0,3,-3
2014,Teruel,Pozuel del Campo (44190),0,1,-1
2014,Teruel,Puebla de Híjar (La) (44191),2,14,-12
2014,Teruel,Puebla de Valverde (La) (44192),1,5,-4
2014,Teruel,Puertomingalvo (44193),0,3,-3
2014,Teruel,Rillo (44195),0,6,-6
2014,Teruel,Riodeva (44196),3,3,0
2014,Teruel,Royuela (44198),1,5,-4
2014,Teruel,Rubielos de Mora (44201),7,4,3
2014,Teruel,Ráfales (44194),0,3,-3
2014,Teruel,Ródenas (44197),0,2,-2
2014,Teruel,Saldón (44204),0,1,-1
2014,Teruel,Samper de Calanda (44205),3,17,-14
2014,Teruel,San Agustín (44206),1,2,-1
2014,Teruel,San Martín del Río (44207),0,6,-6
2014,Teruel,Santa Cruz de Nogueras (44208),0,2,-2
2014,Teruel,Santa Eulalia (44209),8,20,-12
2014,Teruel,Sarrión (44210),14,12,2
2014,Teruel,Segura de los Baños (44211),1,,1
2014,Teruel,Seno (44212),0,1,-1
2014,Teruel,Singra (44213),0,2,-2
2014,Teruel,Terriente (44215),0,2,-2
2014,Teruel,Teruel (44216),356,308,48
2014,Teruel,Tormón (44218),0,1,-1
2014,Teruel,Tornos (44219),0,2,-2
2014,Teruel,Torralba de los Sisones (44220),0,3,-3
2014,Teruel,Torre de Arcas (44223),0,1,-1
2014,Teruel,Torre de las Arcas (44224),0,1,-1
2014,Teruel,Torre del Compte (44225),0,1,-1
2014,Teruel,Torre los Negros (44227),0,1,-1
2014,Teruel,Torrecilla de Alcañiz (44221),0,5,-5
2014,Teruel,Torrecilla del Rebollar (44222),0,1,-1
2014,Teruel,Torrelacárcel (44226),2,7,-5
2014,Teruel,Torremocha de Jiloca (44228),1,4,-3
2014,Teruel,Torres de Albarracín (44229),0,3,-3
2014,Teruel,Torrevelilla (44230),2,3,-1
2014,Teruel,Torrijas (44231),0,4,-4
2014,Teruel,Torrijo del Campo (44232),2,7,-5
2014,Teruel,Tramacastiel (44234),0,5,-5
2014,Teruel,Tramacastilla (44235),0,1,-1
2014,Teruel,Tronchón (44236),0,1,-1
2014,Teruel,Urrea de Gaén (44237),0,9,-9
2014,Teruel,Utrillas (44238),30,28,2
2014,Teruel,Valacloche (44239),0,1,-1
2014,Teruel,Valbona (44240),1,,1
2014,Teruel,Valdealgorfa (44241),5,6,-1
2014,Teruel,Valdecuenca (44243),0,1,-1
2014,Teruel,Valdelinares (44244),0,5,-5
2014,Teruel,Valdeltormo (44245),4,7,-3
2014,Teruel,Valderrobres (44246),28,28,0
2014,Teruel,Valjunquera (44247),1,11,-10
2014,Teruel,Villafranca del Campo (44251),1,3,-2
2014,Teruel,Villahermosa del Campo (44252),1,1,0
2014,Teruel,Villanueva del Rebollar de la Sierra (44256),0,1,-1
2014,Teruel,Villar del Cobo (44257),0,2,-2
2014,Teruel,Villar del Salz (44258),1,2,-1
2014,Teruel,Villarluengo (44260),0,3,-3
2014,Teruel,Villarquemado (44261),5,16,-11
2014,Teruel,Villarroya de los Pinares (44262),0,3,-3
2014,Teruel,Villastar (44263),10,7,3
2014,Teruel,Villel (44264),3,4,-1
2014,Teruel,Vinaceite (44265),1,1,0
2014,Teruel,Visiedo (44266),0,1,-1
2014,Teruel,Vivel del Río Martín (44267),0,2,-2
2013,Teruel,Ababuj (44001),1,,1
2013,Teruel,Abejuela (44002),0,1,-1
2013,Teruel,Aguatón (44003),0,1,-1
2013,Teruel,Aguaviva (44004),4,8,-4
2013,Teruel,Aguilar del Alfambra (44005),0,1,-1
2013,Teruel,Alacón (44006),0,3,-3
2013,Teruel,Alba (44007),0,5,-5
2013,Teruel,Albalate del Arzobispo (44008),13,37,-24
2013,Teruel,Albarracín (44009),7,20,-13
2013,Teruel,Albentosa (44010),2,4,-2
2013,Teruel,Alcaine (44011),2,,2
2013,Teruel,Alcalá de la Selva (44012),2,9,-7
2013,Teruel,Alcañiz (44013),168,148,20
2013,Teruel,Alcorisa (44014),27,38,-11
2013,Teruel,Alfambra (44016),1,7,-6
2013,Teruel,Aliaga (44017),5,2,3
2013,Teruel,Allepuz (44021),0,4,-4
2013,Teruel,Alloza (44022),1,15,-14
2013,Teruel,Almohaja (44018),0,1,-1
2013,Teruel,Alobras (44019),0,1,-1
2013,Teruel,Andorra (44025),76,72,4
2013,Teruel,Arcos de las Salinas (44026),0,2,-2
2013,Teruel,Arens de Lledó (44027),0,3,-3
2013,Teruel,Argente (44028),0,5,-5
2013,Teruel,Ariño (44029),2,9,-7
2013,Teruel,Azaila (44031),0,2,-2
2013,Teruel,Barrachina (44035),0,4,-4
2013,Teruel,Bañón (44034),0,5,-5
2013,Teruel,Beceite (44037),7,10,-3
2013,Teruel,Bello (44039),0,7,-7
2013,Teruel,Belmonte de San José (44038),0,2,-2
2013,Teruel,Berge (44040),0,2,-2
2013,Teruel,Bezas (44041),0,1,-1
2013,Teruel,Blancas (44042),0,3,-3
2013,Teruel,Blesa (44043),0,1,-1
2013,Teruel,Bordón (44044),0,2,-2
2013,Teruel,Bronchales (44045),2,4,-2
2013,Teruel,Bueña (44046),0,1,-1
2013,Teruel,Burbáguena (44047),0,15,-15
2013,Teruel,Bádenas (44032),1,1,0
2013,Teruel,Báguena (44033),1,9,-8
2013,Teruel,Cabra de Mora (44048),1,1,0
2013,Teruel,Calaceite (44049),5,19,-14
2013,Teruel,Calamocha (44050),31,42,-11
2013,Teruel,Calanda (44051),32,50,-18
2013,Teruel,Calomarde (44052),0,2,-2
2013,Teruel,Camañas (44053),0,2,-2
2013,Teruel,Caminreal (44056),4,13,-9
2013,Teruel,Cantavieja (44059),6,13,-7
2013,Teruel,Cascante del Río (44064),0,1,-1
2013,Teruel,Castel de Cabra (44066),0,2,-2
2013,Teruel,Castellar (El) (44070),0,1,-1
2013,Teruel,Castellote (44071),3,16,-13
2013,Teruel,Castelnou (44067),1,2,-1
2013,Teruel,Castelserás (44068),7,11,-4
2013,Teruel,Cañada de Benatanduz (44060),0,1,-1
2013,Teruel,Cañada de Verich (La) (44061),0,2,-2
2013,Teruel,Cañada Vellida (44062),0,1,-1
2013,Teruel,Cañizar del Olivar (44063),0,2,-2
2013,Teruel,Cedrillas (44074),5,8,-3
2013,Teruel,Celadas (44075),2,6,-4
2013,Teruel,Cella (44076),16,28,-12
2013,Teruel,Cerollera (La) (44077),0,2,-2
2013,Teruel,Codoñera (La) (44080),3,2,1
2013,Teruel,Corbalán (44082),1,,1
2013,Teruel,Cortes de Aragón (44084),0,4,-4
2013,Teruel,Cosa (44085),0,3,-3
2013,Teruel,Cretas (44086),4,10,-6
2013,Teruel,Cuba (La) (44088),0,2,-2
2013,Teruel,Cucalón (44090),1,2,-1
2013,Teruel,Cuervo (El) (44092),0,4,-4
2013,Teruel,Cuevas de Almudén (44093),3,1,2
2013,Teruel,Cuevas Labradas (44094),0,1,-1
2013,Teruel,Ejulve (44096),1,4,-3
2013,Teruel,Escorihuela (44097),1,2,-1
2013,Teruel,Escucha (44099),8,10,-2
2013,Teruel,Estercuel (44100),3,3,0
2013,Teruel,Ferreruela de Huerva (44101),0,1,-1
2013,Teruel,Formiche Alto (44103),0,3,-3
2013,Teruel,Fortanete (44106),1,1,0
2013,Teruel,Foz-Calanda (44107),2,2,0
2013,Teruel,Fresneda (La) (44108),5,4,1
2013,Teruel,Frías de Albarracín (44109),2,2,0
2013,Teruel,Fuenferrada (44110),1,,1
2013,Teruel,Fuentes Calientes (44111),1,2,-1
2013,Teruel,Fuentes Claras (44112),2,7,-5
2013,Teruel,Fuentes de Rubielos (44113),1,1,0
2013,Teruel,Fuentespalda (44114),1,5,-4
2013,Teruel,Galve (44115),2,2,0
2013,Teruel,Gargallo (44116),1,3,-2
2013,Teruel,Gea de Albarracín (44117),2,6,-4
2013,Teruel,Ginebrosa (La) (44118),1,,1
2013,Teruel,Guadalaviar (44120),2,1,1
2013,Teruel,Gúdar (44121),2,1,1
2013,Teruel,Hinojosa de Jarque (44123),1,4,-3
2013,Teruel,Hoz de la Vieja (La) (44124),0,1,-1
2013,Teruel,Huesa del Común (44125),0,2,-2
2013,Teruel,Híjar (44122),15,20,-5
2013,Teruel,Iglesuela del Cid (La) (44126),0,3,-3
2013,Teruel,Jarque de la Val (44128),0,2,-2
2013,Teruel,Jatiel (44129),0,1,-1
2013,Teruel,Jorcas (44130),0,1,-1
2013,Teruel,Josa (44131),0,1,-1
2013,Teruel,Libros (44135),0,4,-4
2013,Teruel,Lidón (44136),0,1,-1
2013,Teruel,Linares de Mora (44137),1,6,-5
2013,Teruel,Lledó (44141),3,5,-2
2013,Teruel,Loscos (44138),0,3,-3
2013,Teruel,Manzanera (44143),3,7,-4
2013,Teruel,Martín del Río (44144),0,4,-4
2013,Teruel,Mas de las Matas (44145),13,20,-7
2013,Teruel,Mata de los Olmos (La) (44146),6,4,2
2013,Teruel,Mazaleón (44147),1,9,-8
2013,Teruel,Mezquita de Jarque (44148),2,2,0
2013,Teruel,Mirambel (44149),1,1,0
2013,Teruel,Molinos (44151),3,4,-1
2013,Teruel,Monforte de Moyuela (44152),0,1,-1
2013,Teruel,Monreal del Campo (44153),28,38,-10
2013,Teruel,Monroyo (44154),3,5,-2
2013,Teruel,Montalbán (44155),7,19,-12
2013,Teruel,Monteagudo del Castillo (44156),0,1,-1
2013,Teruel,Monterde de Albarracín (44157),0,1,-1
2013,Teruel,Mora de Rubielos (44158),16,20,-4
2013,Teruel,Mosqueruela (44160),4,3,1
2013,Teruel,Muniesa (44161),5,7,-2
2013,Teruel,Noguera de Albarracín (44163),0,1,-1
2013,Teruel,Nogueruelas (44165),1,3,-2
2013,Teruel,Obón (44167),0,4,-4
2013,Teruel,Odón (44168),1,3,-2
2013,Teruel,Ojos Negros (44169),0,6,-6
2013,Teruel,Olba (44171),3,3,0
2013,Teruel,Oliete (44172),0,9,-9
2013,Teruel,Olmos (Los) (44173),0,5,-5
2013,Teruel,Orihuela del Tremedal (44174),1,6,-5
2013,Teruel,Orrios (44175),0,4,-4
2013,Teruel,Palomar de Arroyos (44176),2,,2
2013,Teruel,Pancrudo (44177),0,2,-2
2013,Teruel,Parras de Castellote (Las) (44178),0,2,-2
2013,Teruel,Perales del Alfambra (44182),0,3,-3
2013,Teruel,Peñarroya de Tastavins (44179),4,7,-3
2013,Teruel,Pitarque (44183),0,,0
2013,Teruel,Plou (44184),1,,1
2013,Teruel,Pobo (El) (44185),1,3,-2
2013,Teruel,Portellada (La) (44187),5,4,1
2013,Teruel,Pozondón (44189),1,1,0
2013,Teruel,Pozuel del Campo (44190),0,1,-1
2013,Teruel,Puebla de Híjar (La) (44191),9,20,-11
2013,Teruel,Puebla de Valverde (La) (44192),2,7,-5
2013,Teruel,Puertomingalvo (44193),1,,1
2013,Teruel,Rillo (44195),0,1,-1
2013,Teruel,Riodeva (44196),1,4,-3
2013,Teruel,Royuela (44198),2,3,-1
2013,Teruel,Rubielos de la Cérida (44200),0,1,-1
2013,Teruel,Rubielos de Mora (44201),8,9,-1
2013,Teruel,Ráfales (44194),0,1,-1
2013,Teruel,Ródenas (44197),1,,1
2013,Teruel,Samper de Calanda (44205),5,10,-5
2013,Teruel,San Agustín (44206),0,3,-3
2013,Teruel,San Martín del Río (44207),0,3,-3
2013,Teruel,Santa Cruz de Nogueras (44208),0,1,-1
2013,Teruel,Santa Eulalia (44209),8,15,-7
2013,Teruel,Sarrión (44210),16,14,2
2013,Teruel,Singra (44213),0,1,-1
2013,Teruel,Terriente (44215),2,1,1
2013,Teruel,Teruel (44216),353,339,14
2013,Teruel,Toril y Masegoso (44217),0,1,-1
2013,Teruel,Tormón (44218),0,2,-2
2013,Teruel,Torralba de los Sisones (44220),1,4,-3
2013,Teruel,Torre de Arcas (44223),0,3,-3
2013,Teruel,Torre del Compte (44225),1,2,-1
2013,Teruel,Torre los Negros (44227),1,,1
2013,Teruel,Torrecilla de Alcañiz (44221),2,7,-5
2013,Teruel,Torrecilla del Rebollar (44222),0,2,-2
2013,Teruel,Torrelacárcel (44226),3,6,-3
2013,Teruel,Torremocha de Jiloca (44228),0,4,-4
2013,Teruel,Torres de Albarracín (44229),1,1,0
2013,Teruel,Torrevelilla (44230),1,3,-2
2013,Teruel,Torrijo del Campo (44232),2,8,-6
2013,Teruel,Tramacastiel (44234),0,2,-2
2013,Teruel,Tramacastilla (44235),0,1,-1
2013,Teruel,Tronchón (44236),0,1,-1
2013,Teruel,Urrea de Gaén (44237),2,11,-9
2013,Teruel,Utrillas (44238),19,32,-13
2013,Teruel,Valbona (44240),0,1,-1
2013,Teruel,Valdealgorfa (44241),3,11,-8
2013,Teruel,Valdecuenca (44243),0,1,-1
2013,Teruel,Valdelinares (44244),1,1,0
2013,Teruel,Valdeltormo (44245),1,7,-6
2013,Teruel,Valderrobres (44246),27,37,-10
2013,Teruel,Valjunquera (44247),0,9,-9
2013,Teruel,Veguillas de la Sierra (44250),0,2,-2
2013,Teruel,Villafranca del Campo (44251),2,6,-4
2013,Teruel,Villahermosa del Campo (44252),0,1,-1
2013,Teruel,Villanueva del Rebollar de la Sierra (44256),1,1,0
2013,Teruel,Villar del Cobo (44257),1,4,-3
2013,Teruel,Villarluengo (44260),3,1,2
2013,Teruel,Villarquemado (44261),5,12,-7
2013,Teruel,Villarroya de los Pinares (44262),2,3,-1
2013,Teruel,Villastar (44263),11,4,7
2013,Teruel,Villel (44264),4,5,-1
2013,Teruel,Vinaceite (44265),2,3,-1
2013,Teruel,Visiedo (44266),2,4,-2
2012,Teruel,Abejuela (44002),0,1,-1
2012,Teruel,Aguaviva (44004),4,7,-3
2012,Teruel,Aguilar del Alfambra (44005),0,1,-1
2012,Teruel,Alacón (44006),1,9,-8
2012,Teruel,Alba (44007),1,10,-9
2012,Teruel,Albalate del Arzobispo (44008),17,35,-18
2012,Teruel,Albarracín (44009),8,19,-11
2012,Teruel,Albentosa (44010),5,,5
2012,Teruel,Alcaine (44011),0,1,-1
2012,Teruel,Alcalá de la Selva (44012),0,6,-6
2012,Teruel,Alcañiz (44013),188,171,17
2012,Teruel,Alcorisa (44014),27,34,-7
2012,Teruel,Alfambra (44016),4,14,-10
2012,Teruel,Aliaga (44017),1,11,-10
2012,Teruel,Allepuz (44021),1,,1
2012,Teruel,Alloza (44022),3,8,-5
2012,Teruel,Alobras (44019),0,,0
2012,Teruel,Andorra (44025),79,79,0
2012,Teruel,Arcos de las Salinas (44026),1,2,-1
2012,Teruel,Arens de Lledó (44027),1,2,-1
2012,Teruel,Argente (44028),1,5,-4
2012,Teruel,Ariño (44029),4,9,-5
2012,Teruel,Azaila (44031),0,6,-6
2012,Teruel,Barrachina (44035),0,1,-1
2012,Teruel,Bañón (44034),3,3,0
2012,Teruel,Beceite (44037),1,8,-7
2012,Teruel,Bello (44039),0,10,-10
2012,Teruel,Belmonte de San José (44038),0,3,-3
2012,Teruel,Berge (44040),5,6,-1
2012,Teruel,Bezas (44041),0,1,-1
2012,Teruel,Blancas (44042),0,1,-1
2012,Teruel,Blesa (44043),0,1,-1
2012,Teruel,Bordón (44044),1,2,-1
2012,Teruel,Bronchales (44045),3,3,0
2012,Teruel,Burbáguena (44047),0,22,-22
2012,Teruel,Bádenas (44032),0,1,-1
2012,Teruel,Báguena (44033),2,5,-3
2012,Teruel,Cabra de Mora (44048),1,,1
2012,Teruel,Calaceite (44049),14,14,0
2012,Teruel,Calamocha (44050),43,50,-7
2012,Teruel,Calanda (44051),23,38,-15
2012,Teruel,Calomarde (44052),0,1,-1
2012,Teruel,Camarena de la Sierra (44054),2,3,-1
2012,Teruel,Camarillas (44055),0,2,-2
2012,Teruel,Camañas (44053),2,1,1
2012,Teruel,Caminreal (44056),3,12,-9
2012,Teruel,Cantavieja (44059),9,9,0
2012,Teruel,Cascante del Río (44064),0,2,-2
2012,Teruel,Castejón de Tornos (44065),0,1,-1
2012,Teruel,Castel de Cabra (44066),1,4,-3
2012,Teruel,Castellote (44071),2,15,-13
2012,Teruel,Castelnou (44067),2,1,1
2012,Teruel,Castelserás (44068),6,14,-8
2012,Teruel,Cañada de Benatanduz (44060),0,2,-2
2012,Teruel,Cañada de Verich (La) (44061),0,4,-4
2012,Teruel,Cedrillas (44074),1,10,-9
2012,Teruel,Celadas (44075),1,4,-3
2012,Teruel,Cella (44076),20,37,-17
2012,Teruel,Cerollera (La) (44077),0,2,-2
2012,Teruel,Codoñera (La) (44080),4,5,-1
2012,Teruel,Corbalán (44082),1,1,0
2012,Teruel,Cosa (44085),0,1,-1
2012,Teruel,Cretas (44086),6,12,-6
2012,Teruel,Crivillén (44087),0,3,-3
2012,Teruel,Cubla (44089),0,,0
2012,Teruel,Cuervo (El) (44092),1,3,-2
2012,Teruel,Cuevas de Almudén (44093),0,,0
2012,Teruel,Cuevas Labradas (44094),0,2,-2
2012,Teruel,Ejulve (44096),0,3,-3
2012,Teruel,Escorihuela (44097),0,3,-3
2012,Teruel,Escucha (44099),4,10,-6
2012,Teruel,Estercuel (44100),2,2,0
2012,Teruel,Ferreruela de Huerva (44101),0,1,-1
2012,Teruel,Formiche Alto (44103),0,4,-4
2012,Teruel,Fortanete (44106),1,3,-2
2012,Teruel,Foz-Calanda (44107),1,2,-1
2012,Teruel,Fresneda (La) (44108),2,5,-3
2012,Teruel,Frías de Albarracín (44109),1,2,-1
2012,Teruel,Fuenferrada (44110),0,3,-3
2012,Teruel,Fuentes Calientes (44111),1,2,-1
2012,Teruel,Fuentes Claras (44112),4,8,-4
2012,Teruel,Fuentes de Rubielos (44113),1,1,0
2012,Teruel,Fuentespalda (44114),4,4,0
2012,Teruel,Fórnoles (44105),1,4,-3
2012,Teruel,Galve (44115),0,3,-3
2012,Teruel,Gargallo (44116),2,,2
2012,Teruel,Gea de Albarracín (44117),1,6,-5
2012,Teruel,Ginebrosa (La) (44118),0,3,-3
2012,Teruel,Griegos (44119),2,1,1
2012,Teruel,Guadalaviar (44120),4,3,1
2012,Teruel,Gúdar (44121),2,,2
2012,Teruel,Hinojosa de Jarque (44123),1,,1
2012,Teruel,Hoz de la Vieja (La) (44124),0,3,-3
2012,Teruel,Huesa del Común (44125),0,1,-1
2012,Teruel,Híjar (44122),15,34,-19
2012,Teruel,Iglesuela del Cid (La) (44126),3,9,-6
2012,Teruel,Jorcas (44130),0,1,-1
2012,Teruel,Josa (44131),0,1,-1
2012,Teruel,Lanzuela (44133),1,,1
2012,Teruel,Libros (44135),0,3,-3
2012,Teruel,Lidón (44136),1,1,0
2012,Teruel,Linares de Mora (44137),2,4,-2
2012,Teruel,Lledó (44141),0,4,-4
2012,Teruel,Loscos (44138),0,3,-3
2012,Teruel,Manzanera (44143),3,8,-5
2012,Teruel,Martín del Río (44144),2,6,-4
2012,Teruel,Mas de las Matas (44145),10,31,-21
2012,Teruel,Mata de los Olmos (La) (44146),4,2,2
2012,Teruel,Mazaleón (44147),4,6,-2
2012,Teruel,Mezquita de Jarque (44148),1,2,-1
2012,Teruel,Mirambel (44149),1,3,-2
2012,Teruel,Miravete de la Sierra (44150),0,2,-2
2012,Teruel,Molinos (44151),4,5,-1
2012,Teruel,Monreal del Campo (44153),26,41,-15
2012,Teruel,Monroyo (44154),1,4,-3
2012,Teruel,Montalbán (44155),5,9,-4
2012,Teruel,Monteagudo del Castillo (44156),0,1,-1
2012,Teruel,Mora de Rubielos (44158),14,17,-3
2012,Teruel,Moscardón (44159),1,1,0
2012,Teruel,Mosqueruela (44160),2,5,-3
2012,Teruel,Muniesa (44161),3,18,-15
2012,Teruel,Noguera de Albarracín (44163),0,3,-3
2012,Teruel,Nogueruelas (44165),0,2,-2
2012,Teruel,Obón (44167),0,1,-1
2012,Teruel,Odón (44168),0,2,-2
2012,Teruel,Ojos Negros (44169),2,10,-8
2012,Teruel,Olba (44171),2,1,1
2012,Teruel,Oliete (44172),0,5,-5
2012,Teruel,Olmos (Los) (44173),1,1,0
2012,Teruel,Orihuela del Tremedal (44174),4,5,-1
2012,Teruel,Orrios (44175),0,4,-4
2012,Teruel,Palomar de Arroyos (44176),0,1,-1
2012,Teruel,Pancrudo (44177),0,2,-2
2012,Teruel,Parras de Castellote (Las) (44178),0,3,-3
2012,Teruel,Peracense (44180),0,2,-2
2012,Teruel,Peralejos (44181),0,1,-1
2012,Teruel,Perales del Alfambra (44182),1,2,-1
2012,Teruel,Peñarroya de Tastavins (44179),6,5,1
2012,Teruel,Plou (44184),1,,1
2012,Teruel,Pobo (El) (44185),1,3,-2
2012,Teruel,Portellada (La) (44187),0,6,-6
2012,Teruel,Pozondón (44189),0,3,-3
2012,Teruel,Puebla de Híjar (La) (44191),6,23,-17
2012,Teruel,Puebla de Valverde (La) (44192),7,5,2
2012,Teruel,Puertomingalvo (44193),0,2,-2
2012,Teruel,Rillo (44195),1,2,-1
2012,Teruel,Riodeva (44196),0,,0
2012,Teruel,Royuela (44198),0,2,-2
2012,Teruel,Rubiales (44199),0,2,-2
2012,Teruel,Rubielos de la Cérida (44200),0,1,-1
2012,Teruel,Rubielos de Mora (44201),3,6,-3
2012,Teruel,Ráfales (44194),2,3,-1
2012,Teruel,Ródenas (44197),1,2,-1
2012,Teruel,Samper de Calanda (44205),1,8,-7
2012,Teruel,San Martín del Río (44207),1,4,-3
2012,Teruel,Santa Eulalia (44209),5,21,-16
2012,Teruel,Sarrión (44210),17,9,8
2012,Teruel,Segura de los Baños (44211),0,1,-1
2012,Teruel,Seno (44212),0,2,-2
2012,Teruel,Singra (44213),0,1,-1
2012,Teruel,Terriente (44215),1,4,-3
2012,Teruel,Teruel (44216),331,318,13
2012,Teruel,Tormón (44218),0,1,-1
2012,Teruel,Tornos (44219),0,2,-2
2012,Teruel,Torralba de los Sisones (44220),1,5,-4
2012,Teruel,Torre de Arcas (44223),0,2,-2
2012,Teruel,Torre de las Arcas (44224),1,,1
2012,Teruel,Torre del Compte (44225),0,6,-6
2012,Teruel,Torre los Negros (44227),0,1,-1
2012,Teruel,Torrecilla de Alcañiz (44221),0,6,-6
2012,Teruel,Torrelacárcel (44226),1,4,-3
2012,Teruel,Torremocha de Jiloca (44228),0,4,-4
2012,Teruel,Torres de Albarracín (44229),2,3,-1
2012,Teruel,Torrevelilla (44230),2,3,-1
2012,Teruel,Torrijas (44231),0,3,-3
2012,Teruel,Torrijo del Campo (44232),3,5,-2
2012,Teruel,Tramacastiel (44234),0,3,-3
2012,Teruel,Tramacastilla (44235),0,3,-3
2012,Teruel,Tronchón (44236),0,1,-1
2012,Teruel,Urrea de Gaén (44237),2,8,-6
2012,Teruel,Utrillas (44238),36,25,11
2012,Teruel,Valbona (44240),1,6,-5
2012,Teruel,Valdealgorfa (44241),3,5,-2
2012,Teruel,Valdecuenca (44243),0,1,-1
2012,Teruel,Valdelinares (44244),1,,1
2012,Teruel,Valdeltormo (44245),2,5,-3
2012,Teruel,Valderrobres (44246),22,37,-15
2012,Teruel,Valjunquera (44247),2,9,-7
2012,Teruel,Veguillas de la Sierra (44250),0,2,-2
2012,Teruel,Villafranca del Campo (44251),1,5,-4
2012,Teruel,Villar del Cobo (44257),1,,1
2012,Teruel,Villar del Salz (44258),0,2,-2
2012,Teruel,Villarluengo (44260),3,1,2
2012,Teruel,Villarquemado (44261),4,12,-8
2012,Teruel,Villarroya de los Pinares (44262),0,1,-1
2012,Teruel,Villastar (44263),11,1,10
2012,Teruel,Villel (44264),2,7,-5
2012,Teruel,Vinaceite (44265),1,6,-5
2012,Teruel,Visiedo (44266),0,2,-2
2011,Teruel,Ababuj (44001),0,1,-1
2011,Teruel,Abejuela (44002),0,1,-1
2011,Teruel,Aguaviva (44004),7,9,-2
2011,Teruel,Aguilar del Alfambra (44005),0,2,-2
2011,Teruel,Alacón (44006),1,9,-8
2011,Teruel,Alba (44007),1,3,-2
2011,Teruel,Albalate del Arzobispo (44008),14,29,-15
2011,Teruel,Albarracín (44009),11,18,-7
2011,Teruel,Albentosa (44010),2,2,0
2011,Teruel,Alcaine (44011),0,,0
2011,Teruel,Alcalá de la Selva (44012),2,2,0
2011,Teruel,Alcañiz (44013),187,158,29
2011,Teruel,Alcorisa (44014),33,32,1
2011,Teruel,Alfambra (44016),0,8,-8
2011,Teruel,Aliaga (44017),2,14,-12
2011,Teruel,Allepuz (44021),0,1,-1
2011,Teruel,Alloza (44022),5,11,-6
2011,Teruel,Almohaja (44018),0,1,-1
2011,Teruel,Alobras (44019),0,2,-2
2011,Teruel,Alpeñés (44020),0,1,-1
2011,Teruel,Andorra (44025),54,77,-23
2011,Teruel,Argente (44028),1,6,-5
2011,Teruel,Ariño (44029),5,14,-9
2011,Teruel,Azaila (44031),0,11,-11
2011,Teruel,Barrachina (44035),1,3,-2
2011,Teruel,Beceite (44037),4,9,-5
2011,Teruel,Bello (44039),1,4,-3
2011,Teruel,Belmonte de San José (44038),0,3,-3
2011,Teruel,Berge (44040),0,3,-3
2011,Teruel,Bezas (44041),0,1,-1
2011,Teruel,Blancas (44042),2,1,1
2011,Teruel,Blesa (44043),0,1,-1
2011,Teruel,Bordón (44044),0,1,-1
2011,Teruel,Bronchales (44045),1,2,-1
2011,Teruel,Bueña (44046),0,3,-3
2011,Teruel,Burbáguena (44047),0,14,-14
2011,Teruel,Bádenas (44032),1,,1
2011,Teruel,Báguena (44033),1,6,-5
2011,Teruel,Cabra de Mora (44048),0,1,-1
2011,Teruel,Calaceite (44049),8,25,-17
2011,Teruel,Calamocha (44050),42,49,-7
2011,Teruel,Calanda (44051),37,50,-13
2011,Teruel,Camarena de la Sierra (44054),0,,0
2011,Teruel,Camarillas (44055),0,4,-4
2011,Teruel,Camañas (44053),2,1,1
2011,Teruel,Caminreal (44056),5,5,0
2011,Teruel,Cantavieja (44059),5,5,0
2011,Teruel,Cascante del Río (44064),0,1,-1
2011,Teruel,Castejón de Tornos (44065),0,1,-1
2011,Teruel,Castel de Cabra (44066),1,1,0
2011,Teruel,Castellar (El) (44070),0,3,-3
2011,Teruel,Castellote (44071),6,17,-11
2011,Teruel,Castelnou (44067),3,2,1
2011,Teruel,Castelserás (44068),9,9,0
2011,Teruel,Cañada de Benatanduz (44060),0,2,-2
2011,Teruel,Cañizar del Olivar (44063),1,,1
2011,Teruel,Cedrillas (44074),7,6,1
2011,Teruel,Celadas (44075),0,9,-9
2011,Teruel,Cella (44076),29,34,-5
2011,Teruel,Cerollera (La) (44077),0,2,-2
2011,Teruel,Codoñera (La) (44080),2,9,-7
2011,Teruel,Corbalán (44082),1,1,0
2011,Teruel,Cortes de Aragón (44084),1,,1
2011,Teruel,Cretas (44086),5,8,-3
2011,Teruel,Crivillén (44087),0,1,-1
2011,Teruel,Cucalón (44090),1,1,0
2011,Teruel,Cuervo (El) (44092),1,2,-1
2011,Teruel,Cuevas de Almudén (44093),1,1,0
2011,Teruel,Cuevas Labradas (44094),0,5,-5
2011,Teruel,Ejulve (44096),2,,2
2011,Teruel,Escorihuela (44097),0,1,-1
2011,Teruel,Escucha (44099),10,9,1
2011,Teruel,Estercuel (44100),0,5,-5
2011,Teruel,Ferreruela de Huerva (44101),1,,1
2011,Teruel,Formiche Alto (44103),0,2,-2
2011,Teruel,Fortanete (44106),2,2,0
2011,Teruel,Foz-Calanda (44107),1,4,-3
2011,Teruel,Fresneda (La) (44108),4,14,-10
2011,Teruel,Frías de Albarracín (44109),1,3,-2
2011,Teruel,Fuenferrada (44110),0,1,-1
2011,Teruel,Fuentes Calientes (44111),1,3,-2
2011,Teruel,Fuentes Claras (44112),0,4,-4
2011,Teruel,Fuentes de Rubielos (44113),4,,4
2011,Teruel,Fuentespalda (44114),1,3,-2
2011,Teruel,Fórnoles (44105),0,2,-2
2011,Teruel,Galve (44115),3,1,2
2011,Teruel,Gargallo (44116),2,1,1
2011,Teruel,Gea de Albarracín (44117),0,8,-8
2011,Teruel,Ginebrosa (La) (44118),2,5,-3
2011,Teruel,Griegos (44119),1,1,0
2011,Teruel,Guadalaviar (44120),1,2,-1
2011,Teruel,Gúdar (44121),0,,0
2011,Teruel,Hinojosa de Jarque (44123),0,3,-3
2011,Teruel,Hoz de la Vieja (La) (44124),0,3,-3
2011,Teruel,Huesa del Común (44125),0,2,-2
2011,Teruel,Híjar (44122),11,31,-20
2011,Teruel,Iglesuela del Cid (La) (44126),3,5,-2
2011,Teruel,Jabaloyas (44127),0,2,-2
2011,Teruel,Jarque de la Val (44128),1,1,0
2011,Teruel,Jorcas (44130),0,1,-1
2011,Teruel,Libros (44135),0,4,-4
2011,Teruel,Linares de Mora (44137),2,3,-1
2011,Teruel,Lledó (44141),1,1,0
2011,Teruel,Loscos (44138),1,2,-1
2011,Teruel,Manzanera (44143),4,8,-4
2011,Teruel,Martín del Río (44144),2,4,-2
2011,Teruel,Mas de las Matas (44145),6,41,-35
2011,Teruel,Mata de los Olmos (La) (44146),3,4,-1
2011,Teruel,Mazaleón (44147),2,5,-3
2011,Teruel,Mezquita de Jarque (44148),0,2,-2
2011,Teruel,Mirambel (44149),1,6,-5
2011,Teruel,Molinos (44151),0,1,-1
2011,Teruel,Monreal del Campo (44153),33,26,7
2011,Teruel,Monroyo (44154),1,3,-2
2011,Teruel,Montalbán (44155),9,17,-8
2011,Teruel,Monteagudo del Castillo (44156),0,1,-1
2011,Teruel,Monterde de Albarracín (44157),0,1,-1
2011,Teruel,Mora de Rubielos (44158),20,15,5
2011,Teruel,Mosqueruela (44160),3,6,-3
2011,Teruel,Muniesa (44161),6,14,-8
2011,Teruel,Noguera de Albarracín (44163),0,1,-1
2011,Teruel,Nogueras (44164),0,2,-2
2011,Teruel,Nogueruelas (44165),3,2,1
2011,Teruel,Obón (44167),0,1,-1
2011,Teruel,Odón (44168),0,2,-2
2011,Teruel,Ojos Negros (44169),3,10,-7
2011,Teruel,Olba (44171),2,4,-2
2011,Teruel,Oliete (44172),0,9,-9
2011,Teruel,Olmos (Los) (44173),1,2,-1
2011,Teruel,Orihuela del Tremedal (44174),4,3,1
2011,Teruel,Orrios (44175),0,3,-3
2011,Teruel,Palomar de Arroyos (44176),1,1,0
2011,Teruel,Pancrudo (44177),0,1,-1
2011,Teruel,Parras de Castellote (Las) (44178),0,1,-1
2011,Teruel,Peracense (44180),0,2,-2
2011,Teruel,Perales del Alfambra (44182),3,2,1
2011,Teruel,Peñarroya de Tastavins (44179),3,5,-2
2011,Teruel,Pitarque (44183),0,2,-2
2011,Teruel,Portellada (La) (44187),4,4,0
2011,Teruel,Pozondón (44189),0,2,-2
2011,Teruel,Pozuel del Campo (44190),0,1,-1
2011,Teruel,Puebla de Híjar (La) (44191),5,10,-5
2011,Teruel,Puebla de Valverde (La) (44192),5,6,-1
2011,Teruel,Puertomingalvo (44193),1,1,0
2011,Teruel,Rillo (44195),0,1,-1
2011,Teruel,Riodeva (44196),0,2,-2
2011,Teruel,Royuela (44198),2,8,-6
2011,Teruel,Rubiales (44199),0,2,-2
2011,Teruel,Rubielos de Mora (44201),6,4,2
2011,Teruel,Ráfales (44194),1,4,-3
2011,Teruel,Ródenas (44197),0,1,-1
2011,Teruel,Saldón (44204),0,1,-1
2011,Teruel,Samper de Calanda (44205),5,20,-15
2011,Teruel,San Agustín (44206),1,2,-1
2011,Teruel,San Martín del Río (44207),0,5,-5
2011,Teruel,Santa Eulalia (44209),9,29,-20
2011,Teruel,Sarrión (44210),11,15,-4
2011,Teruel,Seno (44212),2,1,1
2011,Teruel,Singra (44213),0,3,-3
2011,Teruel,Terriente (44215),0,4,-4
2011,Teruel,Teruel (44216),374,334,40
2011,Teruel,Toril y Masegoso (44217),0,1,-1
2011,Teruel,Tormón (44218),0,1,-1
2011,Teruel,Tornos (44219),0,4,-4
2011,Teruel,Torralba de los Sisones (44220),0,2,-2
2011,Teruel,Torre de Arcas (44223),1,2,-1
2011,Teruel,Torre de las Arcas (44224),0,1,-1
2011,Teruel,Torre del Compte (44225),1,3,-2
2011,Teruel,Torre los Negros (44227),0,2,-2
2011,Teruel,Torrecilla de Alcañiz (44221),0,5,-5
2011,Teruel,Torrecilla del Rebollar (44222),0,2,-2
2011,Teruel,Torrelacárcel (44226),0,5,-5
2011,Teruel,Torremocha de Jiloca (44228),0,1,-1
2011,Teruel,Torres de Albarracín (44229),0,3,-3
2011,Teruel,Torrevelilla (44230),1,5,-4
2011,Teruel,Torrijas (44231),0,1,-1
2011,Teruel,Torrijo del Campo (44232),1,9,-8
2011,Teruel,Tramacastiel (44234),0,3,-3
2011,Teruel,Tramacastilla (44235),2,,2
2011,Teruel,Tronchón (44236),0,1,-1
2011,Teruel,Urrea de Gaén (44237),4,6,-2
2011,Teruel,Utrillas (44238),31,31,0
2011,Teruel,Valacloche (44239),0,1,-1
2011,Teruel,Valbona (44240),0,,0
2011,Teruel,Valdealgorfa (44241),5,14,-9
2011,Teruel,Valdecuenca (44243),0,1,-1
2011,Teruel,Valdelinares (44244),1,,1
2011,Teruel,Valdeltormo (44245),2,8,-6
2011,Teruel,Valderrobres (44246),28,45,-17
2011,Teruel,Valjunquera (44247),0,6,-6
2011,Teruel,Villafranca del Campo (44251),2,4,-2
2011,Teruel,Villahermosa del Campo (44252),1,,1
2011,Teruel,Villanueva del Rebollar de la Sierra (44256),0,1,-1
2011,Teruel,Villar del Cobo (44257),0,1,-1
2011,Teruel,Villar del Salz (44258),0,1,-1
2011,Teruel,Villarluengo (44260),2,4,-2
2011,Teruel,Villarquemado (44261),6,10,-4
2011,Teruel,Villarroya de los Pinares (44262),1,3,-2
2011,Teruel,Villastar (44263),7,6,1
2011,Teruel,Villel (44264),5,1,4
2011,Teruel,Vinaceite (44265),1,3,-2
2011,Teruel,Visiedo (44266),0,2,-2
2011,Teruel,Vivel del Río Martín (44267),1,1,0
2011,Teruel,Zoma (La) (44268),0,2,-2
2010,Teruel,Ababuj (44001),1,2,-1
2010,Teruel,Abejuela (44002),0,1,-1
2010,Teruel,Aguaviva (44004),1,5,-4
2010,Teruel,Aguilar del Alfambra (44005),0,1,-1
2010,Teruel,Alacón (44006),1,5,-4
2010,Teruel,Alba (44007),1,2,-1
2010,Teruel,Albalate del Arzobispo (44008),17,25,-8
2010,Teruel,Albarracín (44009),11,12,-1
2010,Teruel,Albentosa (44010),5,3,2
2010,Teruel,Alcaine (44011),1,1,0
2010,Teruel,Alcalá de la Selva (44012),6,9,-3
2010,Teruel,Alcañiz (44013),230,163,67
2010,Teruel,Alcorisa (44014),37,49,-12
2010,Teruel,Alfambra (44016),2,12,-10
2010,Teruel,Aliaga (44017),3,4,-1
2010,Teruel,Allepuz (44021),0,5,-5
2010,Teruel,Alloza (44022),5,9,-4
2010,Teruel,Andorra (44025),62,75,-13
2010,Teruel,Arcos de las Salinas (44026),0,2,-2
2010,Teruel,Arens de Lledó (44027),1,5,-4
2010,Teruel,Argente (44028),1,7,-6
2010,Teruel,Ariño (44029),6,14,-8
2010,Teruel,Azaila (44031),0,2,-2
2010,Teruel,Barrachina (44035),2,2,0
2010,Teruel,Bañón (44034),0,1,-1
2010,Teruel,Beceite (44037),5,8,-3
2010,Teruel,Bello (44039),0,2,-2
2010,Teruel,Belmonte de San José (44038),0,5,-5
2010,Teruel,Berge (44040),1,6,-5
2010,Teruel,Bezas (44041),0,1,-1
2010,Teruel,Blancas (44042),0,1,-1
2010,Teruel,Bordón (44044),0,2,-2
2010,Teruel,Bronchales (44045),1,3,-2
2010,Teruel,Bueña (44046),0,1,-1
2010,Teruel,Burbáguena (44047),0,15,-15
2010,Teruel,Báguena (44033),0,6,-6
2010,Teruel,Cabra de Mora (44048),0,1,-1
2010,Teruel,Calaceite (44049),6,23,-17
2010,Teruel,Calamocha (44050),47,45,2
2010,Teruel,Calanda (44051),23,45,-22
2010,Teruel,Calomarde (44052),0,2,-2
2010,Teruel,Camarena de la Sierra (44054),1,4,-3
2010,Teruel,Camarillas (44055),0,1,-1
2010,Teruel,Camañas (44053),0,3,-3
2010,Teruel,Caminreal (44056),4,13,-9
2010,Teruel,Cantavieja (44059),8,8,0
2010,Teruel,Castejón de Tornos (44065),0,1,-1
2010,Teruel,Castel de Cabra (44066),0,2,-2
2010,Teruel,Castellar (El) (44070),0,1,-1
2010,Teruel,Castellote (44071),1,5,-4
2010,Teruel,Castelnou (44067),0,3,-3
2010,Teruel,Castelserás (44068),2,15,-13
2010,Teruel,Cañada de Benatanduz (44060),0,1,-1
2010,Teruel,Cañada de Verich (La) (44061),0,1,-1
2010,Teruel,Cañada Vellida (44062),0,1,-1
2010,Teruel,Cañizar del Olivar (44063),2,1,1
2010,Teruel,Cedrillas (44074),2,11,-9
2010,Teruel,Celadas (44075),0,5,-5
2010,Teruel,Cella (44076),16,26,-10
2010,Teruel,Cerollera (La) (44077),0,1,-1
2010,Teruel,Codoñera (La) (44080),2,4,-2
2010,Teruel,Corbalán (44082),0,2,-2
2010,Teruel,Cortes de Aragón (44084),0,2,-2
2010,Teruel,Cosa (44085),0,2,-2
2010,Teruel,Cretas (44086),2,12,-10
2010,Teruel,Cubla (44089),0,2,-2
2010,Teruel,Cucalón (44090),1,2,-1
2010,Teruel,Cuervo (El) (44092),0,4,-4
2010,Teruel,Cuevas de Almudén (44093),5,,5
2010,Teruel,Cuevas Labradas (44094),0,1,-1
2010,Teruel,Ejulve (44096),0,1,-1
2010,Teruel,Escorihuela (44097),0,1,-1
2010,Teruel,Escucha (44099),7,10,-3
2010,Teruel,Estercuel (44100),4,6,-2
2010,Teruel,Ferreruela de Huerva (44101),0,2,-2
2010,Teruel,Formiche Alto (44103),0,7,-7
2010,Teruel,Fortanete (44106),3,3,0
2010,Teruel,Foz-Calanda (44107),2,3,-1
2010,Teruel,Fresneda (La) (44108),4,8,-4
2010,Teruel,Frías de Albarracín (44109),0,2,-2
2010,Teruel,Fuentes Calientes (44111),1,,1
2010,Teruel,Fuentes Claras (44112),3,10,-7
2010,Teruel,Fuentes de Rubielos (44113),1,1,0
2010,Teruel,Fuentespalda (44114),2,14,-12
2010,Teruel,Fórnoles (44105),1,1,0
2010,Teruel,Galve (44115),1,,1
2010,Teruel,Gargallo (44116),1,,1
2010,Teruel,Gea de Albarracín (44117),2,7,-5
2010,Teruel,Ginebrosa (La) (44118),0,1,-1
2010,Teruel,Griegos (44119),1,1,0
2010,Teruel,Guadalaviar (44120),2,1,1
2010,Teruel,Gúdar (44121),2,,2
2010,Teruel,Hinojosa de Jarque (44123),3,4,-1
2010,Teruel,Huesa del Común (44125),0,1,-1
2010,Teruel,Híjar (44122),10,33,-23
2010,Teruel,Iglesuela del Cid (La) (44126),4,4,0
2010,Teruel,Jarque de la Val (44128),1,,1
2010,Teruel,Jatiel (44129),0,,0
2010,Teruel,Jorcas (44130),0,1,-1
2010,Teruel,Lanzuela (44133),1,,1
2010,Teruel,Libros (44135),0,4,-4
2010,Teruel,Linares de Mora (44137),0,2,-2
2010,Teruel,Lledó (44141),0,2,-2
2010,Teruel,Loscos (44138),0,3,-3
2010,Teruel,Manzanera (44143),5,7,-2
2010,Teruel,Martín del Río (44144),2,8,-6
2010,Teruel,Mas de las Matas (44145),9,27,-18
2010,Teruel,Mata de los Olmos (La) (44146),2,2,0
2010,Teruel,Mazaleón (44147),2,9,-7
2010,Teruel,Mezquita de Jarque (44148),0,1,-1
2010,Teruel,Mirambel (44149),2,3,-1
2010,Teruel,Miravete de la Sierra (44150),0,1,-1
2010,Teruel,Molinos (44151),2,6,-4
2010,Teruel,Monreal del Campo (44153),25,23,2
2010,Teruel,Monroyo (44154),4,6,-2
2010,Teruel,Montalbán (44155),9,13,-4
2010,Teruel,Monteagudo del Castillo (44156),0,1,-1
2010,Teruel,Monterde de Albarracín (44157),0,1,-1
2010,Teruel,Mora de Rubielos (44158),15,13,2
2010,Teruel,Moscardón (44159),1,2,-1
2010,Teruel,Mosqueruela (44160),5,10,-5
2010,Teruel,Muniesa (44161),6,8,-2
2010,Teruel,Noguera de Albarracín (44163),2,2,0
2010,Teruel,Nogueras (44164),0,1,-1
2010,Teruel,Nogueruelas (44165),1,3,-2
2010,Teruel,Obón (44167),0,1,-1
2010,Teruel,Odón (44168),1,2,-1
2010,Teruel,Ojos Negros (44169),3,9,-6
2010,Teruel,Olba (44171),2,2,0
2010,Teruel,Oliete (44172),1,6,-5
2010,Teruel,Olmos (Los) (44173),0,1,-1
2010,Teruel,Orihuela del Tremedal (44174),3,10,-7
2010,Teruel,Orrios (44175),0,1,-1
2010,Teruel,Palomar de Arroyos (44176),0,3,-3
2010,Teruel,Pancrudo (44177),0,1,-1
2010,Teruel,Parras de Castellote (Las) (44178),0,1,-1
2010,Teruel,Peracense (44180),1,2,-1
2010,Teruel,Perales del Alfambra (44182),1,3,-2
2010,Teruel,Peñarroya de Tastavins (44179),3,8,-5
2010,Teruel,Pitarque (44183),2,2,0
2010,Teruel,Pobo (El) (44185),0,2,-2
2010,Teruel,Portellada (La) (44187),0,4,-4
2010,Teruel,Pozuel del Campo (44190),0,3,-3
2010,Teruel,Puebla de Híjar (La) (44191),6,14,-8
2010,Teruel,Puebla de Valverde (La) (44192),3,9,-6
2010,Teruel,Puertomingalvo (44193),1,,1
2010,Teruel,Rillo (44195),0,3,-3
2010,Teruel,Riodeva (44196),1,3,-2
2010,Teruel,Royuela (44198),2,1,1
2010,Teruel,Rubiales (44199),0,1,-1
2010,Teruel,Rubielos de Mora (44201),5,4,1
2010,Teruel,Ráfales (44194),3,5,-2
2010,Teruel,Ródenas (44197),0,1,-1
2010,Teruel,Saldón (44204),1,1,0
2010,Teruel,Samper de Calanda (44205),2,15,-13
2010,Teruel,San Agustín (44206),1,2,-1
2010,Teruel,San Martín del Río (44207),0,6,-6
2010,Teruel,Santa Eulalia (44209),10,13,-3
2010,Teruel,Sarrión (44210),9,15,-6
2010,Teruel,Segura de los Baños (44211),0,1,-1
2010,Teruel,Seno (44212),0,1,-1
2010,Teruel,Singra (44213),0,2,-2
2010,Teruel,Terriente (44215),1,2,-1
2010,Teruel,Teruel (44216),360,316,44
2010,Teruel,Tormón (44218),0,3,-3
2010,Teruel,Tornos (44219),0,4,-4
2010,Teruel,Torralba de los Sisones (44220),0,1,-1
2010,Teruel,Torre de Arcas (44223),1,1,0
2010,Teruel,Torre de las Arcas (44224),0,3,-3
2010,Teruel,Torre del Compte (44225),1,2,-1
2010,Teruel,Torrecilla del Rebollar (44222),0,3,-3
2010,Teruel,Torrelacárcel (44226),0,5,-5
2010,Teruel,Torres de Albarracín (44229),0,1,-1
2010,Teruel,Torrevelilla (44230),1,3,-2
2010,Teruel,Torrijas (44231),0,2,-2
2010,Teruel,Torrijo del Campo (44232),3,11,-8
2010,Teruel,Tramacastiel (44234),1,4,-3
2010,Teruel,Tramacastilla (44235),0,2,-2
2010,Teruel,Tronchón (44236),0,1,-1
2010,Teruel,Urrea de Gaén (44237),3,9,-6
2010,Teruel,Utrillas (44238),25,27,-2
2010,Teruel,Valacloche (44239),0,1,-1
2010,Teruel,Valbona (44240),0,3,-3
2010,Teruel,Valdealgorfa (44241),5,11,-6
2010,Teruel,Valdelinares (44244),0,1,-1
2010,Teruel,Valdeltormo (44245),1,3,-2
2010,Teruel,Valderrobres (44246),23,37,-14
2010,Teruel,Valjunquera (44247),1,12,-11
2010,Teruel,Veguillas de la Sierra (44250),0,2,-2
2010,Teruel,Villafranca del Campo (44251),3,6,-3
2010,Teruel,Villahermosa del Campo (44252),0,1,-1
2010,Teruel,Villanueva del Rebollar de la Sierra (44256),0,1,-1
2010,Teruel,Villar del Cobo (44257),3,1,2
2010,Teruel,Villar del Salz (44258),0,3,-3
2010,Teruel,Villarluengo (44260),1,2,-1
2010,Teruel,Villarquemado (44261),4,19,-15
2010,Teruel,Villarroya de los Pinares (44262),1,3,-2
2010,Teruel,Villastar (44263),9,3,6
2010,Teruel,Villel (44264),2,8,-6
2010,Teruel,Vinaceite (44265),1,6,-5
2010,Teruel,Visiedo (44266),1,1,0
2010,Teruel,Vivel del Río Martín (44267),0,2,-2
2009,Teruel,Ababuj (44001),0,3,-3
2009,Teruel,Abejuela (44002),0,3,-3
2009,Teruel,Aguaviva (44004),2,6,-4
2009,Teruel,Alacón (44006),1,6,-5
2009,Teruel,Alba (44007),1,6,-5
2009,Teruel,Albalate del Arzobispo (44008),13,30,-17
2009,Teruel,Albarracín (44009),9,22,-13
2009,Teruel,Albentosa (44010),3,1,2
2009,Teruel,Alcaine (44011),0,3,-3
2009,Teruel,Alcalá de la Selva (44012),3,7,-4
2009,Teruel,Alcañiz (44013),190,171,19
2009,Teruel,Alcorisa (44014),38,43,-5
2009,Teruel,Alfambra (44016),2,13,-11
2009,Teruel,Aliaga (44017),1,9,-8
2009,Teruel,Alloza (44022),4,4,0
2009,Teruel,Anadón (44024),0,1,-1
2009,Teruel,Andorra (44025),75,63,12
2009,Teruel,Arcos de las Salinas (44026),1,4,-3
2009,Teruel,Arens de Lledó (44027),0,3,-3
2009,Teruel,Argente (44028),0,2,-2
2009,Teruel,Ariño (44029),2,6,-4
2009,Teruel,Azaila (44031),0,10,-10
2009,Teruel,Barrachina (44035),0,2,-2
2009,Teruel,Bañón (44034),2,1,1
2009,Teruel,Beceite (44037),6,7,-1
2009,Teruel,Bello (44039),1,7,-6
2009,Teruel,Belmonte de San José (44038),0,2,-2
2009,Teruel,Berge (44040),1,6,-5
2009,Teruel,Bezas (44041),0,2,-2
2009,Teruel,Blancas (44042),1,,1
2009,Teruel,Bordón (44044),1,1,0
2009,Teruel,Bronchales (44045),2,4,-2
2009,Teruel,Bueña (44046),0,4,-4
2009,Teruel,Burbáguena (44047),0,24,-24
2009,Teruel,Báguena (44033),1,7,-6
2009,Teruel,Calaceite (44049),11,13,-2
2009,Teruel,Calamocha (44050),44,48,-4
2009,Teruel,Calanda (44051),32,38,-6
2009,Teruel,Camarena de la Sierra (44054),2,3,-1
2009,Teruel,Camarillas (44055),3,,3
2009,Teruel,Camañas (44053),0,2,-2
2009,Teruel,Caminreal (44056),4,8,-4
2009,Teruel,Cantavieja (44059),9,5,4
2009,Teruel,Cascante del Río (44064),1,2,-1
2009,Teruel,Castejón de Tornos (44065),1,1,0
2009,Teruel,Castel de Cabra (44066),1,2,-1
2009,Teruel,Castellar (El) (44070),0,3,-3
2009,Teruel,Castellote (44071),4,11,-7
2009,Teruel,Castelnou (44067),1,2,-1
2009,Teruel,Castelserás (44068),8,15,-7
2009,Teruel,Cañada de Benatanduz (44060),0,2,-2
2009,Teruel,Cañada de Verich (La) (44061),0,1,-1
2009,Teruel,Cañizar del Olivar (44063),1,,1
2009,Teruel,Cedrillas (44074),3,10,-7
2009,Teruel,Celadas (44075),1,3,-2
2009,Teruel,Cella (44076),19,42,-23
2009,Teruel,Cerollera (La) (44077),0,2,-2
2009,Teruel,Codoñera (La) (44080),3,3,0
2009,Teruel,Cortes de Aragón (44084),0,1,-1
2009,Teruel,Cretas (44086),5,13,-8
2009,Teruel,Cuba (La) (44088),0,4,-4
2009,Teruel,Cubla (44089),1,1,0
2009,Teruel,Cucalón (44090),0,3,-3
2009,Teruel,Cuervo (El) (44092),1,1,0
2009,Teruel,Cuevas de Almudén (44093),2,1,1
2009,Teruel,Cuevas Labradas (44094),0,2,-2
2009,Teruel,Ejulve (44096),0,5,-5
2009,Teruel,Escorihuela (44097),1,5,-4
2009,Teruel,Escucha (44099),5,5,0
2009,Teruel,Estercuel (44100),3,5,-2
2009,Teruel,Ferreruela de Huerva (44101),0,2,-2
2009,Teruel,Formiche Alto (44103),0,,0
2009,Teruel,Fortanete (44106),4,5,-1
2009,Teruel,Foz-Calanda (44107),3,6,-3
2009,Teruel,Fresneda (La) (44108),3,5,-2
2009,Teruel,Frías de Albarracín (44109),0,4,-4
2009,Teruel,Fuentes Calientes (44111),1,3,-2
2009,Teruel,Fuentes Claras (44112),6,8,-2
2009,Teruel,Fuentes de Rubielos (44113),1,1,0
2009,Teruel,Fuentespalda (44114),0,1,-1
2009,Teruel,Fórnoles (44105),0,2,-2
2009,Teruel,Galve (44115),2,,2
2009,Teruel,Gargallo (44116),1,3,-2
2009,Teruel,Gea de Albarracín (44117),1,4,-3
2009,Teruel,Ginebrosa (La) (44118),3,2,1
2009,Teruel,Griegos (44119),0,4,-4
2009,Teruel,Guadalaviar (44120),0,6,-6
2009,Teruel,Gúdar (44121),1,,1
2009,Teruel,Hinojosa de Jarque (44123),0,2,-2
2009,Teruel,Hoz de la Vieja (La) (44124),1,1,0
2009,Teruel,Huesa del Común (44125),0,1,-1
2009,Teruel,Híjar (44122),15,28,-13
2009,Teruel,Iglesuela del Cid (La) (44126),6,1,5
2009,Teruel,Jabaloyas (44127),0,1,-1
2009,Teruel,Jarque de la Val (44128),1,1,0
2009,Teruel,Jatiel (44129),1,1,0
2009,Teruel,Lagueruela (44132),0,1,-1
2009,Teruel,Lanzuela (44133),0,2,-2
2009,Teruel,Libros (44135),0,1,-1
2009,Teruel,Lidón (44136),0,2,-2
2009,Teruel,Linares de Mora (44137),2,2,0
2009,Teruel,Lledó (44141),0,5,-5
2009,Teruel,Loscos (44138),0,2,-2
2009,Teruel,Manzanera (44143),6,5,1
2009,Teruel,Martín del Río (44144),4,7,-3
2009,Teruel,Mas de las Matas (44145),8,22,-14
2009,Teruel,Mata de los Olmos (La) (44146),3,4,-1
2009,Teruel,Mazaleón (44147),2,6,-4
2009,Teruel,Mezquita de Jarque (44148),1,3,-2
2009,Teruel,Mirambel (44149),0,3,-3
2009,Teruel,Miravete de la Sierra (44150),0,2,-2
2009,Teruel,Molinos (44151),1,10,-9
2009,Teruel,Monforte de Moyuela (44152),0,1,-1
2009,Teruel,Monreal del Campo (44153),39,37,2
2009,Teruel,Monroyo (44154),2,6,-4
2009,Teruel,Montalbán (44155),8,16,-8
2009,Teruel,Monteagudo del Castillo (44156),1,2,-1
2009,Teruel,Monterde de Albarracín (44157),0,1,-1
2009,Teruel,Mora de Rubielos (44158),19,22,-3
2009,Teruel,Moscardón (44159),1,,1
2009,Teruel,Mosqueruela (44160),3,10,-7
2009,Teruel,Muniesa (44161),5,5,0
2009,Teruel,Noguera de Albarracín (44163),0,3,-3
2009,Teruel,Nogueruelas (44165),3,4,-1
2009,Teruel,Odón (44168),1,4,-3
2009,Teruel,Ojos Negros (44169),5,5,0
2009,Teruel,Olba (44171),3,3,0
2009,Teruel,Oliete (44172),2,7,-5
2009,Teruel,Olmos (Los) (44173),0,2,-2
2009,Teruel,Orihuela del Tremedal (44174),3,3,0
2009,Teruel,Orrios (44175),0,3,-3
2009,Teruel,Palomar de Arroyos (44176),0,3,-3
2009,Teruel,Pancrudo (44177),0,4,-4
2009,Teruel,Parras de Castellote (Las) (44178),0,4,-4
2009,Teruel,Peracense (44180),0,3,-3
2009,Teruel,Peralejos (44181),0,1,-1
2009,Teruel,Perales del Alfambra (44182),1,6,-5
2009,Teruel,Peñarroya de Tastavins (44179),4,8,-4
2009,Teruel,Pitarque (44183),0,1,-1
2009,Teruel,Pobo (El) (44185),0,2,-2
2009,Teruel,Portellada (La) (44187),2,7,-5
2009,Teruel,Pozondón (44189),0,1,-1
2009,Teruel,Pozuel del Campo (44190),0,2,-2
2009,Teruel,Puebla de Híjar (La) (44191),8,12,-4
2009,Teruel,Puebla de Valverde (La) (44192),4,3,1
2009,Teruel,Puertomingalvo (44193),0,3,-3
2009,Teruel,Rillo (44195),1,1,0
2009,Teruel,Riodeva (44196),1,4,-3
2009,Teruel,Royuela (44198),3,4,-1
2009,Teruel,Rubielos de Mora (44201),5,13,-8
2009,Teruel,Ráfales (44194),0,4,-4
2009,Teruel,Samper de Calanda (44205),6,14,-8
2009,Teruel,San Agustín (44206),0,2,-2
2009,Teruel,San Martín del Río (44207),1,7,-6
2009,Teruel,Santa Eulalia (44209),6,17,-11
2009,Teruel,Sarrión (44210),14,13,1
2009,Teruel,Segura de los Baños (44211),0,1,-1
2009,Teruel,Singra (44213),2,1,1
2009,Teruel,Terriente (44215),0,3,-3
2009,Teruel,Teruel (44216),387,310,77
2009,Teruel,Tormón (44218),0,2,-2
2009,Teruel,Tornos (44219),0,2,-2
2009,Teruel,Torralba de los Sisones (44220),0,5,-5
2009,Teruel,Torre de Arcas (44223),1,2,-1
2009,Teruel,Torre de las Arcas (44224),0,1,-1
2009,Teruel,Torre del Compte (44225),0,4,-4
2009,Teruel,Torre los Negros (44227),0,2,-2
2009,Teruel,Torrecilla de Alcañiz (44221),0,2,-2
2009,Teruel,Torrecilla del Rebollar (44222),0,1,-1
2009,Teruel,Torrelacárcel (44226),1,6,-5
2009,Teruel,Torremocha de Jiloca (44228),0,3,-3
2009,Teruel,Torres de Albarracín (44229),0,2,-2
2009,Teruel,Torrevelilla (44230),3,3,0
2009,Teruel,Torrijas (44231),1,2,-1
2009,Teruel,Torrijo del Campo (44232),4,9,-5
2009,Teruel,Tramacastiel (44234),0,6,-6
2009,Teruel,Tronchón (44236),1,1,0
2009,Teruel,Urrea de Gaén (44237),2,8,-6
2009,Teruel,Utrillas (44238),33,34,-1
2009,Teruel,Valbona (44240),0,2,-2
2009,Teruel,Valdealgorfa (44241),2,13,-11
2009,Teruel,Valdelinares (44244),0,3,-3
2009,Teruel,Valdeltormo (44245),2,9,-7
2009,Teruel,Valderrobres (44246),24,28,-4
2009,Teruel,Valjunquera (44247),3,7,-4
2009,Teruel,Vallecillo (El) (44249),0,1,-1
2009,Teruel,Villafranca del Campo (44251),3,3,0
2009,Teruel,Villahermosa del Campo (44252),0,1,-1
2009,Teruel,Villanueva del Rebollar de la Sierra (44256),2,1,1
2009,Teruel,Villar del Cobo (44257),1,4,-3
2009,Teruel,Villarluengo (44260),0,3,-3
2009,Teruel,Villarquemado (44261),3,23,-20
2009,Teruel,Villarroya de los Pinares (44262),0,3,-3
2009,Teruel,Villastar (44263),11,9,2
2009,Teruel,Villel (44264),5,5,0
2009,Teruel,Vinaceite (44265),0,1,-1
2009,Teruel,Visiedo (44266),0,2,-2
2008,Teruel,Ababuj (44001),0,1,-1
2008,Teruel,Abejuela (44002),0,3,-3
2008,Teruel,Aguatón (44003),0,,0
2008,Teruel,Aguaviva (44004),4,6,-2
2008,Teruel,Alacón (44006),2,3,-1
2008,Teruel,Alba (44007),0,4,-4
2008,Teruel,Albalate del Arzobispo (44008),16,26,-10
2008,Teruel,Albarracín (44009),12,15,-3
2008,Teruel,Albentosa (44010),6,1,5
2008,Teruel,Alcaine (44011),1,,1
2008,Teruel,Alcalá de la Selva (44012),3,3,0
2008,Teruel,Alcañiz (44013),192,139,53
2008,Teruel,Alcorisa (44014),55,34,21
2008,Teruel,Alfambra (44016),4,20,-16
2008,Teruel,Aliaga (44017),2,11,-9
2008,Teruel,Allepuz (44021),0,2,-2
2008,Teruel,Alloza (44022),6,10,-4
2008,Teruel,Allueva (44023),1,,1
2008,Teruel,Alobras (44019),0,1,-1
2008,Teruel,Alpeñés (44020),0,1,-1
2008,Teruel,Anadón (44024),0,1,-1
2008,Teruel,Andorra (44025),77,76,1
2008,Teruel,Arcos de las Salinas (44026),0,1,-1
2008,Teruel,Arens de Lledó (44027),0,3,-3
2008,Teruel,Argente (44028),0,4,-4
2008,Teruel,Ariño (44029),2,10,-8
2008,Teruel,Azaila (44031),0,1,-1
2008,Teruel,Barrachina (44035),0,1,-1
2008,Teruel,Bañón (44034),0,1,-1
2008,Teruel,Beceite (44037),8,10,-2
2008,Teruel,Bello (44039),2,8,-6
2008,Teruel,Belmonte de San José (44038),2,1,1
2008,Teruel,Berge (44040),1,6,-5
2008,Teruel,Bezas (44041),0,1,-1
2008,Teruel,Blancas (44042),1,2,-1
2008,Teruel,Blesa (44043),0,4,-4
2008,Teruel,Bordón (44044),0,1,-1
2008,Teruel,Bronchales (44045),2,6,-4
2008,Teruel,Bueña (44046),0,1,-1
2008,Teruel,Burbáguena (44047),0,14,-14
2008,Teruel,Báguena (44033),1,9,-8
2008,Teruel,Cabra de Mora (44048),0,3,-3
2008,Teruel,Calaceite (44049),2,16,-14
2008,Teruel,Calamocha (44050),49,48,1
2008,Teruel,Calanda (44051),30,44,-14
2008,Teruel,Calomarde (44052),0,1,-1
2008,Teruel,Camarena de la Sierra (44054),2,2,0
2008,Teruel,Camarillas (44055),1,,1
2008,Teruel,Camañas (44053),1,2,-1
2008,Teruel,Caminreal (44056),5,12,-7
2008,Teruel,Cantavieja (44059),7,9,-2
2008,Teruel,Cascante del Río (44064),0,1,-1
2008,Teruel,Castejón de Tornos (44065),0,1,-1
2008,Teruel,Castel de Cabra (44066),1,1,0
2008,Teruel,Castellar (El) (44070),0,1,-1
2008,Teruel,Castellote (44071),6,8,-2
2008,Teruel,Castelnou (44067),0,1,-1
2008,Teruel,Castelserás (44068),5,8,-3
2008,Teruel,Cañada de Verich (La) (44061),0,1,-1
2008,Teruel,Cañizar del Olivar (44063),0,1,-1
2008,Teruel,Cedrillas (44074),4,15,-11
2008,Teruel,Celadas (44075),3,6,-3
2008,Teruel,Cella (44076),18,32,-14
2008,Teruel,Codoñera (La) (44080),6,3,3
2008,Teruel,Corbalán (44082),0,3,-3
2008,Teruel,Cortes de Aragón (44084),0,2,-2
2008,Teruel,Cosa (44085),0,2,-2
2008,Teruel,Cretas (44086),7,9,-2
2008,Teruel,Cuba (La) (44088),2,2,0
2008,Teruel,Cubla (44089),0,2,-2
2008,Teruel,Cucalón (44090),1,,1
2008,Teruel,Cuervo (El) (44092),0,1,-1
2008,Teruel,Cuevas de Almudén (44093),1,,1
2008,Teruel,Cuevas Labradas (44094),1,4,-3
2008,Teruel,Ejulve (44096),3,5,-2
2008,Teruel,Escucha (44099),6,10,-4
2008,Teruel,Estercuel (44100),0,2,-2
2008,Teruel,Ferreruela de Huerva (44101),1,1,0
2008,Teruel,Formiche Alto (44103),1,4,-3
2008,Teruel,Fortanete (44106),3,,3
2008,Teruel,Foz-Calanda (44107),1,5,-4
2008,Teruel,Fresneda (La) (44108),4,8,-4
2008,Teruel,Frías de Albarracín (44109),1,2,-1
2008,Teruel,Fuentes Calientes (44111),1,1,0
2008,Teruel,Fuentes Claras (44112),3,7,-4
2008,Teruel,Fuentes de Rubielos (44113),1,1,0
2008,Teruel,Fuentespalda (44114),0,8,-8
2008,Teruel,Fórnoles (44105),0,2,-2
2008,Teruel,Galve (44115),4,,4
2008,Teruel,Gargallo (44116),0,1,-1
2008,Teruel,Gea de Albarracín (44117),3,5,-2
2008,Teruel,Ginebrosa (La) (44118),1,1,0
2008,Teruel,Griegos (44119),0,2,-2
2008,Teruel,Guadalaviar (44120),2,6,-4
2008,Teruel,Gúdar (44121),0,2,-2
2008,Teruel,Hinojosa de Jarque (44123),0,4,-4
2008,Teruel,Hoz de la Vieja (La) (44124),0,1,-1
2008,Teruel,Huesa del Común (44125),0,1,-1
2008,Teruel,Híjar (44122),18,35,-17
2008,Teruel,Iglesuela del Cid (La) (44126),5,7,-2
2008,Teruel,Jarque de la Val (44128),0,,0
2008,Teruel,Jatiel (44129),1,2,-1
2008,Teruel,Jorcas (44130),0,1,-1
2008,Teruel,Josa (44131),0,1,-1
2008,Teruel,Lagueruela (44132),0,1,-1
2008,Teruel,Lanzuela (44133),0,1,-1
2008,Teruel,Libros (44135),0,2,-2
2008,Teruel,Lidón (44136),0,1,-1
2008,Teruel,Linares de Mora (44137),1,5,-4
2008,Teruel,Lledó (44141),1,1,0
2008,Teruel,Loscos (44138),1,7,-6
2008,Teruel,Maicas (44142),0,1,-1
2008,Teruel,Manzanera (44143),2,4,-2
2008,Teruel,Martín del Río (44144),2,6,-4
2008,Teruel,Mas de las Matas (44145),8,16,-8
2008,Teruel,Mata de los Olmos (La) (44146),2,3,-1
2008,Teruel,Mazaleón (44147),8,9,-1
2008,Teruel,Mezquita de Jarque (44148),0,1,-1
2008,Teruel,Mirambel (44149),3,2,1
2008,Teruel,Miravete de la Sierra (44150),0,1,-1
2008,Teruel,Molinos (44151),0,4,-4
2008,Teruel,Monforte de Moyuela (44152),0,2,-2
2008,Teruel,Monreal del Campo (44153),26,39,-13
2008,Teruel,Monroyo (44154),6,8,-2
2008,Teruel,Montalbán (44155),13,18,-5
2008,Teruel,Monteagudo del Castillo (44156),1,2,-1
2008,Teruel,Mora de Rubielos (44158),23,15,8
2008,Teruel,Moscardón (44159),5,,5
2008,Teruel,Mosqueruela (44160),1,9,-8
2008,Teruel,Muniesa (44161),6,12,-6
2008,Teruel,Noguera de Albarracín (44163),0,1,-1
2008,Teruel,Nogueras (44164),0,,0
2008,Teruel,Nogueruelas (44165),0,3,-3
2008,Teruel,Obón (44167),0,1,-1
2008,Teruel,Odón (44168),1,5,-4
2008,Teruel,Ojos Negros (44169),2,9,-7
2008,Teruel,Olba (44171),4,1,3
2008,Teruel,Oliete (44172),1,12,-11
2008,Teruel,Olmos (Los) (44173),0,1,-1
2008,Teruel,Orihuela del Tremedal (44174),3,9,-6
2008,Teruel,Orrios (44175),0,4,-4
2008,Teruel,Palomar de Arroyos (44176),1,2,-1
2008,Teruel,Pancrudo (44177),1,3,-2
2008,Teruel,Parras de Castellote (Las) (44178),0,2,-2
2008,Teruel,Peracense (44180),0,2,-2
2008,Teruel,Peralejos (44181),0,2,-2
2008,Teruel,Perales del Alfambra (44182),0,6,-6
2008,Teruel,Peñarroya de Tastavins (44179),6,7,-1
2008,Teruel,Pitarque (44183),0,1,-1
2008,Teruel,Plou (44184),0,1,-1
2008,Teruel,Pobo (El) (44185),1,5,-4
2008,Teruel,Portellada (La) (44187),1,3,-2
2008,Teruel,Pozuel del Campo (44190),0,1,-1
2008,Teruel,Puebla de Híjar (La) (44191),13,8,5
2008,Teruel,Puebla de Valverde (La) (44192),5,4,1
2008,Teruel,Puertomingalvo (44193),3,1,2
2008,Teruel,Rillo (44195),0,2,-2
2008,Teruel,Riodeva (44196),0,3,-3
2008,Teruel,Royuela (44198),2,1,1
2008,Teruel,Rubielos de la Cérida (44200),0,3,-3
2008,Teruel,Rubielos de Mora (44201),4,7,-3
2008,Teruel,Ráfales (44194),2,4,-2
2008,Teruel,Saldón (44204),0,2,-2
2008,Teruel,Samper de Calanda (44205),3,13,-10
2008,Teruel,San Agustín (44206),0,3,-3
2008,Teruel,San Martín del Río (44207),0,5,-5
2008,Teruel,Santa Cruz de Nogueras (44208),0,1,-1
2008,Teruel,Santa Eulalia (44209),4,15,-11
2008,Teruel,Sarrión (44210),8,7,1
2008,Teruel,Seno (44212),1,,1
2008,Teruel,Terriente (44215),3,3,0
2008,Teruel,Teruel (44216),362,327,35
2008,Teruel,Tormón (44218),0,1,-1
2008,Teruel,Tornos (44219),1,3,-2
2008,Teruel,Torralba de los Sisones (44220),1,,1
2008,Teruel,Torre de Arcas (44223),1,,1
2008,Teruel,Torre de las Arcas (44224),1,1,0
2008,Teruel,Torre del Compte (44225),0,3,-3
2008,Teruel,Torre los Negros (44227),0,1,-1
2008,Teruel,Torrecilla de Alcañiz (44221),0,1,-1
2008,Teruel,Torrecilla del Rebollar (44222),0,3,-3
2008,Teruel,Torrelacárcel (44226),1,4,-3
2008,Teruel,Torremocha de Jiloca (44228),1,2,-1
2008,Teruel,Torres de Albarracín (44229),0,2,-2
2008,Teruel,Torrevelilla (44230),0,3,-3
2008,Teruel,Torrijas (44231),0,1,-1
2008,Teruel,Torrijo del Campo (44232),3,16,-13
2008,Teruel,Tramacastiel (44234),0,1,-1
2008,Teruel,Tramacastilla (44235),0,4,-4
2008,Teruel,Tronchón (44236),2,,2
2008,Teruel,Urrea de Gaén (44237),2,8,-6
2008,Teruel,Utrillas (44238),36,22,14
2008,Teruel,Valacloche (44239),0,1,-1
2008,Teruel,Valbona (44240),0,4,-4
2008,Teruel,Valdealgorfa (44241),3,7,-4
2008,Teruel,Valdelinares (44244),1,2,-1
2008,Teruel,Valdeltormo (44245),1,8,-7
2008,Teruel,Valderrobres (44246),15,34,-19
2008,Teruel,Valjunquera (44247),1,1,0
2008,Teruel,Vallecillo (El) (44249),0,1,-1
2008,Teruel,Veguillas de la Sierra (44250),0,1,-1
2008,Teruel,Villafranca del Campo (44251),2,10,-8
2008,Teruel,Villanueva del Rebollar de la Sierra (44256),0,1,-1
2008,Teruel,Villar del Cobo (44257),0,3,-3
2008,Teruel,Villar del Salz (44258),0,2,-2
2008,Teruel,Villarluengo (44260),0,2,-2
2008,Teruel,Villarquemado (44261),8,12,-4
2008,Teruel,Villarroya de los Pinares (44262),2,2,0
2008,Teruel,Villastar (44263),4,7,-3
2008,Teruel,Villel (44264),5,4,1
2008,Teruel,Vinaceite (44265),0,2,-2
2008,Teruel,Visiedo (44266),0,6,-6
2007,Teruel,Aguaviva (44004),7,7,0
2007,Teruel,Alacón (44006),2,2,0
2007,Teruel,Alba (44007),3,5,-2
2007,Teruel,Albalate del Arzobispo (44008),18,32,-14
2007,Teruel,Albarracín (44009),7,15,-8
2007,Teruel,Albentosa (44010),2,3,-1
2007,Teruel,Alcaine (44011),1,,1
2007,Teruel,Alcalá de la Selva (44012),0,5,-5
2007,Teruel,Alcañiz (44013),224,142,82
2007,Teruel,Alcorisa (44014),35,38,-3
2007,Teruel,Alfambra (44016),2,13,-11
2007,Teruel,Aliaga (44017),3,6,-3
2007,Teruel,Allepuz (44021),2,2,0
2007,Teruel,Alloza (44022),4,14,-10
2007,Teruel,Almohaja (44018),0,1,-1
2007,Teruel,Alobras (44019),0,2,-2
2007,Teruel,Anadón (44024),0,1,-1
2007,Teruel,Andorra (44025),61,66,-5
2007,Teruel,Arcos de las Salinas (44026),0,3,-3
2007,Teruel,Arens de Lledó (44027),0,4,-4
2007,Teruel,Argente (44028),0,4,-4
2007,Teruel,Ariño (44029),6,12,-6
2007,Teruel,Azaila (44031),0,7,-7
2007,Teruel,Barrachina (44035),3,2,1
2007,Teruel,Beceite (44037),4,10,-6
2007,Teruel,Bello (44039),0,8,-8
2007,Teruel,Belmonte de San José (44038),0,,0
2007,Teruel,Berge (44040),4,3,1
2007,Teruel,Bezas (44041),1,1,0
2007,Teruel,Blancas (44042),0,3,-3
2007,Teruel,Blesa (44043),0,2,-2
2007,Teruel,Bordón (44044),0,2,-2
2007,Teruel,Bronchales (44045),2,7,-5
2007,Teruel,Bueña (44046),0,2,-2
2007,Teruel,Burbáguena (44047),0,19,-19
2007,Teruel,Báguena (44033),0,7,-7
2007,Teruel,Cabra de Mora (44048),0,2,-2
2007,Teruel,Calaceite (44049),6,16,-10
2007,Teruel,Calamocha (44050),45,49,-4
2007,Teruel,Calanda (44051),32,35,-3
2007,Teruel,Camarena de la Sierra (44054),1,,1
2007,Teruel,Camañas (44053),1,2,-1
2007,Teruel,Caminreal (44056),3,12,-9
2007,Teruel,Cantavieja (44059),5,8,-3
2007,Teruel,Cascante del Río (44064),0,2,-2
2007,Teruel,Castejón de Tornos (44065),0,1,-1
2007,Teruel,Castel de Cabra (44066),1,2,-1
2007,Teruel,Castellar (El) (44070),0,2,-2
2007,Teruel,Castellote (44071),9,19,-10
2007,Teruel,Castelnou (44067),1,1,0
2007,Teruel,Castelserás (44068),5,13,-8
2007,Teruel,Cañada de Verich (La) (44061),0,2,-2
2007,Teruel,Cañada Vellida (44062),0,1,-1
2007,Teruel,Cañizar del Olivar (44063),0,1,-1
2007,Teruel,Cedrillas (44074),8,9,-1
2007,Teruel,Celadas (44075),1,3,-2
2007,Teruel,Cella (44076),28,32,-4
2007,Teruel,Cerollera (La) (44077),0,3,-3
2007,Teruel,Codoñera (La) (44080),4,3,1
2007,Teruel,Corbalán (44082),0,3,-3
2007,Teruel,Cortes de Aragón (44084),2,,2
2007,Teruel,Cosa (44085),0,3,-3
2007,Teruel,Cretas (44086),8,9,-1
2007,Teruel,Crivillén (44087),0,6,-6
2007,Teruel,Cuba (La) (44088),1,,1
2007,Teruel,Cubla (44089),0,1,-1
2007,Teruel,Cucalón (44090),0,2,-2
2007,Teruel,Cuevas de Almudén (44093),0,1,-1
2007,Teruel,Cuevas Labradas (44094),0,3,-3
2007,Teruel,Ejulve (44096),1,2,-1
2007,Teruel,Escorihuela (44097),1,4,-3
2007,Teruel,Escucha (44099),9,9,0
2007,Teruel,Estercuel (44100),1,2,-1
2007,Teruel,Ferreruela de Huerva (44101),0,1,-1
2007,Teruel,Formiche Alto (44103),0,1,-1
2007,Teruel,Fortanete (44106),7,,7
2007,Teruel,Foz-Calanda (44107),2,3,-1
2007,Teruel,Fresneda (La) (44108),4,5,-1
2007,Teruel,Frías de Albarracín (44109),1,,1
2007,Teruel,Fuentes Claras (44112),1,13,-12
2007,Teruel,Fuentes de Rubielos (44113),1,1,0
2007,Teruel,Fuentespalda (44114),3,3,0
2007,Teruel,Fórnoles (44105),0,3,-3
2007,Teruel,Galve (44115),0,,0
2007,Teruel,Gargallo (44116),1,,1
2007,Teruel,Gea de Albarracín (44117),4,10,-6
2007,Teruel,Ginebrosa (La) (44118),1,1,0
2007,Teruel,Griegos (44119),1,1,0
2007,Teruel,Guadalaviar (44120),2,3,-1
2007,Teruel,Gúdar (44121),2,1,1
2007,Teruel,Hinojosa de Jarque (44123),1,1,0
2007,Teruel,Hoz de la Vieja (La) (44124),0,2,-2
2007,Teruel,Huesa del Común (44125),1,2,-1
2007,Teruel,Híjar (44122),11,30,-19
2007,Teruel,Iglesuela del Cid (La) (44126),3,4,-1
2007,Teruel,Jabaloyas (44127),1,2,-1
2007,Teruel,Jarque de la Val (44128),1,1,0
2007,Teruel,Jatiel (44129),1,3,-2
2007,Teruel,Jorcas (44130),0,2,-2
2007,Teruel,Libros (44135),0,2,-2
2007,Teruel,Lidón (44136),0,2,-2
2007,Teruel,Linares de Mora (44137),0,3,-3
2007,Teruel,Lledó (44141),0,2,-2
2007,Teruel,Loscos (44138),0,2,-2
2007,Teruel,Manzanera (44143),5,11,-6
2007,Teruel,Martín del Río (44144),4,6,-2
2007,Teruel,Mas de las Matas (44145),5,27,-22
2007,Teruel,Mata de los Olmos (La) (44146),4,3,1
2007,Teruel,Mazaleón (44147),2,10,-8
2007,Teruel,Mezquita de Jarque (44148),0,2,-2
2007,Teruel,Mirambel (44149),2,3,-1
2007,Teruel,Miravete de la Sierra (44150),0,2,-2
2007,Teruel,Molinos (44151),1,9,-8
2007,Teruel,Monreal del Campo (44153),29,39,-10
2007,Teruel,Monroyo (44154),2,4,-2
2007,Teruel,Montalbán (44155),5,12,-7
2007,Teruel,Monterde de Albarracín (44157),0,3,-3
2007,Teruel,Mora de Rubielos (44158),12,18,-6
2007,Teruel,Mosqueruela (44160),2,11,-9
2007,Teruel,Muniesa (44161),5,18,-13
2007,Teruel,Noguera de Albarracín (44163),1,2,-1
2007,Teruel,Nogueruelas (44165),3,6,-3
2007,Teruel,Odón (44168),0,4,-4
2007,Teruel,Ojos Negros (44169),2,7,-5
2007,Teruel,Olba (44171),1,1,0
2007,Teruel,Oliete (44172),3,6,-3
2007,Teruel,Olmos (Los) (44173),0,1,-1
2007,Teruel,Orihuela del Tremedal (44174),2,7,-5
2007,Teruel,Orrios (44175),1,2,-1
2007,Teruel,Palomar de Arroyos (44176),1,1,0
2007,Teruel,Pancrudo (44177),1,4,-3
2007,Teruel,Parras de Castellote (Las) (44178),0,2,-2
2007,Teruel,Peracense (44180),0,2,-2
2007,Teruel,Peralejos (44181),0,1,-1
2007,Teruel,Perales del Alfambra (44182),2,4,-2
2007,Teruel,Peñarroya de Tastavins (44179),5,9,-4
2007,Teruel,Pitarque (44183),0,2,-2
2007,Teruel,Plou (44184),0,2,-2
2007,Teruel,Pobo (El) (44185),0,2,-2
2007,Teruel,Portellada (La) (44187),1,5,-4
2007,Teruel,Pozondón (44189),0,3,-3
2007,Teruel,Pozuel del Campo (44190),0,1,-1
2007,Teruel,Puebla de Híjar (La) (44191),5,9,-4
2007,Teruel,Puebla de Valverde (La) (44192),3,10,-7
2007,Teruel,Puertomingalvo (44193),3,3,0
2007,Teruel,Riodeva (44196),0,3,-3
2007,Teruel,Royuela (44198),1,4,-3
2007,Teruel,Rubiales (44199),0,3,-3
2007,Teruel,Rubielos de la Cérida (44200),0,3,-3
2007,Teruel,Rubielos de Mora (44201),3,6,-3
2007,Teruel,Ráfales (44194),2,2,0
2007,Teruel,Ródenas (44197),0,1,-1
2007,Teruel,Saldón (44204),1,,1
2007,Teruel,Samper de Calanda (44205),2,17,-15
2007,Teruel,San Agustín (44206),1,3,-2
2007,Teruel,San Martín del Río (44207),0,6,-6
2007,Teruel,Santa Eulalia (44209),13,19,-6
2007,Teruel,Sarrión (44210),5,15,-10
2007,Teruel,Segura de los Baños (44211),0,1,-1
2007,Teruel,Singra (44213),0,1,-1
2007,Teruel,Terriente (44215),2,7,-5
2007,Teruel,Teruel (44216),381,284,97
2007,Teruel,Toril y Masegoso (44217),0,1,-1
2007,Teruel,Tormón (44218),0,1,-1
2007,Teruel,Tornos (44219),0,7,-7
2007,Teruel,Torralba de los Sisones (44220),0,1,-1
2007,Teruel,Torre de Arcas (44223),1,2,-1
2007,Teruel,Torre de las Arcas (44224),0,1,-1
2007,Teruel,Torre del Compte (44225),0,3,-3
2007,Teruel,Torre los Negros (44227),0,2,-2
2007,Teruel,Torrecilla de Alcañiz (44221),0,8,-8
2007,Teruel,Torrecilla del Rebollar (44222),1,2,-1
2007,Teruel,Torrelacárcel (44226),0,3,-3
2007,Teruel,Torremocha de Jiloca (44228),0,4,-4
2007,Teruel,Torres de Albarracín (44229),1,1,0
2007,Teruel,Torrevelilla (44230),2,8,-6
2007,Teruel,Torrijas (44231),0,1,-1
2007,Teruel,Torrijo del Campo (44232),5,9,-4
2007,Teruel,Tramacastilla (44235),1,3,-2
2007,Teruel,Tronchón (44236),2,,2
2007,Teruel,Urrea de Gaén (44237),3,5,-2
2007,Teruel,Utrillas (44238),23,32,-9
2007,Teruel,Valacloche (44239),0,1,-1
2007,Teruel,Valbona (44240),1,5,-4
2007,Teruel,Valdealgorfa (44241),1,9,-8
2007,Teruel,Valdelinares (44244),0,2,-2
2007,Teruel,Valdeltormo (44245),2,5,-3
2007,Teruel,Valderrobres (44246),26,30,-4
2007,Teruel,Valjunquera (44247),3,7,-4
2007,Teruel,Vallecillo (El) (44249),0,1,-1
2007,Teruel,Villafranca del Campo (44251),6,6,0
2007,Teruel,Villahermosa del Campo (44252),2,2,0
2007,Teruel,Villar del Cobo (44257),2,2,0
2007,Teruel,Villar del Salz (44258),0,1,-1
2007,Teruel,Villarluengo (44260),0,7,-7
2007,Teruel,Villarquemado (44261),4,17,-13
2007,Teruel,Villarroya de los Pinares (44262),1,3,-2
2007,Teruel,Villastar (44263),5,11,-6
2007,Teruel,Villel (44264),3,9,-6
2007,Teruel,Vinaceite (44265),0,5,-5
2007,Teruel,Visiedo (44266),0,5,-5
2007,Teruel,Vivel del Río Martín (44267),1,2,-1
2006,Teruel,Ababuj (44001),0,1,-1
2006,Teruel,Abejuela (44002),0,1,-1
2006,Teruel,Aguaviva (44004),3,5,-2
2006,Teruel,Aguilar del Alfambra (44005),0,1,-1
2006,Teruel,Alacón (44006),3,6,-3
2006,Teruel,Alba (44007),0,2,-2
2006,Teruel,Albalate del Arzobispo (44008),7,32,-25
2006,Teruel,Albarracín (44009),5,16,-11
2006,Teruel,Albentosa (44010),5,3,2
2006,Teruel,Alcalá de la Selva (44012),5,5,0
2006,Teruel,Alcañiz (44013),203,169,34
2006,Teruel,Alcorisa (44014),36,43,-7
2006,Teruel,Alfambra (44016),3,12,-9
2006,Teruel,Aliaga (44017),3,9,-6
2006,Teruel,Allepuz (44021),0,3,-3
2006,Teruel,Alloza (44022),4,10,-6
2006,Teruel,Allueva (44023),0,1,-1
2006,Teruel,Almohaja (44018),0,1,-1
2006,Teruel,Alobras (44019),0,2,-2
2006,Teruel,Andorra (44025),67,63,4
2006,Teruel,Arcos de las Salinas (44026),1,2,-1
2006,Teruel,Arens de Lledó (44027),0,4,-4
2006,Teruel,Argente (44028),0,3,-3
2006,Teruel,Ariño (44029),4,5,-1
2006,Teruel,Azaila (44031),1,5,-4
2006,Teruel,Barrachina (44035),0,3,-3
2006,Teruel,Bañón (44034),2,3,-1
2006,Teruel,Beceite (44037),3,10,-7
2006,Teruel,Bello (44039),0,7,-7
2006,Teruel,Belmonte de San José (44038),0,3,-3
2006,Teruel,Berge (44040),1,3,-2
2006,Teruel,Bezas (44041),0,1,-1
2006,Teruel,Blancas (44042),0,2,-2
2006,Teruel,Bordón (44044),0,4,-4
2006,Teruel,Bronchales (44045),1,6,-5
2006,Teruel,Bueña (44046),0,1,-1
2006,Teruel,Burbáguena (44047),0,12,-12
2006,Teruel,Báguena (44033),1,7,-6
2006,Teruel,Cabra de Mora (44048),0,1,-1
2006,Teruel,Calaceite (44049),5,19,-14
2006,Teruel,Calamocha (44050),38,48,-10
2006,Teruel,Calanda (44051),24,59,-35
2006,Teruel,Calomarde (44052),0,1,-1
2006,Teruel,Camarena de la Sierra (44054),0,2,-2
2006,Teruel,Camarillas (44055),1,1,0
2006,Teruel,Camañas (44053),0,1,-1
2006,Teruel,Caminreal (44056),2,11,-9
2006,Teruel,Cantavieja (44059),4,5,-1
2006,Teruel,Cascante del Río (44064),0,1,-1
2006,Teruel,Castejón de Tornos (44065),0,1,-1
2006,Teruel,Castel de Cabra (44066),0,4,-4
2006,Teruel,Castellote (44071),5,12,-7
2006,Teruel,Castelnou (44067),0,3,-3
2006,Teruel,Castelserás (44068),11,14,-3
2006,Teruel,Cañada de Benatanduz (44060),0,2,-2
2006,Teruel,Cañada de Verich (La) (44061),0,1,-1
2006,Teruel,Cañada Vellida (44062),0,2,-2
2006,Teruel,Cañizar del Olivar (44063),0,1,-1
2006,Teruel,Cedrillas (44074),4,12,-8
2006,Teruel,Celadas (44075),2,8,-6
2006,Teruel,Cella (44076),24,28,-4
2006,Teruel,Cerollera (La) (44077),1,2,-1
2006,Teruel,Codoñera (La) (44080),1,3,-2
2006,Teruel,Corbalán (44082),0,,0
2006,Teruel,Cretas (44086),5,10,-5
2006,Teruel,Crivillén (44087),0,4,-4
2006,Teruel,Cuba (La) (44088),0,,0
2006,Teruel,Cucalón (44090),2,,2
2006,Teruel,Cuervo (El) (44092),1,3,-2
2006,Teruel,Cuevas de Almudén (44093),2,1,1
2006,Teruel,Cuevas Labradas (44094),0,1,-1
2006,Teruel,Ejulve (44096),0,2,-2
2006,Teruel,Escorihuela (44097),0,4,-4
2006,Teruel,Escucha (44099),10,8,2
2006,Teruel,Estercuel (44100),0,5,-5
2006,Teruel,Ferreruela de Huerva (44101),0,2,-2
2006,Teruel,Formiche Alto (44103),1,1,0
2006,Teruel,Fortanete (44106),0,7,-7
2006,Teruel,Foz-Calanda (44107),0,3,-3
2006,Teruel,Fresneda (La) (44108),3,4,-1
2006,Teruel,Frías de Albarracín (44109),0,1,-1
2006,Teruel,Fuenferrada (44110),0,1,-1
2006,Teruel,Fuentes Calientes (44111),0,1,-1
2006,Teruel,Fuentes Claras (44112),8,9,-1
2006,Teruel,Fuentes de Rubielos (44113),2,,2
2006,Teruel,Fuentespalda (44114),2,4,-2
2006,Teruel,Fórnoles (44105),1,2,-1
2006,Teruel,Galve (44115),1,2,-1
2006,Teruel,Gargallo (44116),0,1,-1
2006,Teruel,Gea de Albarracín (44117),0,6,-6
2006,Teruel,Ginebrosa (La) (44118),2,2,0
2006,Teruel,Griegos (44119),0,1,-1
2006,Teruel,Guadalaviar (44120),1,3,-2
2006,Teruel,Gúdar (44121),0,,0
2006,Teruel,Hinojosa de Jarque (44123),0,3,-3
2006,Teruel,Hoz de la Vieja (La) (44124),1,3,-2
2006,Teruel,Huesa del Común (44125),0,1,-1
2006,Teruel,Híjar (44122),19,22,-3
2006,Teruel,Iglesuela del Cid (La) (44126),4,10,-6
2006,Teruel,Jabaloyas (44127),0,3,-3
2006,Teruel,Jarque de la Val (44128),0,2,-2
2006,Teruel,Jatiel (44129),0,2,-2
2006,Teruel,Josa (44131),1,1,0
2006,Teruel,Lanzuela (44133),0,2,-2
2006,Teruel,Libros (44135),0,2,-2
2006,Teruel,Lidón (44136),0,2,-2
2006,Teruel,Linares de Mora (44137),4,2,2
2006,Teruel,Lledó (44141),0,4,-4
2006,Teruel,Maicas (44142),0,1,-1
2006,Teruel,Manzanera (44143),6,7,-1
2006,Teruel,Martín del Río (44144),1,7,-6
2006,Teruel,Mas de las Matas (44145),10,17,-7
2006,Teruel,Mata de los Olmos (La) (44146),0,1,-1
2006,Teruel,Mazaleón (44147),2,9,-7
2006,Teruel,Mezquita de Jarque (44148),1,3,-2
2006,Teruel,Mirambel (44149),1,2,-1
2006,Teruel,Molinos (44151),0,5,-5
2006,Teruel,Monreal del Campo (44153),22,31,-9
2006,Teruel,Monroyo (44154),5,6,-1
2006,Teruel,Montalbán (44155),9,21,-12
2006,Teruel,Monteagudo del Castillo (44156),0,1,-1
2006,Teruel,Mora de Rubielos (44158),13,18,-5
2006,Teruel,Moscardón (44159),0,1,-1
2006,Teruel,Mosqueruela (44160),7,4,3
2006,Teruel,Muniesa (44161),5,5,0
2006,Teruel,Noguera de Albarracín (44163),0,1,-1
2006,Teruel,Nogueruelas (44165),1,3,-2
2006,Teruel,Obón (44167),0,1,-1
2006,Teruel,Odón (44168),3,5,-2
2006,Teruel,Ojos Negros (44169),9,5,4
2006,Teruel,Olba (44171),0,2,-2
2006,Teruel,Oliete (44172),1,3,-2
2006,Teruel,Orihuela del Tremedal (44174),4,4,0
2006,Teruel,Orrios (44175),0,2,-2
2006,Teruel,Palomar de Arroyos (44176),0,3,-3
2006,Teruel,Pancrudo (44177),2,1,1
2006,Teruel,Parras de Castellote (Las) (44178),1,,1
2006,Teruel,Peracense (44180),0,1,-1
2006,Teruel,Peralejos (44181),0,1,-1
2006,Teruel,Perales del Alfambra (44182),3,4,-1
2006,Teruel,Peñarroya de Tastavins (44179),2,9,-7
2006,Teruel,Plou (44184),0,2,-2
2006,Teruel,Pobo (El) (44185),1,1,0
2006,Teruel,Portellada (La) (44187),2,7,-5
2006,Teruel,Pozondón (44189),0,2,-2
2006,Teruel,Pozuel del Campo (44190),0,1,-1
2006,Teruel,Puebla de Híjar (La) (44191),6,18,-12
2006,Teruel,Puebla de Valverde (La) (44192),4,5,-1
2006,Teruel,Puertomingalvo (44193),1,1,0
2006,Teruel,Rillo (44195),0,3,-3
2006,Teruel,Riodeva (44196),0,5,-5
2006,Teruel,Royuela (44198),2,5,-3
2006,Teruel,Rubiales (44199),0,1,-1
2006,Teruel,Rubielos de Mora (44201),7,4,3
2006,Teruel,Ráfales (44194),0,6,-6
2006,Teruel,Ródenas (44197),0,2,-2
2006,Teruel,Samper de Calanda (44205),5,19,-14
2006,Teruel,San Agustín (44206),0,1,-1
2006,Teruel,San Martín del Río (44207),0,3,-3
2006,Teruel,Santa Cruz de Nogueras (44208),0,1,-1
2006,Teruel,Santa Eulalia (44209),1,25,-24
2006,Teruel,Sarrión (44210),7,12,-5
2006,Teruel,Singra (44213),0,1,-1
2006,Teruel,Terriente (44215),0,4,-4
2006,Teruel,Teruel (44216),357,317,40
2006,Teruel,Toril y Masegoso (44217),0,2,-2
2006,Teruel,Tornos (44219),1,1,0
2006,Teruel,Torralba de los Sisones (44220),3,3,0
2006,Teruel,Torre de Arcas (44223),1,2,-1
2006,Teruel,Torre del Compte (44225),0,1,-1
2006,Teruel,Torre los Negros (44227),0,1,-1
2006,Teruel,Torrecilla de Alcañiz (44221),3,7,-4
2006,Teruel,Torrecilla del Rebollar (44222),1,2,-1
2006,Teruel,Torrelacárcel (44226),1,2,-1
2006,Teruel,Torremocha de Jiloca (44228),0,4,-4
2006,Teruel,Torres de Albarracín (44229),2,1,1
2006,Teruel,Torrevelilla (44230),1,3,-2
2006,Teruel,Torrijo del Campo (44232),2,7,-5
2006,Teruel,Tramacastiel (44234),0,3,-3
2006,Teruel,Tramacastilla (44235),3,1,2
2006,Teruel,Tronchón (44236),0,1,-1
2006,Teruel,Urrea de Gaén (44237),2,10,-8
2006,Teruel,Utrillas (44238),25,30,-5
2006,Teruel,Valbona (44240),1,2,-1
2006,Teruel,Valdealgorfa (44241),0,11,-11
2006,Teruel,Valdelinares (44244),0,1,-1
2006,Teruel,Valdeltormo (44245),0,1,-1
2006,Teruel,Valderrobres (44246),19,29,-10
2006,Teruel,Valjunquera (44247),2,4,-2
2006,Teruel,Vallecillo (El) (44249),0,1,-1
2006,Teruel,Villafranca del Campo (44251),3,5,-2
2006,Teruel,Villahermosa del Campo (44252),0,3,-3
2006,Teruel,Villar del Cobo (44257),0,2,-2
2006,Teruel,Villar del Salz (44258),0,4,-4
2006,Teruel,Villarluengo (44260),1,4,-3
2006,Teruel,Villarquemado (44261),4,18,-14
2006,Teruel,Villarroya de los Pinares (44262),3,3,0
2006,Teruel,Villastar (44263),1,3,-2
2006,Teruel,Villel (44264),6,6,0
2006,Teruel,Vinaceite (44265),0,6,-6
2006,Teruel,Visiedo (44266),0,1,-1
2006,Teruel,Zoma (La) (44268),0,1,-1
2005,Teruel,Ababuj (44001),1,,1
2005,Teruel,Abejuela (44002),1,,1
2005,Teruel,Aguatón (44003),0,,0
2005,Teruel,Aguaviva (44004),7,11,-4
2005,Teruel,Aguilar del Alfambra (44005),0,,0
2005,Teruel,Alacón (44006),2,5,-3
2005,Teruel,Alba (44007),0,7,-7
2005,Teruel,Albalate del Arzobispo (44008),10,29,-19
2005,Teruel,Albarracín (44009),8,8,0
2005,Teruel,Albentosa (44010),2,3,-1
2005,Teruel,Alcaine (44011),1,3,-2
2005,Teruel,Alcalá de la Selva (44012),2,9,-7
2005,Teruel,Alcañiz (44013),199,153,46
2005,Teruel,Alcorisa (44014),35,39,-4
2005,Teruel,Alfambra (44016),4,19,-15
2005,Teruel,Aliaga (44017),5,7,-2
2005,Teruel,Allepuz (44021),2,2,0
2005,Teruel,Alloza (44022),3,7,-4
2005,Teruel,Alobras (44019),0,3,-3
2005,Teruel,Andorra (44025),51,74,-23
2005,Teruel,Arcos de las Salinas (44026),0,2,-2
2005,Teruel,Arens de Lledó (44027),2,1,1
2005,Teruel,Argente (44028),0,5,-5
2005,Teruel,Ariño (44029),2,5,-3
2005,Teruel,Azaila (44031),0,4,-4
2005,Teruel,Barrachina (44035),1,3,-2
2005,Teruel,Bañón (44034),0,2,-2
2005,Teruel,Beceite (44037),3,8,-5
2005,Teruel,Bello (44039),1,4,-3
2005,Teruel,Belmonte de San José (44038),0,1,-1
2005,Teruel,Berge (44040),2,5,-3
2005,Teruel,Bezas (44041),1,,1
2005,Teruel,Blesa (44043),0,2,-2
2005,Teruel,Bordón (44044),1,,1
2005,Teruel,Bronchales (44045),2,5,-3
2005,Teruel,Bueña (44046),0,4,-4
2005,Teruel,Burbáguena (44047),0,10,-10
2005,Teruel,Báguena (44033),2,7,-5
2005,Teruel,Cabra de Mora (44048),0,1,-1
2005,Teruel,Calaceite (44049),4,12,-8
2005,Teruel,Calamocha (44050),42,51,-9
2005,Teruel,Calanda (44051),22,50,-28
2005,Teruel,Calomarde (44052),0,,0
2005,Teruel,Camarena de la Sierra (44054),0,2,-2
2005,Teruel,Camarillas (44055),0,1,-1
2005,Teruel,Camañas (44053),1,4,-3
2005,Teruel,Caminreal (44056),6,16,-10
2005,Teruel,Cantavieja (44059),5,7,-2
2005,Teruel,Cascante del Río (44064),1,,1
2005,Teruel,Castejón de Tornos (44065),1,1,0
2005,Teruel,Castel de Cabra (44066),2,2,0
2005,Teruel,Castellar (El) (44070),1,,1
2005,Teruel,Castellote (44071),5,7,-2
2005,Teruel,Castelnou (44067),1,2,-1
2005,Teruel,Castelserás (44068),7,11,-4
2005,Teruel,Cañada de Benatanduz (44060),0,3,-3
2005,Teruel,Cañada de Verich (La) (44061),0,1,-1
2005,Teruel,Cañizar del Olivar (44063),1,3,-2
2005,Teruel,Cedrillas (44074),8,5,3
2005,Teruel,Celadas (44075),3,6,-3
2005,Teruel,Cella (44076),30,35,-5
2005,Teruel,Codoñera (La) (44080),2,2,0
2005,Teruel,Corbalán (44082),0,1,-1
2005,Teruel,Cortes de Aragón (44084),0,1,-1
2005,Teruel,Cosa (44085),0,1,-1
2005,Teruel,Cretas (44086),6,9,-3
2005,Teruel,Cuba (La) (44088),1,2,-1
2005,Teruel,Cubla (44089),0,1,-1
2005,Teruel,Cucalón (44090),2,1,1
2005,Teruel,Cuevas de Almudén (44093),1,,1
2005,Teruel,Cuevas Labradas (44094),0,5,-5
2005,Teruel,Ejulve (44096),2,1,1
2005,Teruel,Escorihuela (44097),0,4,-4
2005,Teruel,Escucha (44099),8,12,-4
2005,Teruel,Estercuel (44100),1,6,-5
2005,Teruel,Ferreruela de Huerva (44101),0,1,-1
2005,Teruel,Fonfría (44102),0,1,-1
2005,Teruel,Formiche Alto (44103),0,5,-5
2005,Teruel,Fortanete (44106),0,1,-1
2005,Teruel,Foz-Calanda (44107),3,5,-2
2005,Teruel,Fresneda (La) (44108),3,10,-7
2005,Teruel,Frías de Albarracín (44109),1,3,-2
2005,Teruel,Fuenferrada (44110),0,1,-1
2005,Teruel,Fuentes Calientes (44111),1,4,-3
2005,Teruel,Fuentes Claras (44112),1,11,-10
2005,Teruel,Fuentes de Rubielos (44113),2,1,1
2005,Teruel,Fuentespalda (44114),1,10,-9
2005,Teruel,Galve (44115),1,5,-4
2005,Teruel,Gargallo (44116),2,3,-1
2005,Teruel,Gea de Albarracín (44117),0,7,-7
2005,Teruel,Ginebrosa (La) (44118),1,5,-4
2005,Teruel,Griegos (44119),1,,1
2005,Teruel,Guadalaviar (44120),2,4,-2
2005,Teruel,Gúdar (44121),1,2,-1
2005,Teruel,Hinojosa de Jarque (44123),0,6,-6
2005,Teruel,Hoz de la Vieja (La) (44124),0,5,-5
2005,Teruel,Huesa del Común (44125),1,1,0
2005,Teruel,Híjar (44122),12,30,-18
2005,Teruel,Iglesuela del Cid (La) (44126),3,6,-3
2005,Teruel,Jabaloyas (44127),0,1,-1
2005,Teruel,Jarque de la Val (44128),1,1,0
2005,Teruel,Jatiel (44129),0,1,-1
2005,Teruel,Jorcas (44130),0,1,-1
2005,Teruel,Josa (44131),0,1,-1
2005,Teruel,Lagueruela (44132),0,1,-1
2005,Teruel,Lanzuela (44133),0,1,-1
2005,Teruel,Linares de Mora (44137),0,7,-7
2005,Teruel,Lledó (44141),0,4,-4
2005,Teruel,Loscos (44138),0,8,-8
2005,Teruel,Maicas (44142),0,1,-1
2005,Teruel,Manzanera (44143),3,5,-2
2005,Teruel,Martín del Río (44144),4,5,-1
2005,Teruel,Mas de las Matas (44145),11,18,-7
2005,Teruel,Mata de los Olmos (La) (44146),1,5,-4
2005,Teruel,Mazaleón (44147),3,8,-5
2005,Teruel,Mezquita de Jarque (44148),2,2,0
2005,Teruel,Mirambel (44149),0,5,-5
2005,Teruel,Molinos (44151),1,5,-4
2005,Teruel,Monreal del Campo (44153),18,24,-6
2005,Teruel,Monroyo (44154),4,10,-6
2005,Teruel,Montalbán (44155),6,9,-3
2005,Teruel,Monteagudo del Castillo (44156),0,1,-1
2005,Teruel,Monterde de Albarracín (44157),0,1,-1
2005,Teruel,Mora de Rubielos (44158),13,20,-7
2005,Teruel,Moscardón (44159),2,,2
2005,Teruel,Mosqueruela (44160),5,7,-2
2005,Teruel,Muniesa (44161),2,11,-9
2005,Teruel,Noguera de Albarracín (44163),1,2,-1
2005,Teruel,Nogueruelas (44165),3,5,-2
2005,Teruel,Odón (44168),2,4,-2
2005,Teruel,Ojos Negros (44169),3,12,-9
2005,Teruel,Olba (44171),0,2,-2
2005,Teruel,Oliete (44172),2,11,-9
2005,Teruel,Orihuela del Tremedal (44174),2,9,-7
2005,Teruel,Orrios (44175),1,2,-1
2005,Teruel,Palomar de Arroyos (44176),1,3,-2
2005,Teruel,Pancrudo (44177),1,6,-5
2005,Teruel,Parras de Castellote (Las) (44178),1,2,-1
2005,Teruel,Peracense (44180),0,3,-3
2005,Teruel,Peralejos (44181),0,4,-4
2005,Teruel,Perales del Alfambra (44182),0,5,-5
2005,Teruel,Peñarroya de Tastavins (44179),5,12,-7
2005,Teruel,Pitarque (44183),0,1,-1
2005,Teruel,Plou (44184),0,1,-1
2005,Teruel,Pobo (El) (44185),0,1,-1
2005,Teruel,Portellada (La) (44187),0,3,-3
2005,Teruel,Pozondón (44189),0,,0
2005,Teruel,Pozuel del Campo (44190),0,2,-2
2005,Teruel,Puebla de Híjar (La) (44191),12,14,-2
2005,Teruel,Puebla de Valverde (La) (44192),4,11,-7
2005,Teruel,Puertomingalvo (44193),0,,0
2005,Teruel,Rillo (44195),1,4,-3
2005,Teruel,Riodeva (44196),1,3,-2
2005,Teruel,Royuela (44198),0,2,-2
2005,Teruel,Rubiales (44199),0,1,-1
2005,Teruel,Rubielos de Mora (44201),5,8,-3
2005,Teruel,Ráfales (44194),0,4,-4
2005,Teruel,Ródenas (44197),0,2,-2
2005,Teruel,Saldón (44204),0,1,-1
2005,Teruel,Samper de Calanda (44205),6,12,-6
2005,Teruel,San Agustín (44206),0,2,-2
2005,Teruel,San Martín del Río (44207),2,4,-2
2005,Teruel,Santa Cruz de Nogueras (44208),0,1,-1
2005,Teruel,Santa Eulalia (44209),7,17,-10
2005,Teruel,Sarrión (44210),11,19,-8
2005,Teruel,Segura de los Baños (44211),0,1,-1
2005,Teruel,Seno (44212),0,1,-1
2005,Teruel,Singra (44213),0,2,-2
2005,Teruel,Terriente (44215),1,2,-1
2005,Teruel,Teruel (44216),346,339,7
2005,Teruel,Tormón (44218),0,1,-1
2005,Teruel,Tornos (44219),1,2,-1
2005,Teruel,Torralba de los Sisones (44220),0,1,-1
2005,Teruel,Torre de Arcas (44223),1,2,-1
2005,Teruel,Torre de las Arcas (44224),1,,1
2005,Teruel,Torre del Compte (44225),0,4,-4
2005,Teruel,Torre los Negros (44227),1,,1
2005,Teruel,Torrecilla de Alcañiz (44221),1,4,-3
2005,Teruel,Torrecilla del Rebollar (44222),0,3,-3
2005,Teruel,Torrelacárcel (44226),0,6,-6
2005,Teruel,Torremocha de Jiloca (44228),0,4,-4
2005,Teruel,Torres de Albarracín (44229),3,1,2
2005,Teruel,Torrevelilla (44230),2,2,0
2005,Teruel,Torrijas (44231),1,1,0
2005,Teruel,Torrijo del Campo (44232),2,9,-7
2005,Teruel,Tramacastiel (44234),0,2,-2
2005,Teruel,Tramacastilla (44235),0,4,-4
2005,Teruel,Urrea de Gaén (44237),1,8,-7
2005,Teruel,Utrillas (44238),10,33,-23
2005,Teruel,Valacloche (44239),0,1,-1
2005,Teruel,Valbona (44240),0,1,-1
2005,Teruel,Valdealgorfa (44241),3,11,-8
2005,Teruel,Valdeltormo (44245),2,2,0
2005,Teruel,Valderrobres (44246),23,27,-4
2005,Teruel,Valjunquera (44247),2,5,-3
2005,Teruel,Vallecillo (El) (44249),0,1,-1
2005,Teruel,Villafranca del Campo (44251),2,10,-8
2005,Teruel,Villahermosa del Campo (44252),0,1,-1
2005,Teruel,Villar del Cobo (44257),1,4,-3
2005,Teruel,Villar del Salz (44258),0,2,-2
2005,Teruel,Villarluengo (44260),0,1,-1
2005,Teruel,Villarquemado (44261),4,16,-12
2005,Teruel,Villarroya de los Pinares (44262),1,1,0
2005,Teruel,Villastar (44263),2,4,-2
2005,Teruel,Villel (44264),3,8,-5
2005,Teruel,Vinaceite (44265),4,3,1
2005,Teruel,Visiedo (44266),0,7,-7
2005,Teruel,Vivel del Río Martín (44267),0,2,-2
2005,Teruel,Zoma (La) (44268),0,1,-1
2004,Teruel,Ababuj (44001),0,1,-1
2004,Teruel,Aguatón (44003),0,1,-1
2004,Teruel,Aguaviva (44004),1,10,-9
2004,Teruel,Aguilar del Alfambra (44005),1,3,-2
2004,Teruel,Alacón (44006),3,9,-6
2004,Teruel,Alba (44007),2,6,-4
2004,Teruel,Albalate del Arzobispo (44008),11,38,-27
2004,Teruel,Albarracín (44009),9,7,2
2004,Teruel,Albentosa (44010),4,6,-2
2004,Teruel,Alcalá de la Selva (44012),2,3,-1
2004,Teruel,Alcañiz (44013),157,163,-6
2004,Teruel,Alcorisa (44014),30,42,-12
2004,Teruel,Alfambra (44016),3,14,-11
2004,Teruel,Aliaga (44017),0,6,-6
2004,Teruel,Allepuz (44021),0,6,-6
2004,Teruel,Alloza (44022),2,6,-4
2004,Teruel,Alobras (44019),1,,1
2004,Teruel,Andorra (44025),67,61,6
2004,Teruel,Arcos de las Salinas (44026),0,1,-1
2004,Teruel,Arens de Lledó (44027),0,3,-3
2004,Teruel,Argente (44028),0,5,-5
2004,Teruel,Ariño (44029),7,14,-7
2004,Teruel,Azaila (44031),0,1,-1
2004,Teruel,Barrachina (44035),0,3,-3
2004,Teruel,Bañón (44034),1,,1
2004,Teruel,Beceite (44037),2,9,-7
2004,Teruel,Bello (44039),2,9,-7
2004,Teruel,Belmonte de San José (44038),2,1,1
2004,Teruel,Berge (44040),2,2,0
2004,Teruel,Bezas (44041),0,1,-1
2004,Teruel,Blancas (44042),0,1,-1
2004,Teruel,Bordón (44044),1,,1
2004,Teruel,Bronchales (44045),2,8,-6
2004,Teruel,Bueña (44046),0,1,-1
2004,Teruel,Burbáguena (44047),0,10,-10
2004,Teruel,Báguena (44033),0,12,-12
2004,Teruel,Cabra de Mora (44048),0,1,-1
2004,Teruel,Calaceite (44049),5,14,-9
2004,Teruel,Calamocha (44050),33,29,4
2004,Teruel,Calanda (44051),22,40,-18
2004,Teruel,Calomarde (44052),0,1,-1
2004,Teruel,Camarena de la Sierra (44054),1,2,-1
2004,Teruel,Camarillas (44055),0,1,-1
2004,Teruel,Caminreal (44056),2,9,-7
2004,Teruel,Cantavieja (44059),8,5,3
2004,Teruel,Cascante del Río (44064),0,5,-5
2004,Teruel,Castejón de Tornos (44065),0,2,-2
2004,Teruel,Castel de Cabra (44066),0,3,-3
2004,Teruel,Castellar (El) (44070),0,1,-1
2004,Teruel,Castellote (44071),4,10,-6
2004,Teruel,Castelnou (44067),0,2,-2
2004,Teruel,Castelserás (44068),7,19,-12
2004,Teruel,Cañada de Benatanduz (44060),0,1,-1
2004,Teruel,Cañada de Verich (La) (44061),2,,2
2004,Teruel,Cañada Vellida (44062),0,3,-3
2004,Teruel,Cañizar del Olivar (44063),0,5,-5
2004,Teruel,Cedrillas (44074),3,14,-11
2004,Teruel,Celadas (44075),1,2,-1
2004,Teruel,Cella (44076),15,21,-6
2004,Teruel,Cerollera (La) (44077),0,2,-2
2004,Teruel,Codoñera (La) (44080),4,2,2
2004,Teruel,Corbalán (44082),0,1,-1
2004,Teruel,Cortes de Aragón (44084),0,5,-5
2004,Teruel,Cosa (44085),0,1,-1
2004,Teruel,Cretas (44086),6,10,-4
2004,Teruel,Cubla (44089),0,2,-2
2004,Teruel,Cucalón (44090),1,2,-1
2004,Teruel,Cuervo (El) (44092),0,2,-2
2004,Teruel,Cuevas de Almudén (44093),1,2,-1
2004,Teruel,Cuevas Labradas (44094),1,3,-2
2004,Teruel,Ejulve (44096),2,2,0
2004,Teruel,Escorihuela (44097),0,6,-6
2004,Teruel,Escucha (44099),8,5,3
2004,Teruel,Estercuel (44100),0,6,-6
2004,Teruel,Ferreruela de Huerva (44101),0,1,-1
2004,Teruel,Fonfría (44102),0,1,-1
2004,Teruel,Formiche Alto (44103),4,2,2
2004,Teruel,Fortanete (44106),2,1,1
2004,Teruel,Foz-Calanda (44107),4,4,0
2004,Teruel,Fresneda (La) (44108),4,6,-2
2004,Teruel,Frías de Albarracín (44109),1,3,-2
2004,Teruel,Fuenferrada (44110),0,2,-2
2004,Teruel,Fuentes Calientes (44111),0,2,-2
2004,Teruel,Fuentes Claras (44112),2,8,-6
2004,Teruel,Fuentes de Rubielos (44113),2,1,1
2004,Teruel,Fuentespalda (44114),3,3,0
2004,Teruel,Fórnoles (44105),1,1,0
2004,Teruel,Galve (44115),3,1,2
2004,Teruel,Gargallo (44116),0,2,-2
2004,Teruel,Gea de Albarracín (44117),3,4,-1
2004,Teruel,Ginebrosa (La) (44118),1,7,-6
2004,Teruel,Griegos (44119),1,2,-1
2004,Teruel,Guadalaviar (44120),3,5,-2
2004,Teruel,Gúdar (44121),2,,2
2004,Teruel,Hinojosa de Jarque (44123),1,5,-4
2004,Teruel,Huesa del Común (44125),0,2,-2
2004,Teruel,Híjar (44122),10,27,-17
2004,Teruel,Iglesuela del Cid (La) (44126),4,5,-1
2004,Teruel,Jabaloyas (44127),0,2,-2
2004,Teruel,Jarque de la Val (44128),0,1,-1
2004,Teruel,Jatiel (44129),0,2,-2
2004,Teruel,Jorcas (44130),0,1,-1
2004,Teruel,Josa (44131),0,1,-1
2004,Teruel,Lanzuela (44133),0,1,-1
2004,Teruel,Libros (44135),0,5,-5
2004,Teruel,Lidón (44136),1,3,-2
2004,Teruel,Linares de Mora (44137),0,4,-4
2004,Teruel,Lledó (44141),0,1,-1
2004,Teruel,Loscos (44138),0,1,-1
2004,Teruel,Manzanera (44143),7,5,2
2004,Teruel,Martín del Río (44144),3,3,0
2004,Teruel,Mas de las Matas (44145),9,22,-13
2004,Teruel,Mata de los Olmos (La) (44146),0,3,-3
2004,Teruel,Mazaleón (44147),7,4,3
2004,Teruel,Mezquita de Jarque (44148),1,1,0
2004,Teruel,Mirambel (44149),0,,0
2004,Teruel,Miravete de la Sierra (44150),0,2,-2
2004,Teruel,Molinos (44151),1,4,-3
2004,Teruel,Monreal del Campo (44153),22,24,-2
2004,Teruel,Monroyo (44154),1,2,-1
2004,Teruel,Montalbán (44155),8,14,-6
2004,Teruel,Mora de Rubielos (44158),7,13,-6
2004,Teruel,Mosqueruela (44160),9,7,2
2004,Teruel,Muniesa (44161),3,6,-3
2004,Teruel,Noguera de Albarracín (44163),0,2,-2
2004,Teruel,Nogueruelas (44165),0,9,-9
2004,Teruel,Odón (44168),1,3,-2
2004,Teruel,Ojos Negros (44169),3,7,-4
2004,Teruel,Olba (44171),1,2,-1
2004,Teruel,Oliete (44172),1,8,-7
2004,Teruel,Olmos (Los) (44173),1,,1
2004,Teruel,Orihuela del Tremedal (44174),2,5,-3
2004,Teruel,Orrios (44175),0,5,-5
2004,Teruel,Pancrudo (44177),1,2,-1
2004,Teruel,Parras de Castellote (Las) (44178),0,5,-5
2004,Teruel,Peracense (44180),0,3,-3
2004,Teruel,Peralejos (44181),0,1,-1
2004,Teruel,Perales del Alfambra (44182),1,4,-3
2004,Teruel,Peñarroya de Tastavins (44179),0,3,-3
2004,Teruel,Pitarque (44183),0,2,-2
2004,Teruel,Plou (44184),0,2,-2
2004,Teruel,Pobo (El) (44185),0,2,-2
2004,Teruel,Portellada (La) (44187),0,2,-2
2004,Teruel,Pozondón (44189),0,4,-4
2004,Teruel,Pozuel del Campo (44190),0,5,-5
2004,Teruel,Puebla de Híjar (La) (44191),6,15,-9
2004,Teruel,Puebla de Valverde (La) (44192),6,8,-2
2004,Teruel,Puertomingalvo (44193),2,4,-2
2004,Teruel,Rillo (44195),0,5,-5
2004,Teruel,Riodeva (44196),0,6,-6
2004,Teruel,Royuela (44198),2,5,-3
2004,Teruel,Rubiales (44199),0,1,-1
2004,Teruel,Rubielos de Mora (44201),5,7,-2
2004,Teruel,Ráfales (44194),0,9,-9
2004,Teruel,Ródenas (44197),0,2,-2
2004,Teruel,Saldón (44204),0,2,-2
2004,Teruel,Samper de Calanda (44205),7,16,-9
2004,Teruel,San Agustín (44206),2,1,1
2004,Teruel,San Martín del Río (44207),0,2,-2
2004,Teruel,Santa Eulalia (44209),4,20,-16
2004,Teruel,Sarrión (44210),5,15,-10
2004,Teruel,Segura de los Baños (44211),0,1,-1
2004,Teruel,Seno (44212),0,,0
2004,Teruel,Terriente (44215),0,3,-3
2004,Teruel,Teruel (44216),367,324,43
2004,Teruel,Tornos (44219),1,7,-6
2004,Teruel,Torralba de los Sisones (44220),0,1,-1
2004,Teruel,Torre del Compte (44225),1,1,0
2004,Teruel,Torre los Negros (44227),0,,0
2004,Teruel,Torrecilla de Alcañiz (44221),2,8,-6
2004,Teruel,Torrecilla del Rebollar (44222),0,4,-4
2004,Teruel,Torrelacárcel (44226),2,5,-3
2004,Teruel,Torremocha de Jiloca (44228),0,2,-2
2004,Teruel,Torres de Albarracín (44229),1,1,0
2004,Teruel,Torrevelilla (44230),0,3,-3
2004,Teruel,Torrijas (44231),0,1,-1
2004,Teruel,Torrijo del Campo (44232),1,8,-7
2004,Teruel,Tramacastiel (44234),0,2,-2
2004,Teruel,Tramacastilla (44235),0,1,-1
2004,Teruel,Tronchón (44236),0,1,-1
2004,Teruel,Urrea de Gaén (44237),1,5,-4
2004,Teruel,Utrillas (44238),42,23,19
2004,Teruel,Valacloche (44239),0,1,-1
2004,Teruel,Valbona (44240),2,3,-1
2004,Teruel,Valdealgorfa (44241),4,7,-3
2004,Teruel,Valdecuenca (44243),0,1,-1
2004,Teruel,Valdelinares (44244),0,2,-2
2004,Teruel,Valdeltormo (44245),0,7,-7
2004,Teruel,Valderrobres (44246),21,27,-6
2004,Teruel,Valjunquera (44247),1,6,-5
2004,Teruel,Veguillas de la Sierra (44250),0,2,-2
2004,Teruel,Villafranca del Campo (44251),1,4,-3
2004,Teruel,Villahermosa del Campo (44252),0,1,-1
2004,Teruel,Villanueva del Rebollar de la Sierra (44256),1,2,-1
2004,Teruel,Villar del Cobo (44257),0,2,-2
2004,Teruel,Villar del Salz (44258),0,1,-1
2004,Teruel,Villarluengo (44260),1,3,-2
2004,Teruel,Villarquemado (44261),6,19,-13
2004,Teruel,Villarroya de los Pinares (44262),1,2,-1
2004,Teruel,Villastar (44263),2,4,-2
2004,Teruel,Villel (44264),1,8,-7
2004,Teruel,Vinaceite (44265),0,2,-2
2004,Teruel,Visiedo (44266),0,5,-5
2004,Teruel,Vivel del Río Martín (44267),1,,1
2003,Teruel,Ababuj (44001),0,1,-1
2003,Teruel,Abejuela (44002),1,,1
2003,Teruel,Aguatón (44003),0,2,-2
2003,Teruel,Aguaviva (44004),4,8,-4
2003,Teruel,Aguilar del Alfambra (44005),1,,1
2003,Teruel,Alacón (44006),1,8,-7
2003,Teruel,Alba (44007),0,2,-2
2003,Teruel,Albalate del Arzobispo (44008),11,35,-24
2003,Teruel,Albarracín (44009),5,20,-15
2003,Teruel,Albentosa (44010),2,9,-7
2003,Teruel,Alcalá de la Selva (44012),7,4,3
2003,Teruel,Alcañiz (44013),155,186,-31
2003,Teruel,Alcorisa (44014),35,31,4
2003,Teruel,Alfambra (44016),2,7,-5
2003,Teruel,Aliaga (44017),2,3,-1
2003,Teruel,Allepuz (44021),0,2,-2
2003,Teruel,Alloza (44022),3,11,-8
2003,Teruel,Almohaja (44018),0,1,-1
2003,Teruel,Alobras (44019),0,3,-3
2003,Teruel,Andorra (44025),49,55,-6
2003,Teruel,Arcos de las Salinas (44026),0,4,-4
2003,Teruel,Arens de Lledó (44027),1,3,-2
2003,Teruel,Argente (44028),3,2,1
2003,Teruel,Ariño (44029),7,12,-5
2003,Teruel,Azaila (44031),1,2,-1
2003,Teruel,Barrachina (44035),0,5,-5
2003,Teruel,Bañón (44034),1,4,-3
2003,Teruel,Beceite (44037),3,8,-5
2003,Teruel,Bello (44039),4,1,3
2003,Teruel,Belmonte de San José (44038),1,3,-2
2003,Teruel,Berge (44040),3,4,-1
2003,Teruel,Bezas (44041),1,,1
2003,Teruel,Blancas (44042),0,4,-4
2003,Teruel,Blesa (44043),0,1,-1
2003,Teruel,Bordón (44044),2,2,0
2003,Teruel,Bronchales (44045),2,5,-3
2003,Teruel,Bueña (44046),0,4,-4
2003,Teruel,Burbáguena (44047),0,10,-10
2003,Teruel,Báguena (44033),2,12,-10
2003,Teruel,Calaceite (44049),5,23,-18
2003,Teruel,Calamocha (44050),38,50,-12
2003,Teruel,Calanda (44051),25,41,-16
2003,Teruel,Camarena de la Sierra (44054),2,6,-4
2003,Teruel,Camarillas (44055),0,1,-1
2003,Teruel,Camañas (44053),0,1,-1
2003,Teruel,Caminreal (44056),1,10,-9
2003,Teruel,Cantavieja (44059),5,10,-5
2003,Teruel,Cascante del Río (44064),0,4,-4
2003,Teruel,Castejón de Tornos (44065),0,1,-1
2003,Teruel,Castel de Cabra (44066),0,1,-1
2003,Teruel,Castellar (El) (44070),0,2,-2
2003,Teruel,Castellote (44071),2,19,-17
2003,Teruel,Castelnou (44067),0,3,-3
2003,Teruel,Castelserás (44068),0,9,-9
2003,Teruel,Cañada de Verich (La) (44061),0,2,-2
2003,Teruel,Cañada Vellida (44062),0,1,-1
2003,Teruel,Cañizar del Olivar (44063),3,4,-1
2003,Teruel,Cedrillas (44074),3,13,-10
2003,Teruel,Celadas (44075),1,4,-3
2003,Teruel,Cella (44076),14,45,-31
2003,Teruel,Codoñera (La) (44080),0,6,-6
2003,Teruel,Corbalán (44082),1,1,0
2003,Teruel,Cortes de Aragón (44084),1,2,-1
2003,Teruel,Cosa (44085),0,1,-1
2003,Teruel,Cretas (44086),1,7,-6
2003,Teruel,Cuba (La) (44088),1,1,0
2003,Teruel,Cucalón (44090),0,2,-2
2003,Teruel,Cuervo (El) (44092),0,4,-4
2003,Teruel,Cuevas de Almudén (44093),1,3,-2
2003,Teruel,Ejulve (44096),0,2,-2
2003,Teruel,Escorihuela (44097),0,3,-3
2003,Teruel,Escucha (44099),10,6,4
2003,Teruel,Estercuel (44100),2,3,-1
2003,Teruel,Ferreruela de Huerva (44101),0,3,-3
2003,Teruel,Fonfría (44102),0,1,-1
2003,Teruel,Formiche Alto (44103),2,2,0
2003,Teruel,Fortanete (44106),1,2,-1
2003,Teruel,Foz-Calanda (44107),2,3,-1
2003,Teruel,Fresneda (La) (44108),1,8,-7
2003,Teruel,Frías de Albarracín (44109),1,1,0
2003,Teruel,Fuentes Claras (44112),2,8,-6
2003,Teruel,Fuentes de Rubielos (44113),2,1,1
2003,Teruel,Fuentespalda (44114),4,4,0
2003,Teruel,Galve (44115),1,2,-1
2003,Teruel,Gargallo (44116),2,3,-1
2003,Teruel,Gea de Albarracín (44117),1,8,-7
2003,Teruel,Ginebrosa (La) (44118),0,3,-3
2003,Teruel,Griegos (44119),0,2,-2
2003,Teruel,Guadalaviar (44120),1,4,-3
2003,Teruel,Gúdar (44121),0,,0
2003,Teruel,Hinojosa de Jarque (44123),0,4,-4
2003,Teruel,Hoz de la Vieja (La) (44124),0,5,-5
2003,Teruel,Híjar (44122),23,24,-1
2003,Teruel,Iglesuela del Cid (La) (44126),5,4,1
2003,Teruel,Jabaloyas (44127),1,1,0
2003,Teruel,Jarque de la Val (44128),0,1,-1
2003,Teruel,Jorcas (44130),0,1,-1
2003,Teruel,Libros (44135),0,1,-1
2003,Teruel,Lidón (44136),0,3,-3
2003,Teruel,Linares de Mora (44137),2,11,-9
2003,Teruel,Lledó (44141),1,2,-1
2003,Teruel,Loscos (44138),0,1,-1
2003,Teruel,Maicas (44142),1,1,0
2003,Teruel,Manzanera (44143),1,7,-6
2003,Teruel,Martín del Río (44144),5,6,-1
2003,Teruel,Mas de las Matas (44145),7,37,-30
2003,Teruel,Mata de los Olmos (La) (44146),4,7,-3
2003,Teruel,Mazaleón (44147),3,16,-13
2003,Teruel,Mezquita de Jarque (44148),0,4,-4
2003,Teruel,Mirambel (44149),1,2,-1
2003,Teruel,Miravete de la Sierra (44150),0,1,-1
2003,Teruel,Molinos (44151),2,4,-2
2003,Teruel,Monforte de Moyuela (44152),0,1,-1
2003,Teruel,Monreal del Campo (44153),15,21,-6
2003,Teruel,Monroyo (44154),0,2,-2
2003,Teruel,Montalbán (44155),13,18,-5
2003,Teruel,Mora de Rubielos (44158),12,20,-8
2003,Teruel,Moscardón (44159),1,1,0
2003,Teruel,Mosqueruela (44160),9,16,-7
2003,Teruel,Muniesa (44161),4,6,-2
2003,Teruel,Noguera de Albarracín (44163),1,6,-5
2003,Teruel,Nogueras (44164),0,1,-1
2003,Teruel,Nogueruelas (44165),1,5,-4
2003,Teruel,Obón (44167),0,1,-1
2003,Teruel,Odón (44168),1,4,-3
2003,Teruel,Ojos Negros (44169),2,6,-4
2003,Teruel,Olba (44171),1,3,-2
2003,Teruel,Oliete (44172),3,7,-4
2003,Teruel,Olmos (Los) (44173),1,3,-2
2003,Teruel,Orihuela del Tremedal (44174),6,4,2
2003,Teruel,Orrios (44175),1,2,-1
2003,Teruel,Palomar de Arroyos (44176),0,6,-6
2003,Teruel,Pancrudo (44177),1,1,0
2003,Teruel,Parras de Castellote (Las) (44178),0,1,-1
2003,Teruel,Peracense (44180),0,1,-1
2003,Teruel,Peralejos (44181),0,1,-1
2003,Teruel,Perales del Alfambra (44182),1,4,-3
2003,Teruel,Peñarroya de Tastavins (44179),2,7,-5
2003,Teruel,Pitarque (44183),1,1,0
2003,Teruel,Plou (44184),0,1,-1
2003,Teruel,Pobo (El) (44185),0,2,-2
2003,Teruel,Portellada (La) (44187),0,5,-5
2003,Teruel,Pozondón (44189),0,1,-1
2003,Teruel,Puebla de Híjar (La) (44191),4,16,-12
2003,Teruel,Puebla de Valverde (La) (44192),2,4,-2
2003,Teruel,Puertomingalvo (44193),0,1,-1
2003,Teruel,Rillo (44195),0,3,-3
2003,Teruel,Riodeva (44196),1,2,-1
2003,Teruel,Royuela (44198),0,2,-2
2003,Teruel,Rubielos de la Cérida (44200),0,2,-2
2003,Teruel,Rubielos de Mora (44201),4,5,-1
2003,Teruel,Ráfales (44194),0,3,-3
2003,Teruel,Ródenas (44197),0,1,-1
2003,Teruel,Samper de Calanda (44205),4,14,-10
2003,Teruel,San Agustín (44206),0,3,-3
2003,Teruel,San Martín del Río (44207),1,2,-1
2003,Teruel,Santa Cruz de Nogueras (44208),1,,1
2003,Teruel,Santa Eulalia (44209),5,16,-11
2003,Teruel,Sarrión (44210),10,14,-4
2003,Teruel,Segura de los Baños (44211),0,2,-2
2003,Teruel,Singra (44213),1,1,0
2003,Teruel,Terriente (44215),0,2,-2
2003,Teruel,Teruel (44216),310,350,-40
2003,Teruel,Toril y Masegoso (44217),0,1,-1
2003,Teruel,Tornos (44219),2,4,-2
2003,Teruel,Torralba de los Sisones (44220),0,2,-2
2003,Teruel,Torre de las Arcas (44224),0,1,-1
2003,Teruel,Torre del Compte (44225),0,5,-5
2003,Teruel,Torre los Negros (44227),1,1,0
2003,Teruel,Torrecilla de Alcañiz (44221),3,8,-5
2003,Teruel,Torrecilla del Rebollar (44222),1,1,0
2003,Teruel,Torrelacárcel (44226),0,4,-4
2003,Teruel,Torremocha de Jiloca (44228),0,2,-2
2003,Teruel,Torres de Albarracín (44229),1,2,-1
2003,Teruel,Torrevelilla (44230),1,5,-4
2003,Teruel,Torrijo del Campo (44232),1,2,-1
2003,Teruel,Tramacastiel (44234),0,3,-3
2003,Teruel,Tramacastilla (44235),0,1,-1
2003,Teruel,Tronchón (44236),0,5,-5
2003,Teruel,Urrea de Gaén (44237),1,8,-7
2003,Teruel,Utrillas (44238),19,33,-14
2003,Teruel,Valacloche (44239),1,,1
2003,Teruel,Valbona (44240),0,3,-3
2003,Teruel,Valdealgorfa (44241),3,12,-9
2003,Teruel,Valdelinares (44244),2,1,1
2003,Teruel,Valdeltormo (44245),1,6,-5
2003,Teruel,Valderrobres (44246),22,33,-11
2003,Teruel,Valjunquera (44247),2,10,-8
2003,Teruel,Villafranca del Campo (44251),1,2,-1
2003,Teruel,Villahermosa del Campo (44252),1,2,-1
2003,Teruel,Villanueva del Rebollar de la Sierra (44256),1,,1
2003,Teruel,Villar del Cobo (44257),0,2,-2
2003,Teruel,Villar del Salz (44258),0,3,-3
2003,Teruel,Villarluengo (44260),0,3,-3
2003,Teruel,Villarquemado (44261),2,14,-12
2003,Teruel,Villarroya de los Pinares (44262),2,4,-2
2003,Teruel,Villastar (44263),3,7,-4
2003,Teruel,Villel (44264),2,8,-6
2003,Teruel,Vinaceite (44265),2,2,0
2003,Teruel,Visiedo (44266),1,1,0
2003,Teruel,Vivel del Río Martín (44267),0,2,-2
2003,Teruel,Zoma (La) (44268),0,1,-1
2002,Teruel,Ababuj (44001),1,,1
2002,Teruel,Abejuela (44002),0,1,-1
2002,Teruel,Aguatón (44003),0,1,-1
2002,Teruel,Aguaviva (44004),6,10,-4
2002,Teruel,Aguilar del Alfambra (44005),0,2,-2
2002,Teruel,Alacón (44006),1,9,-8
2002,Teruel,Alba (44007),0,6,-6
2002,Teruel,Albalate del Arzobispo (44008),15,35,-20
2002,Teruel,Albarracín (44009),2,21,-19
2002,Teruel,Albentosa (44010),2,2,0
2002,Teruel,Alcaine (44011),0,,0
2002,Teruel,Alcalá de la Selva (44012),6,6,0
2002,Teruel,Alcañiz (44013),161,174,-13
2002,Teruel,Alcorisa (44014),23,33,-10
2002,Teruel,Alfambra (44016),0,6,-6
2002,Teruel,Aliaga (44017),0,6,-6
2002,Teruel,Allepuz (44021),1,3,-2
2002,Teruel,Alloza (44022),3,15,-12
2002,Teruel,Alobras (44019),0,1,-1
2002,Teruel,Andorra (44025),60,50,10
2002,Teruel,Arcos de las Salinas (44026),0,3,-3
2002,Teruel,Arens de Lledó (44027),1,7,-6
2002,Teruel,Argente (44028),0,1,-1
2002,Teruel,Ariño (44029),2,7,-5
2002,Teruel,Azaila (44031),0,3,-3
2002,Teruel,Barrachina (44035),0,2,-2
2002,Teruel,Bañón (44034),0,4,-4
2002,Teruel,Bea (44036),0,1,-1
2002,Teruel,Beceite (44037),3,5,-2
2002,Teruel,Bello (44039),0,5,-5
2002,Teruel,Belmonte de San José (44038),1,3,-2
2002,Teruel,Berge (44040),1,1,0
2002,Teruel,Bezas (44041),1,1,0
2002,Teruel,Blancas (44042),1,2,-1
2002,Teruel,Bordón (44044),1,4,-3
2002,Teruel,Bronchales (44045),2,5,-3
2002,Teruel,Bueña (44046),0,2,-2
2002,Teruel,Burbáguena (44047),0,13,-13
2002,Teruel,Báguena (44033),1,6,-5
2002,Teruel,Cabra de Mora (44048),0,2,-2
2002,Teruel,Calaceite (44049),10,14,-4
2002,Teruel,Calamocha (44050),30,36,-6
2002,Teruel,Calanda (44051),28,44,-16
2002,Teruel,Calomarde (44052),0,4,-4
2002,Teruel,Camarena de la Sierra (44054),0,1,-1
2002,Teruel,Camarillas (44055),0,1,-1
2002,Teruel,Camañas (44053),2,3,-1
2002,Teruel,Caminreal (44056),3,10,-7
2002,Teruel,Cantavieja (44059),7,9,-2
2002,Teruel,Cascante del Río (44064),0,3,-3
2002,Teruel,Castejón de Tornos (44065),0,1,-1
2002,Teruel,Castel de Cabra (44066),1,3,-2
2002,Teruel,Castellar (El) (44070),1,2,-1
2002,Teruel,Castellote (44071),3,7,-4
2002,Teruel,Castelnou (44067),0,1,-1
2002,Teruel,Castelserás (44068),7,7,0
2002,Teruel,Cañada de Benatanduz (44060),0,2,-2
2002,Teruel,Cañizar del Olivar (44063),0,4,-4
2002,Teruel,Cedrillas (44074),4,12,-8
2002,Teruel,Celadas (44075),1,5,-4
2002,Teruel,Cella (44076),13,31,-18
2002,Teruel,Cerollera (La) (44077),0,2,-2
2002,Teruel,Codoñera (La) (44080),1,3,-2
2002,Teruel,Corbalán (44082),0,2,-2
2002,Teruel,Cortes de Aragón (44084),0,8,-8
2002,Teruel,Cretas (44086),1,7,-6
2002,Teruel,Crivillén (44087),0,2,-2
2002,Teruel,Cuba (La) (44088),0,1,-1
2002,Teruel,Cubla (44089),0,4,-4
2002,Teruel,Cucalón (44090),0,2,-2
2002,Teruel,Cuervo (El) (44092),1,2,-1
2002,Teruel,Cuevas de Almudén (44093),0,,0
2002,Teruel,Cuevas Labradas (44094),0,,0
2002,Teruel,Ejulve (44096),1,3,-2
2002,Teruel,Escorihuela (44097),0,6,-6
2002,Teruel,Escucha (44099),9,8,1
2002,Teruel,Estercuel (44100),2,4,-2
2002,Teruel,Ferreruela de Huerva (44101),0,1,-1
2002,Teruel,Fonfría (44102),0,1,-1
2002,Teruel,Formiche Alto (44103),2,3,-1
2002,Teruel,Fortanete (44106),1,2,-1
2002,Teruel,Foz-Calanda (44107),3,5,-2
2002,Teruel,Fresneda (La) (44108),0,6,-6
2002,Teruel,Frías de Albarracín (44109),0,2,-2
2002,Teruel,Fuentes Calientes (44111),0,,0
2002,Teruel,Fuentes Claras (44112),1,4,-3
2002,Teruel,Fuentes de Rubielos (44113),2,1,1
2002,Teruel,Fuentespalda (44114),0,6,-6
2002,Teruel,Fórnoles (44105),1,1,0
2002,Teruel,Galve (44115),1,2,-1
2002,Teruel,Gargallo (44116),1,3,-2
2002,Teruel,Gea de Albarracín (44117),1,11,-10
2002,Teruel,Ginebrosa (La) (44118),0,4,-4
2002,Teruel,Griegos (44119),0,5,-5
2002,Teruel,Guadalaviar (44120),0,3,-3
2002,Teruel,Gúdar (44121),0,1,-1
2002,Teruel,Hinojosa de Jarque (44123),0,4,-4
2002,Teruel,Huesa del Común (44125),0,1,-1
2002,Teruel,Híjar (44122),11,31,-20
2002,Teruel,Iglesuela del Cid (La) (44126),3,7,-4
2002,Teruel,Jabaloyas (44127),1,1,0
2002,Teruel,Jarque de la Val (44128),0,1,-1
2002,Teruel,Jorcas (44130),0,1,-1
2002,Teruel,Lagueruela (44132),0,1,-1
2002,Teruel,Libros (44135),1,2,-1
2002,Teruel,Lidón (44136),0,1,-1
2002,Teruel,Linares de Mora (44137),2,7,-5
2002,Teruel,Lledó (44141),0,4,-4
2002,Teruel,Loscos (44138),1,3,-2
2002,Teruel,Manzanera (44143),4,9,-5
2002,Teruel,Martín del Río (44144),3,8,-5
2002,Teruel,Mas de las Matas (44145),9,18,-9
2002,Teruel,Mata de los Olmos (La) (44146),1,4,-3
2002,Teruel,Mazaleón (44147),2,7,-5
2002,Teruel,Mezquita de Jarque (44148),0,4,-4
2002,Teruel,Mirambel (44149),0,1,-1
2002,Teruel,Molinos (44151),2,7,-5
2002,Teruel,Monforte de Moyuela (44152),0,2,-2
2002,Teruel,Monreal del Campo (44153),16,23,-7
2002,Teruel,Monroyo (44154),0,2,-2
2002,Teruel,Montalbán (44155),8,12,-4
2002,Teruel,Monteagudo del Castillo (44156),1,1,0
2002,Teruel,Mora de Rubielos (44158),5,13,-8
2002,Teruel,Moscardón (44159),0,,0
2002,Teruel,Mosqueruela (44160),2,11,-9
2002,Teruel,Muniesa (44161),6,13,-7
2002,Teruel,Noguera de Albarracín (44163),0,3,-3
2002,Teruel,Nogueruelas (44165),0,3,-3
2002,Teruel,Odón (44168),2,2,0
2002,Teruel,Ojos Negros (44169),2,7,-5
2002,Teruel,Olba (44171),0,3,-3
2002,Teruel,Oliete (44172),0,5,-5
2002,Teruel,Olmos (Los) (44173),1,4,-3
2002,Teruel,Orihuela del Tremedal (44174),5,6,-1
2002,Teruel,Orrios (44175),0,1,-1
2002,Teruel,Palomar de Arroyos (44176),0,1,-1
2002,Teruel,Pancrudo (44177),1,2,-1
2002,Teruel,Parras de Castellote (Las) (44178),0,2,-2
2002,Teruel,Peracense (44180),0,1,-1
2002,Teruel,Peralejos (44181),0,1,-1
2002,Teruel,Perales del Alfambra (44182),0,2,-2
2002,Teruel,Peñarroya de Tastavins (44179),4,9,-5
2002,Teruel,Pitarque (44183),0,1,-1
2002,Teruel,Plou (44184),0,1,-1
2002,Teruel,Portellada (La) (44187),0,8,-8
2002,Teruel,Pozondón (44189),0,1,-1
2002,Teruel,Pozuel del Campo (44190),1,4,-3
2002,Teruel,Puebla de Híjar (La) (44191),4,13,-9
2002,Teruel,Puebla de Valverde (La) (44192),5,3,2
2002,Teruel,Puertomingalvo (44193),1,2,-1
2002,Teruel,Rillo (44195),0,2,-2
2002,Teruel,Riodeva (44196),0,7,-7
2002,Teruel,Royuela (44198),3,6,-3
2002,Teruel,Rubielos de la Cérida (44200),0,1,-1
2002,Teruel,Rubielos de Mora (44201),2,7,-5
2002,Teruel,Ráfales (44194),0,6,-6
2002,Teruel,Ródenas (44197),0,1,-1
2002,Teruel,Salcedillo (44203),0,1,-1
2002,Teruel,Saldón (44204),0,1,-1
2002,Teruel,Samper de Calanda (44205),8,15,-7
2002,Teruel,San Agustín (44206),0,5,-5
2002,Teruel,San Martín del Río (44207),0,2,-2
2002,Teruel,Santa Cruz de Nogueras (44208),0,,0
2002,Teruel,Santa Eulalia (44209),5,20,-15
2002,Teruel,Sarrión (44210),2,20,-18
2002,Teruel,Singra (44213),0,2,-2
2002,Teruel,Terriente (44215),1,6,-5
2002,Teruel,Teruel (44216),287,340,-53
2002,Teruel,Tornos (44219),0,3,-3
2002,Teruel,Torralba de los Sisones (44220),0,2,-2
2002,Teruel,Torre de las Arcas (44224),0,2,-2
2002,Teruel,Torre del Compte (44225),0,7,-7
2002,Teruel,Torre los Negros (44227),0,3,-3
2002,Teruel,Torrecilla de Alcañiz (44221),3,7,-4
2002,Teruel,Torrecilla del Rebollar (44222),0,7,-7
2002,Teruel,Torrelacárcel (44226),0,5,-5
2002,Teruel,Torremocha de Jiloca (44228),0,4,-4
2002,Teruel,Torres de Albarracín (44229),1,3,-2
2002,Teruel,Torrevelilla (44230),0,1,-1
2002,Teruel,Torrijas (44231),0,1,-1
2002,Teruel,Torrijo del Campo (44232),0,5,-5
2002,Teruel,Tramacastiel (44234),1,,1
2002,Teruel,Tramacastilla (44235),0,3,-3
2002,Teruel,Tronchón (44236),0,1,-1
2002,Teruel,Urrea de Gaén (44237),4,8,-4
2002,Teruel,Utrillas (44238),25,29,-4
2002,Teruel,Valbona (44240),0,2,-2
2002,Teruel,Valdealgorfa (44241),4,14,-10
2002,Teruel,Valdecuenca (44243),0,3,-3
2002,Teruel,Valdelinares (44244),0,2,-2
2002,Teruel,Valdeltormo (44245),0,3,-3
2002,Teruel,Valderrobres (44246),14,21,-7
2002,Teruel,Valjunquera (44247),0,4,-4
2002,Teruel,Villafranca del Campo (44251),1,5,-4
2002,Teruel,Villahermosa del Campo (44252),2,2,0
2002,Teruel,Villar del Cobo (44257),1,1,0
2002,Teruel,Villar del Salz (44258),1,1,0
2002,Teruel,Villarluengo (44260),2,3,-1
2002,Teruel,Villarquemado (44261),3,11,-8
2002,Teruel,Villarroya de los Pinares (44262),1,2,-1
2002,Teruel,Villastar (44263),1,4,-3
2002,Teruel,Villel (44264),0,5,-5
2002,Teruel,Vinaceite (44265),0,5,-5
2002,Teruel,Visiedo (44266),0,3,-3
2002,Teruel,Vivel del Río Martín (44267),0,2,-2
2001,Teruel,Ababuj (44001),1,1,0
2001,Teruel,Abejuela (44002),0,1,-1
2001,Teruel,Aguatón (44003),0,1,-1
2001,Teruel,Aguaviva (44004),3,10,-7
2001,Teruel,Aguilar del Alfambra (44005),0,,0
2001,Teruel,Alacón (44006),4,4,0
2001,Teruel,Alba (44007),1,1,0
2001,Teruel,Albalate del Arzobispo (44008),15,30,-15
2001,Teruel,Albarracín (44009),11,15,-4
2001,Teruel,Albentosa (44010),2,1,1
2001,Teruel,Alcalá de la Selva (44012),5,12,-7
2001,Teruel,Alcañiz (44013),149,168,-19
2001,Teruel,Alcorisa (44014),38,30,8
2001,Teruel,Alfambra (44016),0,9,-9
2001,Teruel,Aliaga (44017),3,7,-4
2001,Teruel,Allepuz (44021),1,2,-1
2001,Teruel,Alloza (44022),2,17,-15
2001,Teruel,Almohaja (44018),0,1,-1
2001,Teruel,Alobras (44019),0,3,-3
2001,Teruel,Alpeñés (44020),1,,1
2001,Teruel,Andorra (44025),68,59,9
2001,Teruel,Arcos de las Salinas (44026),0,1,-1
2001,Teruel,Arens de Lledó (44027),1,8,-7
2001,Teruel,Argente (44028),0,2,-2
2001,Teruel,Ariño (44029),3,10,-7
2001,Teruel,Azaila (44031),0,2,-2
2001,Teruel,Barrachina (44035),0,1,-1
2001,Teruel,Bañón (44034),1,3,-2
2001,Teruel,Beceite (44037),5,10,-5
2001,Teruel,Bello (44039),4,4,0
2001,Teruel,Belmonte de San José (44038),2,3,-1
2001,Teruel,Berge (44040),3,1,2
2001,Teruel,Blancas (44042),1,2,-1
2001,Teruel,Blesa (44043),0,1,-1
2001,Teruel,Bordón (44044),1,1,0
2001,Teruel,Bronchales (44045),3,7,-4
2001,Teruel,Bueña (44046),0,1,-1
2001,Teruel,Burbáguena (44047),1,5,-4
2001,Teruel,Bádenas (44032),0,2,-2
2001,Teruel,Báguena (44033),5,8,-3
2001,Teruel,Cabra de Mora (44048),0,1,-1
2001,Teruel,Calaceite (44049),5,11,-6
2001,Teruel,Calamocha (44050),27,37,-10
2001,Teruel,Calanda (44051),35,45,-10
2001,Teruel,Calomarde (44052),0,1,-1
2001,Teruel,Camarena de la Sierra (44054),1,2,-1
2001,Teruel,Camarillas (44055),0,3,-3
2001,Teruel,Camañas (44053),1,2,-1
2001,Teruel,Caminreal (44056),1,13,-12
2001,Teruel,Cantavieja (44059),6,13,-7
2001,Teruel,Cascante del Río (44064),0,,0
2001,Teruel,Castejón de Tornos (44065),1,3,-2
2001,Teruel,Castel de Cabra (44066),0,1,-1
2001,Teruel,Castellar (El) (44070),0,1,-1
2001,Teruel,Castellote (44071),2,12,-10
2001,Teruel,Castelnou (44067),1,,1
2001,Teruel,Castelserás (44068),5,13,-8
2001,Teruel,Cañada de Benatanduz (44060),0,1,-1
2001,Teruel,Cañada de Verich (La) (44061),3,1,2
2001,Teruel,Cañada Vellida (44062),0,1,-1
2001,Teruel,Cañizar del Olivar (44063),0,1,-1
2001,Teruel,Cedrillas (44074),1,11,-10
2001,Teruel,Celadas (44075),3,4,-1
2001,Teruel,Cella (44076),7,40,-33
2001,Teruel,Codoñera (La) (44080),0,4,-4
2001,Teruel,Corbalán (44082),0,1,-1
2001,Teruel,Cosa (44085),1,1,0
2001,Teruel,Cretas (44086),4,7,-3
2001,Teruel,Crivillén (44087),0,3,-3
2001,Teruel,Cuba (La) (44088),0,4,-4
2001,Teruel,Cubla (44089),0,3,-3
2001,Teruel,Cucalón (44090),0,1,-1
2001,Teruel,Cuervo (El) (44092),0,1,-1
2001,Teruel,Cuevas de Almudén (44093),1,3,-2
2001,Teruel,Cuevas Labradas (44094),0,5,-5
2001,Teruel,Ejulve (44096),1,2,-1
2001,Teruel,Escorihuela (44097),0,3,-3
2001,Teruel,Escucha (44099),13,11,2
2001,Teruel,Estercuel (44100),1,9,-8
2001,Teruel,Ferreruela de Huerva (44101),0,1,-1
2001,Teruel,Formiche Alto (44103),2,2,0
2001,Teruel,Fortanete (44106),2,2,0
2001,Teruel,Foz-Calanda (44107),1,1,0
2001,Teruel,Fresneda (La) (44108),0,3,-3
2001,Teruel,Frías de Albarracín (44109),1,3,-2
2001,Teruel,Fuenferrada (44110),0,1,-1
2001,Teruel,Fuentes Calientes (44111),0,2,-2
2001,Teruel,Fuentes Claras (44112),2,9,-7
2001,Teruel,Fuentes de Rubielos (44113),2,,2
2001,Teruel,Fuentespalda (44114),1,4,-3
2001,Teruel,Fórnoles (44105),0,4,-4
2001,Teruel,Galve (44115),4,2,2
2001,Teruel,Gargallo (44116),2,1,1
2001,Teruel,Gea de Albarracín (44117),1,7,-6
2001,Teruel,Ginebrosa (La) (44118),3,5,-2
2001,Teruel,Griegos (44119),0,,0
2001,Teruel,Guadalaviar (44120),1,3,-2
2001,Teruel,Gúdar (44121),0,1,-1
2001,Teruel,Hinojosa de Jarque (44123),2,1,1
2001,Teruel,Hoz de la Vieja (La) (44124),0,2,-2
2001,Teruel,Híjar (44122),17,31,-14
2001,Teruel,Iglesuela del Cid (La) (44126),5,5,0
2001,Teruel,Jarque de la Val (44128),0,2,-2
2001,Teruel,Jatiel (44129),0,1,-1
2001,Teruel,Jorcas (44130),0,1,-1
2001,Teruel,Josa (44131),0,1,-1
2001,Teruel,Lagueruela (44132),0,2,-2
2001,Teruel,Libros (44135),1,4,-3
2001,Teruel,Lidón (44136),0,2,-2
2001,Teruel,Linares de Mora (44137),2,1,1
2001,Teruel,Lledó (44141),1,1,0
2001,Teruel,Loscos (44138),0,2,-2
2001,Teruel,Manzanera (44143),3,6,-3
2001,Teruel,Martín del Río (44144),3,5,-2
2001,Teruel,Mas de las Matas (44145),5,25,-20
2001,Teruel,Mazaleón (44147),5,7,-2
2001,Teruel,Mezquita de Jarque (44148),1,1,0
2001,Teruel,Mirambel (44149),0,1,-1
2001,Teruel,Miravete de la Sierra (44150),0,1,-1
2001,Teruel,Molinos (44151),0,5,-5
2001,Teruel,Monreal del Campo (44153),23,21,2
2001,Teruel,Monroyo (44154),0,4,-4
2001,Teruel,Montalbán (44155),10,14,-4
2001,Teruel,Monterde de Albarracín (44157),0,1,-1
2001,Teruel,Mora de Rubielos (44158),13,23,-10
2001,Teruel,Mosqueruela (44160),5,9,-4
2001,Teruel,Muniesa (44161),4,13,-9
2001,Teruel,Noguera de Albarracín (44163),0,1,-1
2001,Teruel,Nogueruelas (44165),0,4,-4
2001,Teruel,Obón (44167),0,1,-1
2001,Teruel,Odón (44168),1,4,-3
2001,Teruel,Ojos Negros (44169),0,5,-5
2001,Teruel,Olba (44171),0,2,-2
2001,Teruel,Oliete (44172),1,7,-6
2001,Teruel,Olmos (Los) (44173),3,2,1
2001,Teruel,Orihuela del Tremedal (44174),7,9,-2
2001,Teruel,Palomar de Arroyos (44176),1,,1
2001,Teruel,Pancrudo (44177),0,5,-5
2001,Teruel,Parras de Castellote (Las) (44178),0,3,-3
2001,Teruel,Peracense (44180),0,1,-1
2001,Teruel,Peralejos (44181),0,2,-2
2001,Teruel,Perales del Alfambra (44182),1,2,-1
2001,Teruel,Peñarroya de Tastavins (44179),5,4,1
2001,Teruel,Pitarque (44183),2,,2
2001,Teruel,Plou (44184),0,1,-1
2001,Teruel,Pobo (El) (44185),0,1,-1
2001,Teruel,Portellada (La) (44187),0,8,-8
2001,Teruel,Pozondón (44189),0,1,-1
2001,Teruel,Pozuel del Campo (44190),0,3,-3
2001,Teruel,Puebla de Híjar (La) (44191),0,11,-11
2001,Teruel,Puebla de Valverde (La) (44192),4,1,3
2001,Teruel,Puertomingalvo (44193),0,,0
2001,Teruel,Rillo (44195),1,1,0
2001,Teruel,Riodeva (44196),1,4,-3
2001,Teruel,Royuela (44198),3,5,-2
2001,Teruel,Rubielos de la Cérida (44200),0,3,-3
2001,Teruel,Rubielos de Mora (44201),4,9,-5
2001,Teruel,Ráfales (44194),0,3,-3
2001,Teruel,Ródenas (44197),0,2,-2
2001,Teruel,Saldón (44204),0,4,-4
2001,Teruel,Samper de Calanda (44205),6,17,-11
2001,Teruel,San Agustín (44206),1,1,0
2001,Teruel,San Martín del Río (44207),0,3,-3
2001,Teruel,Santa Cruz de Nogueras (44208),0,1,-1
2001,Teruel,Santa Eulalia (44209),3,10,-7
2001,Teruel,Sarrión (44210),3,17,-14
2001,Teruel,Segura de los Baños (44211),0,2,-2
2001,Teruel,Seno (44212),0,1,-1
2001,Teruel,Singra (44213),1,3,-2
2001,Teruel,Terriente (44215),0,1,-1
2001,Teruel,Teruel (44216),301,348,-47
2001,Teruel,Toril y Masegoso (44217),0,,0
2001,Teruel,Tornos (44219),0,1,-1
2001,Teruel,Torralba de los Sisones (44220),0,2,-2
2001,Teruel,Torre de las Arcas (44224),0,1,-1
2001,Teruel,Torre del Compte (44225),0,1,-1
2001,Teruel,Torre los Negros (44227),0,1,-1
2001,Teruel,Torrecilla de Alcañiz (44221),1,1,0
2001,Teruel,Torrecilla del Rebollar (44222),1,1,0
2001,Teruel,Torrelacárcel (44226),1,4,-3
2001,Teruel,Torres de Albarracín (44229),0,1,-1
2001,Teruel,Torrevelilla (44230),0,4,-4
2001,Teruel,Torrijas (44231),0,1,-1
2001,Teruel,Torrijo del Campo (44232),3,3,0
2001,Teruel,Tramacastiel (44234),0,2,-2
2001,Teruel,Tramacastilla (44235),0,1,-1
2001,Teruel,Tronchón (44236),1,1,0
2001,Teruel,Urrea de Gaén (44237),3,9,-6
2001,Teruel,Utrillas (44238),20,27,-7
2001,Teruel,Valbona (44240),2,3,-1
2001,Teruel,Valdealgorfa (44241),3,11,-8
2001,Teruel,Valdecuenca (44243),0,1,-1
2001,Teruel,Valdelinares (44244),2,1,1
2001,Teruel,Valdeltormo (44245),1,7,-6
2001,Teruel,Valderrobres (44246),15,21,-6
2001,Teruel,Valjunquera (44247),4,9,-5
2001,Teruel,Vallecillo (El) (44249),0,1,-1
2001,Teruel,Villafranca del Campo (44251),3,2,1
2001,Teruel,Villahermosa del Campo (44252),0,1,-1
2001,Teruel,Villanueva del Rebollar de la Sierra (44256),2,1,1
2001,Teruel,Villar del Cobo (44257),1,2,-1
2001,Teruel,Villar del Salz (44258),1,2,-1
2001,Teruel,Villarluengo (44260),0,1,-1
2001,Teruel,Villarquemado (44261),6,13,-7
2001,Teruel,Villarroya de los Pinares (44262),3,,3
2001,Teruel,Villastar (44263),2,6,-4
2001,Teruel,Villel (44264),1,2,-1
2001,Teruel,Vinaceite (44265),1,4,-3
2001,Teruel,Visiedo (44266),1,4,-3
2001,Teruel,Vivel del Río Martín (44267),0,4,-4
2000,Teruel,Abejuela (44002),0,2,-2
2000,Teruel,Aguaviva (44004),5,7,-2
2000,Teruel,Aguilar del Alfambra (44005),1,,1
2000,Teruel,Alacón (44006),1,4,-3
2000,Teruel,Alba (44007),0,4,-4
2000,Teruel,Albalate del Arzobispo (44008),11,38,-27
2000,Teruel,Albarracín (44009),14,18,-4
2000,Teruel,Albentosa (44010),4,1,3
2000,Teruel,Alcaine (44011),0,2,-2
2000,Teruel,Alcalá de la Selva (44012),1,4,-3
2000,Teruel,Alcañiz (44013),137,140,-3
2000,Teruel,Alcorisa (44014),27,37,-10
2000,Teruel,Alfambra (44016),2,11,-9
2000,Teruel,Aliaga (44017),2,9,-7
2000,Teruel,Allepuz (44021),0,2,-2
2000,Teruel,Alloza (44022),4,15,-11
2000,Teruel,Andorra (44025),68,67,1
2000,Teruel,Arcos de las Salinas (44026),0,2,-2
2000,Teruel,Arens de Lledó (44027),0,,0
2000,Teruel,Argente (44028),2,,2
2000,Teruel,Ariño (44029),7,18,-11
2000,Teruel,Azaila (44031),0,3,-3
2000,Teruel,Barrachina (44035),1,4,-3
2000,Teruel,Bañón (44034),1,2,-1
2000,Teruel,Bea (44036),0,1,-1
2000,Teruel,Beceite (44037),2,6,-4
2000,Teruel,Bello (44039),0,10,-10
2000,Teruel,Belmonte de San José (44038),1,2,-1
2000,Teruel,Berge (44040),1,1,0
2000,Teruel,Bezas (44041),0,4,-4
2000,Teruel,Blancas (44042),0,4,-4
2000,Teruel,Blesa (44043),0,3,-3
2000,Teruel,Bordón (44044),3,1,2
2000,Teruel,Bronchales (44045),0,7,-7
2000,Teruel,Bueña (44046),0,1,-1
2000,Teruel,Burbáguena (44047),1,11,-10
2000,Teruel,Báguena (44033),2,11,-9
2000,Teruel,Calaceite (44049),3,16,-13
2000,Teruel,Calamocha (44050),30,32,-2
2000,Teruel,Calanda (44051),24,43,-19
2000,Teruel,Camarena de la Sierra (44054),3,1,2
2000,Teruel,Camarillas (44055),1,2,-1
2000,Teruel,Camañas (44053),1,2,-1
2000,Teruel,Caminreal (44056),3,9,-6
2000,Teruel,Cantavieja (44059),7,9,-2
2000,Teruel,Cascante del Río (44064),0,5,-5
2000,Teruel,Castejón de Tornos (44065),0,1,-1
2000,Teruel,Castel de Cabra (44066),0,3,-3
2000,Teruel,Castellar (El) (44070),1,2,-1
2000,Teruel,Castellote (44071),1,8,-7
2000,Teruel,Castelnou (44067),0,,0
2000,Teruel,Castelserás (44068),9,12,-3
2000,Teruel,Cañada de Benatanduz (44060),0,1,-1
2000,Teruel,Cañada de Verich (La) (44061),2,1,1
2000,Teruel,Cañada Vellida (44062),0,2,-2
2000,Teruel,Cañizar del Olivar (44063),0,5,-5
2000,Teruel,Cedrillas (44074),6,9,-3
2000,Teruel,Celadas (44075),1,11,-10
2000,Teruel,Cella (44076),21,29,-8
2000,Teruel,Cerollera (La) (44077),0,1,-1
2000,Teruel,Codoñera (La) (44080),4,5,-1
2000,Teruel,Corbalán (44082),0,4,-4
2000,Teruel,Cosa (44085),0,3,-3
2000,Teruel,Cretas (44086),2,12,-10
2000,Teruel,Crivillén (44087),0,1,-1
2000,Teruel,Cuba (La) (44088),1,2,-1
2000,Teruel,Cubla (44089),0,2,-2
2000,Teruel,Cucalón (44090),0,1,-1
2000,Teruel,Cuervo (El) (44092),0,2,-2
2000,Teruel,Cuevas de Almudén (44093),1,,1
2000,Teruel,Cuevas Labradas (44094),0,4,-4
2000,Teruel,Ejulve (44096),2,8,-6
2000,Teruel,Escorihuela (44097),0,5,-5
2000,Teruel,Escucha (44099),9,5,4
2000,Teruel,Estercuel (44100),0,5,-5
2000,Teruel,Ferreruela de Huerva (44101),0,1,-1
2000,Teruel,Formiche Alto (44103),4,4,0
2000,Teruel,Fortanete (44106),1,1,0
2000,Teruel,Foz-Calanda (44107),3,1,2
2000,Teruel,Fresneda (La) (44108),4,9,-5
2000,Teruel,Frías de Albarracín (44109),0,1,-1
2000,Teruel,Fuentes Calientes (44111),0,1,-1
2000,Teruel,Fuentes Claras (44112),2,5,-3
2000,Teruel,Fuentes de Rubielos (44113),1,2,-1
2000,Teruel,Fuentespalda (44114),0,7,-7
2000,Teruel,Fórnoles (44105),0,3,-3
2000,Teruel,Galve (44115),0,3,-3
2000,Teruel,Gargallo (44116),0,1,-1
2000,Teruel,Gea de Albarracín (44117),2,8,-6
2000,Teruel,Ginebrosa (La) (44118),4,5,-1
2000,Teruel,Guadalaviar (44120),3,4,-1
2000,Teruel,Gúdar (44121),1,,1
2000,Teruel,Hoz de la Vieja (La) (44124),0,1,-1
2000,Teruel,Huesa del Común (44125),0,3,-3
2000,Teruel,Híjar (44122),15,32,-17
2000,Teruel,Iglesuela del Cid (La) (44126),2,5,-3
2000,Teruel,Jabaloyas (44127),0,4,-4
2000,Teruel,Jatiel (44129),0,3,-3
2000,Teruel,Jorcas (44130),0,2,-2
2000,Teruel,Lagueruela (44132),0,4,-4
2000,Teruel,Libros (44135),0,4,-4
2000,Teruel,Lidón (44136),0,1,-1
2000,Teruel,Linares de Mora (44137),0,3,-3
2000,Teruel,Lledó (44141),0,3,-3
2000,Teruel,Loscos (44138),0,5,-5
2000,Teruel,Manzanera (44143),4,5,-1
2000,Teruel,Martín del Río (44144),3,9,-6
2000,Teruel,Mas de las Matas (44145),8,29,-21
2000,Teruel,Mata de los Olmos (La) (44146),0,2,-2
2000,Teruel,Mazaleón (44147),2,5,-3
2000,Teruel,Mirambel (44149),0,1,-1
2000,Teruel,Miravete de la Sierra (44150),0,,0
2000,Teruel,Molinos (44151),3,4,-1
2000,Teruel,Monforte de Moyuela (44152),0,4,-4
2000,Teruel,Monreal del Campo (44153),28,19,9
2000,Teruel,Monroyo (44154),3,2,1
2000,Teruel,Montalbán (44155),9,18,-9
2000,Teruel,Monteagudo del Castillo (44156),1,2,-1
2000,Teruel,Monterde de Albarracín (44157),0,1,-1
2000,Teruel,Mora de Rubielos (44158),10,18,-8
2000,Teruel,Moscardón (44159),0,2,-2
2000,Teruel,Mosqueruela (44160),5,6,-1
2000,Teruel,Muniesa (44161),7,11,-4
2000,Teruel,Noguera de Albarracín (44163),0,1,-1
2000,Teruel,Nogueras (44164),0,1,-1
2000,Teruel,Nogueruelas (44165),2,5,-3
2000,Teruel,Odón (44168),5,1,4
2000,Teruel,Ojos Negros (44169),2,8,-6
2000,Teruel,Olba (44171),1,2,-1
2000,Teruel,Oliete (44172),5,19,-14
2000,Teruel,Olmos (Los) (44173),3,1,2
2000,Teruel,Orihuela del Tremedal (44174),2,2,0
2000,Teruel,Orrios (44175),0,1,-1
2000,Teruel,Palomar de Arroyos (44176),2,3,-1
2000,Teruel,Pancrudo (44177),1,2,-1
2000,Teruel,Parras de Castellote (Las) (44178),0,1,-1
2000,Teruel,Peracense (44180),0,1,-1
2000,Teruel,Peralejos (44181),0,1,-1
2000,Teruel,Perales del Alfambra (44182),3,3,0
2000,Teruel,Peñarroya de Tastavins (44179),3,6,-3
2000,Teruel,Pitarque (44183),0,1,-1
2000,Teruel,Plou (44184),0,2,-2
2000,Teruel,Pobo (El) (44185),0,5,-5
2000,Teruel,Portellada (La) (44187),0,5,-5
2000,Teruel,Pozondón (44189),0,1,-1
2000,Teruel,Pozuel del Campo (44190),0,3,-3
2000,Teruel,Puebla de Híjar (La) (44191),6,18,-12
2000,Teruel,Puebla de Valverde (La) (44192),2,7,-5
2000,Teruel,Puertomingalvo (44193),0,1,-1
2000,Teruel,Riodeva (44196),2,2,0
2000,Teruel,Royuela (44198),0,1,-1
2000,Teruel,Rubielos de la Cérida (44200),0,3,-3
2000,Teruel,Rubielos de Mora (44201),9,7,2
2000,Teruel,Ráfales (44194),0,7,-7
2000,Teruel,Ródenas (44197),0,1,-1
2000,Teruel,Saldón (44204),0,3,-3
2000,Teruel,Samper de Calanda (44205),3,11,-8
2000,Teruel,San Agustín (44206),1,4,-3
2000,Teruel,San Martín del Río (44207),0,8,-8
2000,Teruel,Santa Eulalia (44209),2,21,-19
2000,Teruel,Sarrión (44210),7,15,-8
2000,Teruel,Segura de los Baños (44211),0,1,-1
2000,Teruel,Singra (44213),1,2,-1
2000,Teruel,Terriente (44215),0,3,-3
2000,Teruel,Teruel (44216),353,321,32
2000,Teruel,Toril y Masegoso (44217),0,1,-1
2000,Teruel,Tormón (44218),0,1,-1
2000,Teruel,Tornos (44219),0,5,-5
2000,Teruel,Torralba de los Sisones (44220),2,,2
2000,Teruel,Torre de Arcas (44223),0,1,-1
2000,Teruel,Torre los Negros (44227),0,1,-1
2000,Teruel,Torrecilla de Alcañiz (44221),5,1,4
2000,Teruel,Torrecilla del Rebollar (44222),0,4,-4
2000,Teruel,Torrelacárcel (44226),0,2,-2
2000,Teruel,Torremocha de Jiloca (44228),0,1,-1
2000,Teruel,Torres de Albarracín (44229),1,3,-2
2000,Teruel,Torrevelilla (44230),1,1,0
2000,Teruel,Torrijas (44231),0,1,-1
2000,Teruel,Torrijo del Campo (44232),2,10,-8
2000,Teruel,Tramacastiel (44234),0,5,-5
2000,Teruel,Tramacastilla (44235),2,1,1
2000,Teruel,Tronchón (44236),1,1,0
2000,Teruel,Urrea de Gaén (44237),0,11,-11
2000,Teruel,Utrillas (44238),27,22,5
2000,Teruel,Valacloche (44239),0,1,-1
2000,Teruel,Valbona (44240),0,2,-2
2000,Teruel,Valdealgorfa (44241),5,13,-8
2000,Teruel,Valdelinares (44244),2,5,-3
2000,Teruel,Valdeltormo (44245),5,9,-4
2000,Teruel,Valderrobres (44246),24,24,0
2000,Teruel,Valjunquera (44247),1,8,-7
2000,Teruel,Vallecillo (El) (44249),0,1,-1
2000,Teruel,Villafranca del Campo (44251),1,11,-10
2000,Teruel,Villanueva del Rebollar de la Sierra (44256),1,1,0
2000,Teruel,Villar del Cobo (44257),2,1,1
2000,Teruel,Villar del Salz (44258),1,2,-1
2000,Teruel,Villarluengo (44260),1,1,0
2000,Teruel,Villarquemado (44261),9,13,-4
2000,Teruel,Villarroya de los Pinares (44262),1,2,-1
2000,Teruel,Villastar (44263),4,6,-2
2000,Teruel,Villel (44264),2,3,-1
2000,Teruel,Vinaceite (44265),0,8,-8
2000,Teruel,Visiedo (44266),0,4,-4
2000,Teruel,Vivel del Río Martín (44267),0,2,-2
1999,Teruel,Ababuj (44001),0,1,-1
1999,Teruel,Aguaviva (44004),3,9,-6
1999,Teruel,Alacón (44006),2,7,-5
1999,Teruel,Alba (44007),0,6,-6
1999,Teruel,Albalate del Arzobispo (44008),8,31,-23
1999,Teruel,Albarracín (44009),7,11,-4
1999,Teruel,Albentosa (44010),1,1,0
1999,Teruel,Alcaine (44011),1,,1
1999,Teruel,Alcalá de la Selva (44012),5,9,-4
1999,Teruel,Alcañiz (44013),121,185,-64
1999,Teruel,Alcorisa (44014),28,41,-13
1999,Teruel,Alfambra (44016),3,5,-2
1999,Teruel,Aliaga (44017),3,10,-7
1999,Teruel,Allepuz (44021),2,4,-2
1999,Teruel,Alloza (44022),3,13,-10
1999,Teruel,Almohaja (44018),0,1,-1
1999,Teruel,Anadón (44024),0,1,-1
1999,Teruel,Andorra (44025),64,61,3
1999,Teruel,Arcos de las Salinas (44026),0,6,-6
1999,Teruel,Arens de Lledó (44027),0,4,-4
1999,Teruel,Argente (44028),0,3,-3
1999,Teruel,Ariño (44029),4,9,-5
1999,Teruel,Azaila (44031),0,1,-1
1999,Teruel,Barrachina (44035),0,1,-1
1999,Teruel,Bañón (44034),1,1,0
1999,Teruel,Beceite (44037),6,13,-7
1999,Teruel,Bello (44039),2,5,-3
1999,Teruel,Belmonte de San José (44038),0,4,-4
1999,Teruel,Berge (44040),3,2,1
1999,Teruel,Bezas (44041),0,1,-1
1999,Teruel,Blancas (44042),1,8,-7
1999,Teruel,Blesa (44043),1,3,-2
1999,Teruel,Bordón (44044),1,4,-3
1999,Teruel,Bronchales (44045),1,3,-2
1999,Teruel,Bueña (44046),0,2,-2
1999,Teruel,Burbáguena (44047),1,16,-15
1999,Teruel,Báguena (44033),1,7,-6
1999,Teruel,Cabra de Mora (44048),1,3,-2
1999,Teruel,Calaceite (44049),5,17,-12
1999,Teruel,Calamocha (44050),35,52,-17
1999,Teruel,Calanda (44051),16,44,-28
1999,Teruel,Camarena de la Sierra (44054),0,3,-3
1999,Teruel,Camarillas (44055),1,2,-1
1999,Teruel,Camañas (44053),1,1,0
1999,Teruel,Caminreal (44056),1,11,-10
1999,Teruel,Cantavieja (44059),6,6,0
1999,Teruel,Cascante del Río (44064),0,3,-3
1999,Teruel,Castejón de Tornos (44065),1,2,-1
1999,Teruel,Castel de Cabra (44066),1,,1
1999,Teruel,Castellote (44071),6,10,-4
1999,Teruel,Castelnou (44067),0,1,-1
1999,Teruel,Castelserás (44068),7,13,-6
1999,Teruel,Cañada de Benatanduz (44060),0,,0
1999,Teruel,Cañada de Verich (La) (44061),1,2,-1
1999,Teruel,Cañada Vellida (44062),0,1,-1
1999,Teruel,Cañizar del Olivar (44063),0,1,-1
1999,Teruel,Cedrillas (44074),3,5,-2
1999,Teruel,Celadas (44075),6,7,-1
1999,Teruel,Cella (44076),13,31,-18
1999,Teruel,Cerollera (La) (44077),1,,1
1999,Teruel,Codoñera (La) (44080),3,9,-6
1999,Teruel,Corbalán (44082),1,,1
1999,Teruel,Cortes de Aragón (44084),0,2,-2
1999,Teruel,Cosa (44085),1,1,0
1999,Teruel,Cretas (44086),1,10,-9
1999,Teruel,Cuba (La) (44088),0,1,-1
1999,Teruel,Cubla (44089),0,2,-2
1999,Teruel,Cucalón (44090),0,1,-1
1999,Teruel,Cuervo (El) (44092),0,4,-4
1999,Teruel,Cuevas de Almudén (44093),2,1,1
1999,Teruel,Cuevas Labradas (44094),0,2,-2
1999,Teruel,Ejulve (44096),1,1,0
1999,Teruel,Escorihuela (44097),0,1,-1
1999,Teruel,Escucha (44099),10,11,-1
1999,Teruel,Estercuel (44100),1,,1
1999,Teruel,Formiche Alto (44103),4,2,2
1999,Teruel,Fortanete (44106),1,4,-3
1999,Teruel,Foz-Calanda (44107),3,2,1
1999,Teruel,Fresneda (La) (44108),1,10,-9
1999,Teruel,Frías de Albarracín (44109),0,3,-3
1999,Teruel,Fuentes Claras (44112),5,10,-5
1999,Teruel,Fuentes de Rubielos (44113),3,1,2
1999,Teruel,Fuentespalda (44114),1,4,-3
1999,Teruel,Fórnoles (44105),0,2,-2
1999,Teruel,Galve (44115),1,1,0
1999,Teruel,Gargallo (44116),3,4,-1
1999,Teruel,Gea de Albarracín (44117),1,4,-3
1999,Teruel,Ginebrosa (La) (44118),1,1,0
1999,Teruel,Griegos (44119),1,1,0
1999,Teruel,Guadalaviar (44120),1,2,-1
1999,Teruel,Hinojosa de Jarque (44123),0,2,-2
1999,Teruel,Hoz de la Vieja (La) (44124),0,3,-3
1999,Teruel,Huesa del Común (44125),0,2,-2
1999,Teruel,Híjar (44122),11,28,-17
1999,Teruel,Iglesuela del Cid (La) (44126),3,7,-4
1999,Teruel,Jabaloyas (44127),0,2,-2
1999,Teruel,Jarque de la Val (44128),0,1,-1
1999,Teruel,Jatiel (44129),0,1,-1
1999,Teruel,Jorcas (44130),0,1,-1
1999,Teruel,Josa (44131),0,1,-1
1999,Teruel,Libros (44135),0,2,-2
1999,Teruel,Lidón (44136),0,2,-2
1999,Teruel,Linares de Mora (44137),1,4,-3
1999,Teruel,Lledó (44141),1,3,-2
1999,Teruel,Loscos (44138),0,2,-2
1999,Teruel,Manzanera (44143),5,6,-1
1999,Teruel,Martín del Río (44144),8,3,5
1999,Teruel,Mas de las Matas (44145),10,25,-15
1999,Teruel,Mata de los Olmos (La) (44146),2,6,-4
1999,Teruel,Mazaleón (44147),6,11,-5
1999,Teruel,Mirambel (44149),0,3,-3
1999,Teruel,Molinos (44151),1,3,-2
1999,Teruel,Monforte de Moyuela (44152),0,5,-5
1999,Teruel,Monreal del Campo (44153),16,24,-8
1999,Teruel,Monroyo (44154),4,9,-5
1999,Teruel,Montalbán (44155),9,12,-3
1999,Teruel,Monteagudo del Castillo (44156),0,1,-1
1999,Teruel,Monterde de Albarracín (44157),0,2,-2
1999,Teruel,Mora de Rubielos (44158),8,18,-10
1999,Teruel,Moscardón (44159),0,,0
1999,Teruel,Mosqueruela (44160),5,9,-4
1999,Teruel,Muniesa (44161),6,16,-10
1999,Teruel,Noguera de Albarracín (44163),0,4,-4
1999,Teruel,Nogueras (44164),0,1,-1
1999,Teruel,Nogueruelas (44165),1,7,-6
1999,Teruel,Obón (44167),0,2,-2
1999,Teruel,Odón (44168),0,2,-2
1999,Teruel,Ojos Negros (44169),1,8,-7
1999,Teruel,Olba (44171),1,4,-3
1999,Teruel,Oliete (44172),1,8,-7
1999,Teruel,Olmos (Los) (44173),0,2,-2
1999,Teruel,Orihuela del Tremedal (44174),5,13,-8
1999,Teruel,Orrios (44175),1,2,-1
1999,Teruel,Palomar de Arroyos (44176),1,4,-3
1999,Teruel,Pancrudo (44177),0,4,-4
1999,Teruel,Parras de Castellote (Las) (44178),0,3,-3
1999,Teruel,Peracense (44180),0,4,-4
1999,Teruel,Peralejos (44181),0,2,-2
1999,Teruel,Perales del Alfambra (44182),1,3,-2
1999,Teruel,Peñarroya de Tastavins (44179),5,12,-7
1999,Teruel,Pitarque (44183),0,3,-3
1999,Teruel,Plou (44184),0,1,-1
1999,Teruel,Pobo (El) (44185),0,1,-1
1999,Teruel,Portellada (La) (44187),0,4,-4
1999,Teruel,Puebla de Híjar (La) (44191),4,20,-16
1999,Teruel,Puebla de Valverde (La) (44192),4,13,-9
1999,Teruel,Puertomingalvo (44193),1,5,-4
1999,Teruel,Rillo (44195),1,1,0
1999,Teruel,Riodeva (44196),1,3,-2
1999,Teruel,Royuela (44198),2,4,-2
1999,Teruel,Rubielos de Mora (44201),6,12,-6
1999,Teruel,Ráfales (44194),1,3,-2
1999,Teruel,Samper de Calanda (44205),5,19,-14
1999,Teruel,San Agustín (44206),0,2,-2
1999,Teruel,San Martín del Río (44207),0,3,-3
1999,Teruel,Santa Eulalia (44209),4,22,-18
1999,Teruel,Sarrión (44210),7,12,-5
1999,Teruel,Segura de los Baños (44211),0,4,-4
1999,Teruel,Seno (44212),0,2,-2
1999,Teruel,Singra (44213),0,,0
1999,Teruel,Terriente (44215),0,2,-2
1999,Teruel,Teruel (44216),295,348,-53
1999,Teruel,Tormón (44218),0,1,-1
1999,Teruel,Tornos (44219),0,1,-1
1999,Teruel,Torralba de los Sisones (44220),3,4,-1
1999,Teruel,Torre de Arcas (44223),0,1,-1
1999,Teruel,Torre del Compte (44225),0,1,-1
1999,Teruel,Torrecilla de Alcañiz (44221),2,9,-7
1999,Teruel,Torrecilla del Rebollar (44222),0,2,-2
1999,Teruel,Torrelacárcel (44226),1,6,-5
1999,Teruel,Torremocha de Jiloca (44228),0,2,-2
1999,Teruel,Torres de Albarracín (44229),1,2,-1
1999,Teruel,Torrevelilla (44230),3,1,2
1999,Teruel,Torrijas (44231),1,2,-1
1999,Teruel,Torrijo del Campo (44232),0,14,-14
1999,Teruel,Tramacastiel (44234),1,,1
1999,Teruel,Tramacastilla (44235),0,1,-1
1999,Teruel,Urrea de Gaén (44237),2,8,-6
1999,Teruel,Utrillas (44238),18,22,-4
1999,Teruel,Valbona (44240),1,4,-3
1999,Teruel,Valdealgorfa (44241),2,12,-10
1999,Teruel,Valdelinares (44244),0,2,-2
1999,Teruel,Valdeltormo (44245),0,7,-7
1999,Teruel,Valderrobres (44246),12,25,-13
1999,Teruel,Valjunquera (44247),7,6,1
1999,Teruel,Vallecillo (El) (44249),0,1,-1
1999,Teruel,Villafranca del Campo (44251),2,11,-9
1999,Teruel,Villar del Cobo (44257),1,2,-1
1999,Teruel,Villar del Salz (44258),1,3,-2
1999,Teruel,Villarluengo (44260),0,4,-4
1999,Teruel,Villarquemado (44261),3,18,-15
1999,Teruel,Villarroya de los Pinares (44262),2,2,0
1999,Teruel,Villastar (44263),1,6,-5
1999,Teruel,Villel (44264),1,6,-5
1999,Teruel,Vinaceite (44265),1,8,-7
1999,Teruel,Visiedo (44266),0,4,-4
1999,Teruel,Vivel del Río Martín (44267),0,2,-2
1999,Teruel,Zoma (La) (44268),1,1,0
1998,Teruel,Abejuela (44002),0,1,-1
1998,Teruel,Aguatón (44003),0,1,-1
1998,Teruel,Aguaviva (44004),3,13,-10
1998,Teruel,Aguilar del Alfambra (44005),2,1,1
1998,Teruel,Alacón (44006),2,3,-1
1998,Teruel,Alba (44007),0,10,-10
1998,Teruel,Albalate del Arzobispo (44008),13,37,-24
1998,Teruel,Albarracín (44009),4,15,-11
1998,Teruel,Albentosa (44010),2,5,-3
1998,Teruel,Alcaine (44011),0,1,-1
1998,Teruel,Alcalá de la Selva (44012),1,6,-5
1998,Teruel,Alcañiz (44013),128,175,-47
1998,Teruel,Alcorisa (44014),27,30,-3
1998,Teruel,Alfambra (44016),3,8,-5
1998,Teruel,Aliaga (44017),1,9,-8
1998,Teruel,Allepuz (44021),0,1,-1
1998,Teruel,Alloza (44022),2,16,-14
1998,Teruel,Almohaja (44018),1,,1
1998,Teruel,Alpeñés (44020),0,1,-1
1998,Teruel,Anadón (44024),0,2,-2
1998,Teruel,Andorra (44025),60,56,4
1998,Teruel,Arcos de las Salinas (44026),1,2,-1
1998,Teruel,Arens de Lledó (44027),3,6,-3
1998,Teruel,Argente (44028),0,4,-4
1998,Teruel,Ariño (44029),11,7,4
1998,Teruel,Azaila (44031),0,2,-2
1998,Teruel,Barrachina (44035),0,3,-3
1998,Teruel,Bañón (44034),1,2,-1
1998,Teruel,Bea (44036),0,2,-2
1998,Teruel,Beceite (44037),3,11,-8
1998,Teruel,Bello (44039),3,4,-1
1998,Teruel,Belmonte de San José (44038),1,4,-3
1998,Teruel,Berge (44040),1,3,-2
1998,Teruel,Bezas (44041),0,1,-1
1998,Teruel,Blancas (44042),0,3,-3
1998,Teruel,Blesa (44043),0,1,-1
1998,Teruel,Bordón (44044),2,1,1
1998,Teruel,Bronchales (44045),3,4,-1
1998,Teruel,Bueña (44046),0,1,-1
1998,Teruel,Burbáguena (44047),0,16,-16
1998,Teruel,Bádenas (44032),0,2,-2
1998,Teruel,Báguena (44033),2,9,-7
1998,Teruel,Calaceite (44049),5,24,-19
1998,Teruel,Calamocha (44050),25,48,-23
1998,Teruel,Calanda (44051),24,35,-11
1998,Teruel,Calomarde (44052),1,,1
1998,Teruel,Camarena de la Sierra (44054),0,3,-3
1998,Teruel,Camañas (44053),0,3,-3
1998,Teruel,Caminreal (44056),3,8,-5
1998,Teruel,Cantavieja (44059),6,10,-4
1998,Teruel,Cascante del Río (44064),0,2,-2
1998,Teruel,Castejón de Tornos (44065),0,2,-2
1998,Teruel,Castel de Cabra (44066),1,1,0
1998,Teruel,Castellote (44071),7,6,1
1998,Teruel,Castelnou (44067),0,2,-2
1998,Teruel,Castelserás (44068),7,8,-1
1998,Teruel,Cañada de Benatanduz (44060),1,2,-1
1998,Teruel,Cañada de Verich (La) (44061),0,3,-3
1998,Teruel,Cedrillas (44074),6,9,-3
1998,Teruel,Celadas (44075),4,2,2
1998,Teruel,Cella (44076),14,40,-26
1998,Teruel,Cerollera (La) (44077),1,,1
1998,Teruel,Codoñera (La) (44080),2,5,-3
1998,Teruel,Cortes de Aragón (44084),0,1,-1
1998,Teruel,Cosa (44085),1,,1
1998,Teruel,Cretas (44086),1,8,-7
1998,Teruel,Crivillén (44087),0,,0
1998,Teruel,Cuba (La) (44088),0,1,-1
1998,Teruel,Cubla (44089),0,2,-2
1998,Teruel,Cucalón (44090),0,2,-2
1998,Teruel,Cuervo (El) (44092),0,4,-4
1998,Teruel,Cuevas de Almudén (44093),2,2,0
1998,Teruel,Cuevas Labradas (44094),1,7,-6
1998,Teruel,Ejulve (44096),4,1,3
1998,Teruel,Escorihuela (44097),0,5,-5
1998,Teruel,Escucha (44099),8,8,0
1998,Teruel,Estercuel (44100),2,7,-5
1998,Teruel,Ferreruela de Huerva (44101),0,2,-2
1998,Teruel,Formiche Alto (44103),1,4,-3
1998,Teruel,Fortanete (44106),0,4,-4
1998,Teruel,Foz-Calanda (44107),4,3,1
1998,Teruel,Fresneda (La) (44108),1,10,-9
1998,Teruel,Frías de Albarracín (44109),0,3,-3
1998,Teruel,Fuenferrada (44110),0,1,-1
1998,Teruel,Fuentes Calientes (44111),0,3,-3
1998,Teruel,Fuentes Claras (44112),5,9,-4
1998,Teruel,Fuentes de Rubielos (44113),1,1,0
1998,Teruel,Fuentespalda (44114),2,8,-6
1998,Teruel,Fórnoles (44105),1,5,-4
1998,Teruel,Galve (44115),1,1,0
1998,Teruel,Gargallo (44116),0,,0
1998,Teruel,Gea de Albarracín (44117),0,7,-7
1998,Teruel,Ginebrosa (La) (44118),2,5,-3
1998,Teruel,Griegos (44119),1,2,-1
1998,Teruel,Guadalaviar (44120),4,2,2
1998,Teruel,Gúdar (44121),0,1,-1
1998,Teruel,Hinojosa de Jarque (44123),0,2,-2
1998,Teruel,Huesa del Común (44125),0,1,-1
1998,Teruel,Híjar (44122),18,31,-13
1998,Teruel,Iglesuela del Cid (La) (44126),3,7,-4
1998,Teruel,Jarque de la Val (44128),0,2,-2
1998,Teruel,Jorcas (44130),0,3,-3
1998,Teruel,Josa (44131),0,1,-1
1998,Teruel,Libros (44135),2,6,-4
1998,Teruel,Lidón (44136),0,1,-1
1998,Teruel,Linares de Mora (44137),1,2,-1
1998,Teruel,Lledó (44141),1,6,-5
1998,Teruel,Loscos (44138),0,3,-3
1998,Teruel,Maicas (44142),0,1,-1
1998,Teruel,Manzanera (44143),3,13,-10
1998,Teruel,Martín del Río (44144),3,4,-1
1998,Teruel,Mas de las Matas (44145),5,21,-16
1998,Teruel,Mata de los Olmos (La) (44146),2,5,-3
1998,Teruel,Mazaleón (44147),7,10,-3
1998,Teruel,Mezquita de Jarque (44148),0,6,-6
1998,Teruel,Miravete de la Sierra (44150),0,1,-1
1998,Teruel,Molinos (44151),2,5,-3
1998,Teruel,Monreal del Campo (44153),15,26,-11
1998,Teruel,Monroyo (44154),3,5,-2
1998,Teruel,Montalbán (44155),11,14,-3
1998,Teruel,Monteagudo del Castillo (44156),0,1,-1
1998,Teruel,Monterde de Albarracín (44157),0,1,-1
1998,Teruel,Mora de Rubielos (44158),7,25,-18
1998,Teruel,Mosqueruela (44160),5,16,-11
1998,Teruel,Muniesa (44161),3,13,-10
1998,Teruel,Noguera de Albarracín (44163),3,2,1
1998,Teruel,Nogueruelas (44165),0,4,-4
1998,Teruel,Odón (44168),0,2,-2
1998,Teruel,Ojos Negros (44169),1,7,-6
1998,Teruel,Olba (44171),1,2,-1
1998,Teruel,Oliete (44172),2,13,-11
1998,Teruel,Olmos (Los) (44173),5,5,0
1998,Teruel,Orihuela del Tremedal (44174),5,9,-4
1998,Teruel,Palomar de Arroyos (44176),2,1,1
1998,Teruel,Pancrudo (44177),1,,1
1998,Teruel,Parras de Castellote (Las) (44178),0,1,-1
1998,Teruel,Peracense (44180),0,1,-1
1998,Teruel,Perales del Alfambra (44182),4,4,0
1998,Teruel,Peñarroya de Tastavins (44179),10,10,0
1998,Teruel,Pitarque (44183),1,1,0
1998,Teruel,Plou (44184),0,2,-2
1998,Teruel,Pobo (El) (44185),0,2,-2
1998,Teruel,Portellada (La) (44187),0,6,-6
1998,Teruel,Pozondón (44189),1,1,0
1998,Teruel,Pozuel del Campo (44190),0,3,-3
1998,Teruel,Puebla de Híjar (La) (44191),3,19,-16
1998,Teruel,Puebla de Valverde (La) (44192),4,5,-1
1998,Teruel,Rillo (44195),1,2,-1
1998,Teruel,Riodeva (44196),0,4,-4
1998,Teruel,Royuela (44198),1,3,-2
1998,Teruel,Rubiales (44199),1,,1
1998,Teruel,Rubielos de la Cérida (44200),1,,1
1998,Teruel,Rubielos de Mora (44201),2,11,-9
1998,Teruel,Ráfales (44194),0,4,-4
1998,Teruel,Ródenas (44197),0,2,-2
1998,Teruel,Saldón (44204),0,1,-1
1998,Teruel,Samper de Calanda (44205),4,19,-15
1998,Teruel,San Agustín (44206),0,5,-5
1998,Teruel,San Martín del Río (44207),1,6,-5
1998,Teruel,Santa Cruz de Nogueras (44208),0,1,-1
1998,Teruel,Santa Eulalia (44209),3,14,-11
1998,Teruel,Sarrión (44210),7,17,-10
1998,Teruel,Singra (44213),2,2,0
1998,Teruel,Terriente (44215),2,2,0
1998,Teruel,Teruel (44216),314,357,-43
1998,Teruel,Toril y Masegoso (44217),0,1,-1
1998,Teruel,Tornos (44219),2,4,-2
1998,Teruel,Torralba de los Sisones (44220),4,5,-1
1998,Teruel,Torre de Arcas (44223),0,3,-3
1998,Teruel,Torre del Compte (44225),0,3,-3
1998,Teruel,Torre los Negros (44227),0,2,-2
1998,Teruel,Torrecilla de Alcañiz (44221),5,5,0
1998,Teruel,Torrecilla del Rebollar (44222),0,2,-2
1998,Teruel,Torrelacárcel (44226),0,8,-8
1998,Teruel,Torremocha de Jiloca (44228),1,3,-2
1998,Teruel,Torres de Albarracín (44229),0,2,-2
1998,Teruel,Torrevelilla (44230),0,1,-1
1998,Teruel,Torrijo del Campo (44232),5,9,-4
1998,Teruel,Tramacastiel (44234),0,3,-3
1998,Teruel,Tramacastilla (44235),0,1,-1
1998,Teruel,Tronchón (44236),0,1,-1
1998,Teruel,Urrea de Gaén (44237),0,19,-19
1998,Teruel,Utrillas (44238),27,20,7
1998,Teruel,Valacloche (44239),0,3,-3
1998,Teruel,Valbona (44240),0,6,-6
1998,Teruel,Valdealgorfa (44241),4,7,-3
1998,Teruel,Valdecuenca (44243),0,3,-3
1998,Teruel,Valdelinares (44244),2,4,-2
1998,Teruel,Valdeltormo (44245),3,5,-2
1998,Teruel,Valderrobres (44246),19,25,-6
1998,Teruel,Valjunquera (44247),1,5,-4
1998,Teruel,Vallecillo (El) (44249),0,1,-1
1998,Teruel,Veguillas de la Sierra (44250),0,1,-1
1998,Teruel,Villafranca del Campo (44251),3,9,-6
1998,Teruel,Villahermosa del Campo (44252),0,1,-1
1998,Teruel,Villar del Cobo (44257),1,4,-3
1998,Teruel,Villarluengo (44260),0,3,-3
1998,Teruel,Villarquemado (44261),6,9,-3
1998,Teruel,Villarroya de los Pinares (44262),2,3,-1
1998,Teruel,Villastar (44263),3,5,-2
1998,Teruel,Villel (44264),0,10,-10
1998,Teruel,Vinaceite (44265),0,3,-3
1998,Teruel,Visiedo (44266),0,5,-5
1998,Teruel,Vivel del Río Martín (44267),0,1,-1
1998,Teruel,Zoma (La) (44268),0,1,-1
1997,Teruel,Ababuj (44001),1,2,-1
1997,Teruel,Abejuela (44002),0,2,-2
1997,Teruel,Aguaviva (44004),10,14,-4
1997,Teruel,Aguilar del Alfambra (44005),0,2,-2
1997,Teruel,Alacón (44006),1,9,-8
1997,Teruel,Alba (44007),0,5,-5
1997,Teruel,Albalate del Arzobispo (44008),18,36,-18
1997,Teruel,Albarracín (44009),6,18,-12
1997,Teruel,Albentosa (44010),2,5,-3
1997,Teruel,Alcalá de la Selva (44012),1,5,-4
1997,Teruel,Alcañiz (44013),138,184,-46
1997,Teruel,Alcorisa (44014),27,30,-3
1997,Teruel,Alfambra (44016),5,10,-5
1997,Teruel,Aliaga (44017),0,3,-3
1997,Teruel,Alloza (44022),0,11,-11
1997,Teruel,Almohaja (44018),0,1,-1
1997,Teruel,Alobras (44019),1,1,0
1997,Teruel,Alpeñés (44020),0,1,-1
1997,Teruel,Andorra (44025),73,53,20
1997,Teruel,Arcos de las Salinas (44026),0,3,-3
1997,Teruel,Arens de Lledó (44027),2,3,-1
1997,Teruel,Argente (44028),2,2,0
1997,Teruel,Ariño (44029),9,12,-3
1997,Teruel,Azaila (44031),0,1,-1
1997,Teruel,Barrachina (44035),0,3,-3
1997,Teruel,Bañón (44034),0,2,-2
1997,Teruel,Beceite (44037),3,13,-10
1997,Teruel,Bello (44039),4,5,-1
1997,Teruel,Belmonte de San José (44038),2,,2
1997,Teruel,Berge (44040),1,4,-3
1997,Teruel,Bezas (44041),0,1,-1
1997,Teruel,Blancas (44042),1,3,-2
1997,Teruel,Blesa (44043),0,1,-1
1997,Teruel,Bordón (44044),1,3,-2
1997,Teruel,Bronchales (44045),2,7,-5
1997,Teruel,Bueña (44046),0,1,-1
1997,Teruel,Burbáguena (44047),0,20,-20
1997,Teruel,Báguena (44033),1,19,-18
1997,Teruel,Cabra de Mora (44048),0,2,-2
1997,Teruel,Calaceite (44049),9,9,0
1997,Teruel,Calamocha (44050),36,59,-23
1997,Teruel,Calanda (44051),31,42,-11
1997,Teruel,Calomarde (44052),0,1,-1
1997,Teruel,Camarena de la Sierra (44054),2,4,-2
1997,Teruel,Camañas (44053),0,2,-2
1997,Teruel,Caminreal (44056),7,13,-6
1997,Teruel,Cantavieja (44059),4,11,-7
1997,Teruel,Cascante del Río (44064),0,1,-1
1997,Teruel,Castejón de Tornos (44065),1,1,0
1997,Teruel,Castel de Cabra (44066),2,2,0
1997,Teruel,Castellar (El) (44070),1,1,0
1997,Teruel,Castellote (44071),7,5,2
1997,Teruel,Castelnou (44067),0,1,-1
1997,Teruel,Castelserás (44068),6,15,-9
1997,Teruel,Cañada de Benatanduz (44060),0,2,-2
1997,Teruel,Cañada de Verich (La) (44061),1,3,-2
1997,Teruel,Cañizar del Olivar (44063),1,,1
1997,Teruel,Cedrillas (44074),6,6,0
1997,Teruel,Celadas (44075),3,8,-5
1997,Teruel,Cella (44076),21,37,-16
1997,Teruel,Cerollera (La) (44077),0,2,-2
1997,Teruel,Codoñera (La) (44080),0,3,-3
1997,Teruel,Cortes de Aragón (44084),0,2,-2
1997,Teruel,Cretas (44086),1,14,-13
1997,Teruel,Crivillén (44087),0,,0
1997,Teruel,Cuba (La) (44088),0,2,-2
1997,Teruel,Cubla (44089),0,4,-4
1997,Teruel,Cucalón (44090),0,1,-1
1997,Teruel,Cuervo (El) (44092),0,5,-5
1997,Teruel,Cuevas de Almudén (44093),2,1,1
1997,Teruel,Cuevas Labradas (44094),0,2,-2
1997,Teruel,Ejulve (44096),1,4,-3
1997,Teruel,Escorihuela (44097),1,3,-2
1997,Teruel,Escucha (44099),13,7,6
1997,Teruel,Estercuel (44100),3,3,0
1997,Teruel,Ferreruela de Huerva (44101),1,2,-1
1997,Teruel,Formiche Alto (44103),4,3,1
1997,Teruel,Fortanete (44106),1,1,0
1997,Teruel,Foz-Calanda (44107),0,3,-3
1997,Teruel,Fresneda (La) (44108),4,3,1
1997,Teruel,Frías de Albarracín (44109),1,,1
1997,Teruel,Fuentes Calientes (44111),2,2,0
1997,Teruel,Fuentes Claras (44112),7,13,-6
1997,Teruel,Fuentes de Rubielos (44113),0,4,-4
1997,Teruel,Fuentespalda (44114),4,5,-1
1997,Teruel,Fórnoles (44105),0,1,-1
1997,Teruel,Galve (44115),1,1,0
1997,Teruel,Gargallo (44116),1,1,0
1997,Teruel,Gea de Albarracín (44117),6,9,-3
1997,Teruel,Ginebrosa (La) (44118),0,3,-3
1997,Teruel,Griegos (44119),0,5,-5
1997,Teruel,Guadalaviar (44120),3,2,1
1997,Teruel,Gúdar (44121),0,1,-1
1997,Teruel,Hinojosa de Jarque (44123),1,4,-3
1997,Teruel,Hoz de la Vieja (La) (44124),0,2,-2
1997,Teruel,Huesa del Común (44125),0,2,-2
1997,Teruel,Híjar (44122),10,36,-26
1997,Teruel,Iglesuela del Cid (La) (44126),2,5,-3
1997,Teruel,Jabaloyas (44127),1,2,-1
1997,Teruel,Jarque de la Val (44128),0,2,-2
1997,Teruel,Jatiel (44129),0,1,-1
1997,Teruel,Josa (44131),0,,0
1997,Teruel,Libros (44135),0,3,-3
1997,Teruel,Linares de Mora (44137),1,6,-5
1997,Teruel,Lledó (44141),1,5,-4
1997,Teruel,Loscos (44138),0,3,-3
1997,Teruel,Maicas (44142),0,2,-2
1997,Teruel,Manzanera (44143),6,8,-2
1997,Teruel,Martín del Río (44144),4,6,-2
1997,Teruel,Mas de las Matas (44145),11,18,-7
1997,Teruel,Mata de los Olmos (La) (44146),1,4,-3
1997,Teruel,Mazaleón (44147),4,12,-8
1997,Teruel,Mezquita de Jarque (44148),1,1,0
1997,Teruel,Miravete de la Sierra (44150),0,1,-1
1997,Teruel,Molinos (44151),2,5,-3
1997,Teruel,Monforte de Moyuela (44152),0,2,-2
1997,Teruel,Monreal del Campo (44153),21,23,-2
1997,Teruel,Monroyo (44154),2,2,0
1997,Teruel,Montalbán (44155),11,24,-13
1997,Teruel,Monteagudo del Castillo (44156),0,1,-1
1997,Teruel,Monterde de Albarracín (44157),0,1,-1
1997,Teruel,Mora de Rubielos (44158),23,18,5
1997,Teruel,Moscardón (44159),0,1,-1
1997,Teruel,Mosqueruela (44160),4,9,-5
1997,Teruel,Muniesa (44161),4,15,-11
1997,Teruel,Noguera de Albarracín (44163),0,,0
1997,Teruel,Nogueruelas (44165),1,3,-2
1997,Teruel,Obón (44167),0,1,-1
1997,Teruel,Odón (44168),1,6,-5
1997,Teruel,Ojos Negros (44169),5,10,-5
1997,Teruel,Olba (44171),0,3,-3
1997,Teruel,Oliete (44172),1,8,-7
1997,Teruel,Olmos (Los) (44173),1,1,0
1997,Teruel,Orihuela del Tremedal (44174),8,5,3
1997,Teruel,Orrios (44175),0,3,-3
1997,Teruel,Palomar de Arroyos (44176),2,2,0
1997,Teruel,Pancrudo (44177),0,4,-4
1997,Teruel,Parras de Castellote (Las) (44178),0,4,-4
1997,Teruel,Peralejos (44181),1,1,0
1997,Teruel,Perales del Alfambra (44182),4,4,0
1997,Teruel,Peñarroya de Tastavins (44179),4,16,-12
1997,Teruel,Pitarque (44183),1,4,-3
1997,Teruel,Pobo (El) (44185),0,4,-4
1997,Teruel,Portellada (La) (44187),1,8,-7
1997,Teruel,Pozondón (44189),0,1,-1
1997,Teruel,Pozuel del Campo (44190),0,2,-2
1997,Teruel,Puebla de Híjar (La) (44191),11,20,-9
1997,Teruel,Puebla de Valverde (La) (44192),5,4,1
1997,Teruel,Puertomingalvo (44193),0,1,-1
1997,Teruel,Rillo (44195),0,2,-2
1997,Teruel,Riodeva (44196),1,7,-6
1997,Teruel,Royuela (44198),3,3,0
1997,Teruel,Rubiales (44199),0,1,-1
1997,Teruel,Rubielos de la Cérida (44200),1,,1
1997,Teruel,Rubielos de Mora (44201),5,13,-8
1997,Teruel,Ráfales (44194),0,4,-4
1997,Teruel,Ródenas (44197),2,3,-1
1997,Teruel,Samper de Calanda (44205),7,17,-10
1997,Teruel,San Agustín (44206),1,4,-3
1997,Teruel,San Martín del Río (44207),0,2,-2
1997,Teruel,Santa Cruz de Nogueras (44208),0,1,-1
1997,Teruel,Santa Eulalia (44209),5,23,-18
1997,Teruel,Sarrión (44210),10,24,-14
1997,Teruel,Segura de los Baños (44211),0,1,-1
1997,Teruel,Seno (44212),0,2,-2
1997,Teruel,Singra (44213),1,2,-1
1997,Teruel,Terriente (44215),1,3,-2
1997,Teruel,Teruel (44216),287,332,-45
1997,Teruel,Toril y Masegoso (44217),0,1,-1
1997,Teruel,Tormón (44218),0,1,-1
1997,Teruel,Tornos (44219),1,4,-3
1997,Teruel,Torralba de los Sisones (44220),7,2,5
1997,Teruel,Torre de Arcas (44223),0,2,-2
1997,Teruel,Torre del Compte (44225),0,6,-6
1997,Teruel,Torre los Negros (44227),1,2,-1
1997,Teruel,Torrecilla de Alcañiz (44221),1,8,-7
1997,Teruel,Torrecilla del Rebollar (44222),0,2,-2
1997,Teruel,Torrelacárcel (44226),0,3,-3
1997,Teruel,Torremocha de Jiloca (44228),0,5,-5
1997,Teruel,Torres de Albarracín (44229),1,3,-2
1997,Teruel,Torrevelilla (44230),2,4,-2
1997,Teruel,Torrijas (44231),0,1,-1
1997,Teruel,Torrijo del Campo (44232),2,8,-6
1997,Teruel,Tramacastiel (44234),0,1,-1
1997,Teruel,Tramacastilla (44235),0,2,-2
1997,Teruel,Tronchón (44236),1,2,-1
1997,Teruel,Urrea de Gaén (44237),1,10,-9
1997,Teruel,Utrillas (44238),20,32,-12
1997,Teruel,Valbona (44240),0,3,-3
1997,Teruel,Valdealgorfa (44241),4,13,-9
1997,Teruel,Valdelinares (44244),3,,3
1997,Teruel,Valdeltormo (44245),1,6,-5
1997,Teruel,Valderrobres (44246),14,28,-14
1997,Teruel,Valjunquera (44247),3,12,-9
1997,Teruel,Vallecillo (El) (44249),0,2,-2
1997,Teruel,Veguillas de la Sierra (44250),0,1,-1
1997,Teruel,Villafranca del Campo (44251),3,9,-6
1997,Teruel,Villahermosa del Campo (44252),0,,0
1997,Teruel,Villanueva del Rebollar de la Sierra (44256),1,1,0
1997,Teruel,Villar del Cobo (44257),1,3,-2
1997,Teruel,Villarluengo (44260),1,1,0
1997,Teruel,Villarquemado (44261),8,8,0
1997,Teruel,Villarroya de los Pinares (44262),1,3,-2
1997,Teruel,Villastar (44263),4,5,-1
1997,Teruel,Villel (44264),0,7,-7
1997,Teruel,Vinaceite (44265),1,2,-1
1997,Teruel,Visiedo (44266),0,5,-5
1997,Teruel,Vivel del Río Martín (44267),0,3,-3
1996,Teruel,Ababuj (44001),1,2,-1
1996,Teruel,Abejuela (44002),0,1,-1
1996,Teruel,Aguatón (44003),0,1,-1
1996,Teruel,Aguaviva (44004),4,11,-7
1996,Teruel,Aguilar del Alfambra (44005),1,,1
1996,Teruel,Alacón (44006),1,10,-9
1996,Teruel,Alba (44007),0,2,-2
1996,Teruel,Albalate del Arzobispo (44008),15,42,-27
1996,Teruel,Albarracín (44009),10,16,-6
1996,Teruel,Albentosa (44010),6,4,2
1996,Teruel,Alcaine (44011),1,1,0
1996,Teruel,Alcalá de la Selva (44012),3,2,1
1996,Teruel,Alcañiz (44013),109,135,-26
1996,Teruel,Alcorisa (44014),33,37,-4
1996,Teruel,Alfambra (44016),4,14,-10
1996,Teruel,Aliaga (44017),3,8,-5
1996,Teruel,Allepuz (44021),1,1,0
1996,Teruel,Alloza (44022),5,17,-12
1996,Teruel,Alobras (44019),1,2,-1
1996,Teruel,Andorra (44025),75,52,23
1996,Teruel,Arens de Lledó (44027),2,3,-1
1996,Teruel,Argente (44028),0,6,-6
1996,Teruel,Ariño (44029),5,14,-9
1996,Teruel,Azaila (44031),0,4,-4
1996,Teruel,Barrachina (44035),2,1,1
1996,Teruel,Bañón (44034),1,5,-4
1996,Teruel,Beceite (44037),8,8,0
1996,Teruel,Bello (44039),1,5,-4
1996,Teruel,Belmonte de San José (44038),1,1,0
1996,Teruel,Berge (44040),2,5,-3
1996,Teruel,Bezas (44041),0,1,-1
1996,Teruel,Blancas (44042),0,4,-4
1996,Teruel,Blesa (44043),1,1,0
1996,Teruel,Bordón (44044),0,1,-1
1996,Teruel,Bronchales (44045),3,2,1
1996,Teruel,Bueña (44046),0,1,-1
1996,Teruel,Burbáguena (44047),0,12,-12
1996,Teruel,Báguena (44033),2,6,-4
1996,Teruel,Cabra de Mora (44048),1,4,-3
1996,Teruel,Calaceite (44049),6,26,-20
1996,Teruel,Calamocha (44050),26,52,-26
1996,Teruel,Calanda (44051),33,42,-9
1996,Teruel,Calomarde (44052),0,3,-3
1996,Teruel,Camarena de la Sierra (44054),0,2,-2
1996,Teruel,Camarillas (44055),2,2,0
1996,Teruel,Camañas (44053),1,3,-2
1996,Teruel,Caminreal (44056),4,9,-5
1996,Teruel,Cantavieja (44059),4,4,0
1996,Teruel,Cascante del Río (44064),0,3,-3
1996,Teruel,Castejón de Tornos (44065),0,4,-4
1996,Teruel,Castel de Cabra (44066),2,2,0
1996,Teruel,Castellar (El) (44070),0,1,-1
1996,Teruel,Castellote (44071),6,17,-11
1996,Teruel,Castelnou (44067),0,6,-6
1996,Teruel,Castelserás (44068),7,5,2
1996,Teruel,Cañada de Benatanduz (44060),0,2,-2
1996,Teruel,Cañada de Verich (La) (44061),1,,1
1996,Teruel,Cañada Vellida (44062),0,1,-1
1996,Teruel,Cañizar del Olivar (44063),1,1,0
1996,Teruel,Cedrillas (44074),3,5,-2
1996,Teruel,Celadas (44075),4,9,-5
1996,Teruel,Cella (44076),13,32,-19
1996,Teruel,Cerollera (La) (44077),1,1,0
1996,Teruel,Codoñera (La) (44080),1,5,-4
1996,Teruel,Corbalán (44082),0,3,-3
1996,Teruel,Cortes de Aragón (44084),0,3,-3
1996,Teruel,Cosa (44085),1,,1
1996,Teruel,Cretas (44086),0,5,-5
1996,Teruel,Crivillén (44087),0,1,-1
1996,Teruel,Cuba (La) (44088),0,2,-2
1996,Teruel,Cubla (44089),0,1,-1
1996,Teruel,Cuervo (El) (44092),0,3,-3
1996,Teruel,Cuevas de Almudén (44093),0,1,-1
1996,Teruel,Cuevas Labradas (44094),0,2,-2
1996,Teruel,Ejulve (44096),2,4,-2
1996,Teruel,Escorihuela (44097),1,4,-3
1996,Teruel,Escucha (44099),9,6,3
1996,Teruel,Estercuel (44100),1,3,-2
1996,Teruel,Formiche Alto (44103),4,3,1
1996,Teruel,Fortanete (44106),0,3,-3
1996,Teruel,Foz-Calanda (44107),1,5,-4
1996,Teruel,Fresneda (La) (44108),3,5,-2
1996,Teruel,Frías de Albarracín (44109),0,1,-1
1996,Teruel,Fuentes Calientes (44111),0,2,-2
1996,Teruel,Fuentes Claras (44112),1,19,-18
1996,Teruel,Fuentes de Rubielos (44113),2,2,0
1996,Teruel,Fuentespalda (44114),6,,6
1996,Teruel,Fórnoles (44105),0,2,-2
1996,Teruel,Galve (44115),0,1,-1
1996,Teruel,Gargallo (44116),1,,1
1996,Teruel,Gea de Albarracín (44117),2,7,-5
1996,Teruel,Ginebrosa (La) (44118),1,9,-8
1996,Teruel,Griegos (44119),0,2,-2
1996,Teruel,Guadalaviar (44120),2,6,-4
1996,Teruel,Gúdar (44121),1,,1
1996,Teruel,Hinojosa de Jarque (44123),0,5,-5
1996,Teruel,Hoz de la Vieja (La) (44124),0,3,-3
1996,Teruel,Huesa del Común (44125),0,2,-2
1996,Teruel,Híjar (44122),18,32,-14
1996,Teruel,Iglesuela del Cid (La) (44126),3,5,-2
1996,Teruel,Jabaloyas (44127),0,1,-1
1996,Teruel,Jarque de la Val (44128),0,2,-2
1996,Teruel,Jorcas (44130),0,2,-2
1996,Teruel,Josa (44131),0,1,-1
1996,Teruel,Lagueruela (44132),0,1,-1
1996,Teruel,Lanzuela (44133),0,1,-1
1996,Teruel,Libros (44135),1,2,-1
1996,Teruel,Linares de Mora (44137),3,4,-1
1996,Teruel,Lledó (44141),0,5,-5
1996,Teruel,Loscos (44138),1,4,-3
1996,Teruel,Maicas (44142),1,1,0
1996,Teruel,Manzanera (44143),2,5,-3
1996,Teruel,Martín del Río (44144),3,8,-5
1996,Teruel,Mas de las Matas (44145),9,16,-7
1996,Teruel,Mata de los Olmos (La) (44146),1,3,-2
1996,Teruel,Mazaleón (44147),6,9,-3
1996,Teruel,Mezquita de Jarque (44148),2,,2
1996,Teruel,Molinos (44151),1,6,-5
1996,Teruel,Monforte de Moyuela (44152),0,1,-1
1996,Teruel,Monreal del Campo (44153),18,22,-4
1996,Teruel,Monroyo (44154),2,4,-2
1996,Teruel,Montalbán (44155),6,15,-9
1996,Teruel,Monterde de Albarracín (44157),0,2,-2
1996,Teruel,Mora de Rubielos (44158),14,11,3
1996,Teruel,Moscardón (44159),0,1,-1
1996,Teruel,Mosqueruela (44160),5,10,-5
1996,Teruel,Muniesa (44161),5,13,-8
1996,Teruel,Noguera de Albarracín (44163),1,,1
1996,Teruel,Nogueras (44164),0,1,-1
1996,Teruel,Nogueruelas (44165),1,6,-5
1996,Teruel,Obón (44167),0,1,-1
1996,Teruel,Odón (44168),1,1,0
1996,Teruel,Ojos Negros (44169),3,6,-3
1996,Teruel,Olba (44171),0,4,-4
1996,Teruel,Oliete (44172),5,10,-5
1996,Teruel,Olmos (Los) (44173),1,1,0
1996,Teruel,Orihuela del Tremedal (44174),4,9,-5
1996,Teruel,Orrios (44175),3,5,-2
1996,Teruel,Palomar de Arroyos (44176),1,4,-3
1996,Teruel,Pancrudo (44177),0,5,-5
1996,Teruel,Parras de Castellote (Las) (44178),1,8,-7
1996,Teruel,Peracense (44180),1,,1
1996,Teruel,Peralejos (44181),0,1,-1
1996,Teruel,Perales del Alfambra (44182),2,1,1
1996,Teruel,Peñarroya de Tastavins (44179),4,7,-3
1996,Teruel,Pitarque (44183),1,3,-2
1996,Teruel,Pobo (El) (44185),1,1,0
1996,Teruel,Portellada (La) (44187),0,5,-5
1996,Teruel,Pozondón (44189),0,3,-3
1996,Teruel,Pozuel del Campo (44190),1,1,0
1996,Teruel,Puebla de Híjar (La) (44191),9,17,-8
1996,Teruel,Puebla de Valverde (La) (44192),1,3,-2
1996,Teruel,Rillo (44195),2,1,1
1996,Teruel,Riodeva (44196),0,4,-4
1996,Teruel,Royuela (44198),1,2,-1
1996,Teruel,Rubiales (44199),0,2,-2
1996,Teruel,Rubielos de Mora (44201),7,3,4
1996,Teruel,Ráfales (44194),2,4,-2
1996,Teruel,Saldón (44204),0,1,-1
1996,Teruel,Samper de Calanda (44205),5,19,-14
1996,Teruel,San Agustín (44206),0,2,-2
1996,Teruel,San Martín del Río (44207),2,1,1
1996,Teruel,Santa Eulalia (44209),5,22,-17
1996,Teruel,Sarrión (44210),7,17,-10
1996,Teruel,Seno (44212),0,1,-1
1996,Teruel,Singra (44213),0,1,-1
1996,Teruel,Terriente (44215),0,1,-1
1996,Teruel,Teruel (44216),306,315,-9
1996,Teruel,Tormón (44218),0,2,-2
1996,Teruel,Tornos (44219),0,3,-3
1996,Teruel,Torralba de los Sisones (44220),1,6,-5
1996,Teruel,Torre de Arcas (44223),1,2,-1
1996,Teruel,Torre de las Arcas (44224),0,1,-1
1996,Teruel,Torre del Compte (44225),0,4,-4
1996,Teruel,Torre los Negros (44227),0,3,-3
1996,Teruel,Torrecilla de Alcañiz (44221),2,6,-4
1996,Teruel,Torrecilla del Rebollar (44222),1,3,-2
1996,Teruel,Torrelacárcel (44226),0,3,-3
1996,Teruel,Torremocha de Jiloca (44228),0,2,-2
1996,Teruel,Torres de Albarracín (44229),0,3,-3
1996,Teruel,Torrevelilla (44230),1,3,-2
1996,Teruel,Torrijas (44231),0,2,-2
1996,Teruel,Torrijo del Campo (44232),2,5,-3
1996,Teruel,Tramacastiel (44234),0,5,-5
1996,Teruel,Tramacastilla (44235),0,3,-3
1996,Teruel,Urrea de Gaén (44237),4,3,1
1996,Teruel,Utrillas (44238),19,28,-9
1996,Teruel,Valacloche (44239),1,,1
1996,Teruel,Valbona (44240),0,4,-4
1996,Teruel,Valdealgorfa (44241),5,11,-6
1996,Teruel,Valdecuenca (44243),0,2,-2
1996,Teruel,Valdeltormo (44245),2,9,-7
1996,Teruel,Valderrobres (44246),16,23,-7
1996,Teruel,Valjunquera (44247),1,3,-2
1996,Teruel,Villafranca del Campo (44251),2,2,0
1996,Teruel,Villahermosa del Campo (44252),0,1,-1
1996,Teruel,Villar del Cobo (44257),3,,3
1996,Teruel,Villar del Salz (44258),0,2,-2
1996,Teruel,Villarluengo (44260),0,3,-3
1996,Teruel,Villarquemado (44261),3,17,-14
1996,Teruel,Villarroya de los Pinares (44262),1,4,-3
1996,Teruel,Villastar (44263),2,8,-6
1996,Teruel,Villel (44264),1,6,-5
1996,Teruel,Vinaceite (44265),2,1,1
1996,Teruel,Visiedo (44266),1,4,-3
1996,Teruel,Vivel del Río Martín (44267),0,1,-1
