year,province,cp,cities,nacidos,defunciones,saldo
2017,Huesca,22001,Abiego,2,4,-2
2017,Huesca,22002,Abizanda,1,1,0
2017,Huesca,22003,Adahuesca,4,2,2
2017,Huesca,22004,Agüero,0,3,-3
2017,Huesca,22007,Albalate de Cinca,10,16,-6
2017,Huesca,22008,Albalatillo,1,4,-3
2017,Huesca,22009,Albelda,5,15,-10
2017,Huesca,22011,Albero Alto,2,2,0
2017,Huesca,22012,Albero Bajo,0,1,-1
2017,Huesca,22013,Alberuela de Tubo,3,3,0
2017,Huesca,22014,Alcalá de Gurrea,0,5,-5
2017,Huesca,22015,Alcalá del Obispo,0,5,-5
2017,Huesca,22016,Alcampell,5,14,-9
2017,Huesca,22017,Alcolea de Cinca,10,7,3
2017,Huesca,22018,Alcubierre,0,3,-3
2017,Huesca,22019,Alerre,2,3,-1
2017,Huesca,22020,Alfántega,2,1,1
2017,Huesca,22021,Almudévar,21,41,-20
2017,Huesca,22022,Almunia de San Juan,6,10,-4
2017,Huesca,22023,Almuniente,0,4,-4
2017,Huesca,22024,Alquézar,2,4,-2
2017,Huesca,22025,Altorricón,12,20,-8
2017,Huesca,22027,Angüés,1,5,-4
2017,Huesca,22028,Ansó,1,3,-2
2017,Huesca,22032,Aragüés del Puerto,0,2,-2
2017,Huesca,22036,Argavieso,0,1,-1
2017,Huesca,22037,Arguis,1,0,1
2017,Huesca,22035,Arén,0,2,-2
2017,Huesca,22039,Ayerbe,6,26,-20
2017,Huesca,22040,Azanuy-Alins,3,4,-1
2017,Huesca,22041,Azara,2,6,-4
2017,Huesca,22042,Azlor,3,2,1
2017,Huesca,22907,Aínsa-Sobrarbe,20,15,5
2017,Huesca,22006,Aísa,0,1,-1
2017,Huesca,22044,Bailo,0,4,-4
2017,Huesca,22045,Baldellou,0,2,-2
2017,Huesca,22046,Ballobar,4,9,-5
2017,Huesca,22047,Banastás,1,4,-3
2017,Huesca,22048,Barbastro,167,208,-41
2017,Huesca,22049,Barbués,0,0,0
2017,Huesca,22052,Belver de Cinca,12,25,-13
2017,Huesca,22053,Benabarre,5,21,-16
2017,Huesca,22054,Benasque,18,6,12
2017,Huesca,22246,Beranuy,0,3,-3
2017,Huesca,22055,Berbegal,0,5,-5
2017,Huesca,22057,Bielsa,0,4,-4
2017,Huesca,22058,Bierge,0,1,-1
2017,Huesca,22059,Biescas,10,17,-7
2017,Huesca,22060,Binaced,12,17,-5
2017,Huesca,22061,Binéfar,85,90,-5
2017,Huesca,22062,Bisaurri,1,2,-1
2017,Huesca,22063,Biscarrués,0,3,-3
2017,Huesca,22064,Blecua y Torres,0,5,-5
2017,Huesca,22066,Boltaña,6,7,-1
2017,Huesca,22067,Bonansa,1,0,1
2017,Huesca,22069,Broto,5,8,-3
2017,Huesca,22072,Caldearenas,3,3,0
2017,Huesca,22074,Campo,2,9,-7
2017,Huesca,22075,Camporrells,0,0,0
2017,Huesca,22076,Canal de Berdún,0,4,-4
2017,Huesca,22077,Candasnos,1,3,-2
2017,Huesca,22078,Canfranc,0,4,-4
2017,Huesca,22079,Capdesaso,1,0,1
2017,Huesca,22080,Capella,2,6,-4
2017,Huesca,22081,Casbas de Huesca,1,6,-5
2017,Huesca,22083,Castejón de Monegros,1,5,-4
2017,Huesca,22084,Castejón de Sos,4,8,-4
2017,Huesca,22082,Castejón del Puente,2,3,-1
2017,Huesca,22085,Castelflorite,0,3,-3
2017,Huesca,22086,Castiello de Jaca,0,3,-3
2017,Huesca,22087,Castigaleu,1,2,-1
2017,Huesca,22088,Castillazuelo,2,4,-2
2017,Huesca,22089,Castillonroy,1,9,-8
2017,Huesca,22094,Chalamera,0,2,-2
2017,Huesca,22096,Chimillas,2,8,-6
2017,Huesca,22095,Chía,1,1,0
2017,Huesca,22090,Colungo,0,2,-2
2017,Huesca,22099,Esplús,1,7,-6
2017,Huesca,22102,Estada,0,1,-1
2017,Huesca,22103,Estadilla,5,16,-11
2017,Huesca,22105,Estopiñán del Castillo,1,1,0
2017,Huesca,22109,Fiscal,2,1,1
2017,Huesca,22110,Fonz,4,19,-15
2017,Huesca,22111,Foradada del Toscar,2,0,2
2017,Huesca,22112,Fraga,172,125,47
2017,Huesca,22113,Fueva (La),4,8,-4
2017,Huesca,22114,Gistaín,0,3,-3
2017,Huesca,22115,Grado (El),4,5,-1
2017,Huesca,22117,Graus,33,58,-25
2017,Huesca,22116,Grañén,7,33,-26
2017,Huesca,22119,Gurrea de Gállego,14,22,-8
2017,Huesca,22122,Hoz de Jaca,0,1,-1
2017,Huesca,22908,Hoz y Costeán,1,1,0
2017,Huesca,22124,Huerto,1,3,-2
2017,Huesca,22125,Huesca,451,564,-113
2017,Huesca,22126,Ibieca,1,2,-1
2017,Huesca,22127,Igriés,7,9,-2
2017,Huesca,22128,Ilche,0,1,-1
2017,Huesca,22129,Isábena,1,6,-5
2017,Huesca,22130,Jaca,92,145,-53
2017,Huesca,22131,Jasa,0,1,-1
2017,Huesca,22133,Labuerda,0,1,-1
2017,Huesca,22135,Laluenga,1,6,-5
2017,Huesca,22136,Lalueza,4,15,-11
2017,Huesca,22137,Lanaja,8,23,-15
2017,Huesca,22141,Lascellas-Ponzano,1,1,0
2017,Huesca,22142,Lascuarre,1,1,0
2017,Huesca,22143,Laspaúles,0,2,-2
2017,Huesca,22144,Laspuña,4,4,0
2017,Huesca,22149,Loarre,0,5,-5
2017,Huesca,22150,Loporzano,3,4,-1
2017,Huesca,22151,Loscorrales,1,3,-2
2017,Huesca,22905,Lupiñén-Ortilla,2,6,-4
2017,Huesca,22155,Monesma y Cajigar,0,5,-5
2017,Huesca,22156,Monflorite-Lascasas,4,4,0
2017,Huesca,22157,Montanuy,1,7,-6
2017,Huesca,22158,Monzón,147,194,-47
2017,Huesca,22160,Naval,3,2,1
2017,Huesca,22162,Novales,2,1,1
2017,Huesca,22163,Nueno,2,3,-1
2017,Huesca,22165,Ontiñena,4,6,-2
2017,Huesca,22167,Osso de Cinca,4,10,-6
2017,Huesca,22168,Palo,0,1,-1
2017,Huesca,22170,Panticosa,5,6,-1
2017,Huesca,22174,Peralta de Alcofea,2,10,-8
2017,Huesca,22175,Peralta de Calasanz,1,4,-3
2017,Huesca,22176,Peraltilla,2,2,0
2017,Huesca,22177,Perarrúa,1,2,-1
2017,Huesca,22178,Pertusa,1,2,-1
2017,Huesca,22172,Peñalba,2,13,-11
2017,Huesca,22173,Peñas de Riglos (Las),0,5,-5
2017,Huesca,22181,Piracés,0,1,-1
2017,Huesca,22182,Plan,2,4,-2
2017,Huesca,22184,Poleñino,1,2,-1
2017,Huesca,22186,Pozán de Vero,2,2,0
2017,Huesca,22187,Puebla de Castro (La),1,4,-3
2017,Huesca,22188,Puente de Montañana,0,2,-2
2017,Huesca,22902,Puente la Reina de Jaca,0,2,-2
2017,Huesca,22190,Pueyo de Araguás (El),1,3,-2
2017,Huesca,22193,Pueyo de Santa Cruz,2,4,-2
2017,Huesca,22189,Puértolas,3,3,0
2017,Huesca,22195,Quicena,0,2,-2
2017,Huesca,22197,Robres,3,8,-5
2017,Huesca,22199,Sabiñánigo,67,107,-40
2017,Huesca,22200,Sahún,3,7,-4
2017,Huesca,22201,Salas Altas,1,2,-1
2017,Huesca,22202,Salas Bajas,0,5,-5
2017,Huesca,22203,Salillas,1,4,-3
2017,Huesca,22204,Sallent de Gállego,8,12,-4
2017,Huesca,22205,San Esteban de Litera,1,9,-8
2017,Huesca,22207,San Juan de Plan,2,1,1
2017,Huesca,22903,San Miguel del Cinca,7,12,-5
2017,Huesca,22206,Sangarrén,2,2,0
2017,Huesca,22208,Santa Cilia,5,2,3
2017,Huesca,22209,Santa Cruz de la Serós,2,2,0
2017,Huesca,22906,Santa María de Dulcis,0,4,-4
2017,Huesca,22213,Sariñena,44,42,2
2017,Huesca,22214,Secastilla,2,0,2
2017,Huesca,22215,Seira,1,2,-1
2017,Huesca,22217,Sena,0,7,-7
2017,Huesca,22220,Sesa,0,6,-6
2017,Huesca,22221,Sesué,1,2,-1
2017,Huesca,22222,Siétamo,6,4,2
2017,Huesca,22223,Sopeira,0,2,-2
2017,Huesca,22904,Sotonera (La),2,20,-18
2017,Huesca,22225,Tamarite de Litera,23,47,-24
2017,Huesca,22226,Tardienta,4,14,-10
2017,Huesca,22227,Tella-Sin,1,4,-3
2017,Huesca,22228,Tierz,6,6,0
2017,Huesca,22229,Tolva,0,5,-5
2017,Huesca,22230,Torla-Ordesa,3,3,0
2017,Huesca,22232,Torralba de Aragón,0,3,-3
2017,Huesca,22233,Torre la Ribera,1,1,0
2017,Huesca,22234,Torrente de Cinca,0,10,-10
2017,Huesca,22235,Torres de Alcanadre,0,2,-2
2017,Huesca,22236,Torres de Barbués,0,4,-4
2017,Huesca,22239,Tramaced,1,1,0
2017,Huesca,22242,Valfarta,0,2,-2
2017,Huesca,22901,Valle de Hecho,3,8,-5
2017,Huesca,22244,Valle de Lierp,0,1,-1
2017,Huesca,22245,Velilla de Cinca,2,6,-4
2017,Huesca,22909,Vencillón,1,3,-2
2017,Huesca,22247,Viacamp y Litera,0,2,-2
2017,Huesca,22248,Vicién,1,1,0
2017,Huesca,22249,Villanova,1,2,-1
2017,Huesca,22251,Villanueva de Sigena,2,6,-4
2017,Huesca,22250,Villanúa,3,3,0
2017,Huesca,22252,Yebra de Basa,1,2,-1
2017,Huesca,22254,Zaidín,15,22,-7
2017,Teruel,44001,Ababuj,0,1,-1
2017,Teruel,44004,Aguaviva,3,8,-5
2017,Teruel,44005,Aguilar del Alfambra,1,3,-2
2017,Teruel,44006,Alacón,2,8,-6
2017,Teruel,44007,Alba,0,4,-4
2017,Teruel,44008,Albalate del Arzobispo,17,35,-18
2017,Teruel,44009,Albarracín,6,17,-11
2017,Teruel,44010,Albentosa,3,3,0
2017,Teruel,44012,Alcalá de la Selva,1,3,-2
2017,Teruel,44013,Alcañiz,147,125,22
2017,Teruel,44014,Alcorisa,25,44,-19
2017,Teruel,44016,Alfambra,0,12,-12
2017,Teruel,44017,Aliaga,2,4,-2
2017,Teruel,44021,Allepuz,1,3,-2
2017,Teruel,44022,Alloza,4,9,-5
2017,Teruel,44023,Allueva,1,1,0
2017,Teruel,44024,Anadón,0,1,-1
2017,Teruel,44025,Andorra,53,79,-26
2017,Teruel,44026,Arcos de las Salinas,0,2,-2
2017,Teruel,44027,Arens de Lledó,2,2,0
2017,Teruel,44028,Argente,1,8,-7
2017,Teruel,44029,Ariño,5,12,-7
2017,Teruel,44031,Azaila,2,7,-5
2017,Teruel,44035,Barrachina,0,3,-3
2017,Teruel,44034,Bañón,0,3,-3
2017,Teruel,44037,Beceite,0,8,-8
2017,Teruel,44039,Bello,1,10,-9
2017,Teruel,44038,Belmonte de San José,1,1,0
2017,Teruel,44042,Blancas,0,2,-2
2017,Teruel,44043,Blesa,1,2,-1
2017,Teruel,44045,Bronchales,3,5,-2
2017,Teruel,44046,Bueña,0,1,-1
2017,Teruel,44047,Burbáguena,1,4,-3
2017,Teruel,44033,Báguena,1,5,-4
2017,Teruel,44048,Cabra de Mora,0,2,-2
2017,Teruel,44049,Calaceite,5,21,-16
2017,Teruel,44050,Calamocha,30,53,-23
2017,Teruel,44051,Calanda,23,55,-32
2017,Teruel,44052,Calomarde,0,2,-2
2017,Teruel,44054,Camarena de la Sierra,1,1,0
2017,Teruel,44055,Camarillas,2,1,1
2017,Teruel,44053,Camañas,0,4,-4
2017,Teruel,44056,Caminreal,3,14,-11
2017,Teruel,44059,Cantavieja,5,4,1
2017,Teruel,44064,Cascante del Río,0,1,-1
2017,Teruel,44065,Castejón de Tornos,0,3,-3
2017,Teruel,44066,Castel de Cabra,0,3,-3
2017,Teruel,44071,Castellote,0,12,-12
2017,Teruel,44067,Castelnou,1,1,0
2017,Teruel,44068,Castelserás,11,14,-3
2017,Teruel,44060,Cañada de Benatanduz,0,1,-1
2017,Teruel,44074,Cedrillas,6,7,-1
2017,Teruel,44075,Celadas,0,10,-10
2017,Teruel,44076,Cella,18,41,-23
2017,Teruel,44080,Codoñera (La),1,8,-7
2017,Teruel,44084,Cortes de Aragón,0,1,-1
2017,Teruel,44085,Cosa,0,1,-1
2017,Teruel,44086,Cretas,3,4,-1
2017,Teruel,44087,Crivillén,0,1,-1
2017,Teruel,44089,Cubla,0,1,-1
2017,Teruel,44090,Cucalón,0,3,-3
2017,Teruel,44092,Cuervo (El),0,3,-3
2017,Teruel,44093,Cuevas de Almudén,2,0,2
2017,Teruel,44094,Cuevas Labradas,0,2,-2
2017,Teruel,44096,Ejulve,1,5,-4
2017,Teruel,44097,Escorihuela,0,4,-4
2017,Teruel,44099,Escucha,9,9,0
2017,Teruel,44100,Estercuel,0,3,-3
2017,Teruel,44101,Ferreruela de Huerva,0,1,-1
2017,Teruel,44102,Fonfría,0,2,-2
2017,Teruel,44103,Formiche Alto,0,4,-4
2017,Teruel,44106,Fortanete,2,2,0
2017,Teruel,44107,Foz-Calanda,1,4,-3
2017,Teruel,44108,Fresneda (La),1,9,-8
2017,Teruel,44109,Frías de Albarracín,0,5,-5
2017,Teruel,44110,Fuenferrada,0,1,-1
2017,Teruel,44111,Fuentes Calientes,0,2,-2
2017,Teruel,44112,Fuentes Claras,2,10,-8
2017,Teruel,44113,Fuentes de Rubielos,1,2,-1
2017,Teruel,44114,Fuentespalda,1,4,-3
2017,Teruel,44105,Fórnoles,1,0,1
2017,Teruel,44115,Galve,1,1,0
2017,Teruel,44116,Gargallo,0,1,-1
2017,Teruel,44117,Gea de Albarracín,1,0,1
2017,Teruel,44118,Ginebrosa (La),0,2,-2
2017,Teruel,44119,Griegos,0,2,-2
2017,Teruel,44120,Guadalaviar,0,5,-5
2017,Teruel,44121,Gúdar,0,1,-1
2017,Teruel,44123,Hinojosa de Jarque,1,1,0
2017,Teruel,44124,Hoz de la Vieja (La),0,1,-1
2017,Teruel,44125,Huesa del Común,0,1,-1
2017,Teruel,44122,Híjar,17,23,-6
2017,Teruel,44126,Iglesuela del Cid (La),1,12,-11
2017,Teruel,44127,Jabaloyas,0,3,-3
2017,Teruel,44128,Jarque de la Val,0,2,-2
2017,Teruel,44131,Josa,0,1,-1
2017,Teruel,44132,Lagueruela,0,1,-1
2017,Teruel,44133,Lanzuela,1,0,1
2017,Teruel,44135,Libros,0,3,-3
2017,Teruel,44137,Linares de Mora,2,3,-1
2017,Teruel,44141,Lledó,0,1,-1
2017,Teruel,44138,Loscos,0,5,-5
2017,Teruel,44143,Manzanera,1,7,-6
2017,Teruel,44144,Martín del Río,2,13,-11
2017,Teruel,44145,Mas de las Matas,6,24,-18
2017,Teruel,44146,Mata de los Olmos (La),1,6,-5
2017,Teruel,44147,Mazaleón,7,8,-1
2017,Teruel,44148,Mezquita de Jarque,3,2,1
2017,Teruel,44149,Mirambel,2,0,2
2017,Teruel,44151,Molinos,2,3,-1
2017,Teruel,44152,Monforte de Moyuela,0,1,-1
2017,Teruel,44153,Monreal del Campo,25,33,-8
2017,Teruel,44154,Monroyo,5,7,-2
2017,Teruel,44155,Montalbán,7,18,-11
2017,Teruel,44158,Mora de Rubielos,5,19,-14
2017,Teruel,44159,Moscardón,0,3,-3
2017,Teruel,44160,Mosqueruela,3,11,-8
2017,Teruel,44161,Muniesa,7,18,-11
2017,Teruel,44164,Nogueras,0,1,-1
2017,Teruel,44165,Nogueruelas,0,2,-2
2017,Teruel,44167,Obón,0,1,-1
2017,Teruel,44168,Odón,0,4,-4
2017,Teruel,44169,Ojos Negros,1,9,-8
2017,Teruel,44171,Olba,1,0,1
2017,Teruel,44172,Oliete,4,4,0
2017,Teruel,44173,Olmos (Los),1,2,-1
2017,Teruel,44174,Orihuela del Tremedal,3,5,-2
2017,Teruel,44175,Orrios,0,1,-1
2017,Teruel,44176,Palomar de Arroyos,2,2,0
2017,Teruel,44177,Pancrudo,0,1,-1
2017,Teruel,44178,Parras de Castellote (Las),1,2,-1
2017,Teruel,44180,Peracense,0,2,-2
2017,Teruel,44181,Peralejos,0,1,-1
2017,Teruel,44182,Perales del Alfambra,0,7,-7
2017,Teruel,44179,Peñarroya de Tastavins,2,9,-7
2017,Teruel,44183,Pitarque,0,1,-1
2017,Teruel,44184,Plou,0,1,-1
2017,Teruel,44185,Pobo (El),0,3,-3
2017,Teruel,44187,Portellada (La),1,1,0
2017,Teruel,44189,Pozondón,0,4,-4
2017,Teruel,44190,Pozuel del Campo,0,1,-1
2017,Teruel,44191,Puebla de Híjar (La),1,15,-14
2017,Teruel,44192,Puebla de Valverde (La),1,8,-7
2017,Teruel,44193,Puertomingalvo,2,1,1
2017,Teruel,44195,Rillo,0,5,-5
2017,Teruel,44196,Riodeva,2,3,-1
2017,Teruel,44198,Royuela,0,3,-3
2017,Teruel,44199,Rubiales,1,0,1
2017,Teruel,44201,Rubielos de Mora,7,10,-3
2017,Teruel,44194,Ráfales,0,3,-3
2017,Teruel,44197,Ródenas,0,4,-4
2017,Teruel,44203,Salcedillo,0,1,-1
2017,Teruel,44205,Samper de Calanda,6,17,-11
2017,Teruel,44206,San Agustín,0,2,-2
2017,Teruel,44207,San Martín del Río,0,5,-5
2017,Teruel,44208,Santa Cruz de Nogueras,1,2,-1
2017,Teruel,44209,Santa Eulalia,4,21,-17
2017,Teruel,44210,Sarrión,12,12,0
2017,Teruel,44211,Segura de los Baños,0,2,-2
2017,Teruel,44212,Seno,0,1,-1
2017,Teruel,44213,Singra,0,2,-2
2017,Teruel,44215,Terriente,0,3,-3
2017,Teruel,44216,Teruel,291,329,-38
2017,Teruel,44219,Tornos,0,2,-2
2017,Teruel,44220,Torralba de los Sisones,0,1,-1
2017,Teruel,44223,Torre de Arcas,0,2,-2
2017,Teruel,44225,Torre del Compte,1,3,-2
2017,Teruel,44221,Torrecilla de Alcañiz,1,4,-3
2017,Teruel,44226,Torrelacárcel,0,7,-7
2017,Teruel,44228,Torremocha de Jiloca,1,2,-1
2017,Teruel,44229,Torres de Albarracín,2,1,1
2017,Teruel,44230,Torrevelilla,1,1,0
2017,Teruel,44231,Torrijas,1,1,0
2017,Teruel,44232,Torrijo del Campo,5,9,-4
2017,Teruel,44234,Tramacastiel,0,2,-2
2017,Teruel,44235,Tramacastilla,0,2,-2
2017,Teruel,44236,Tronchón,0,3,-3
2017,Teruel,44237,Urrea de Gaén,2,11,-9
2017,Teruel,44238,Utrillas,25,33,-8
2017,Teruel,44240,Valbona,0,4,-4
2017,Teruel,44241,Valdealgorfa,3,9,-6
2017,Teruel,44243,Valdecuenca,1,0,1
2017,Teruel,44244,Valdelinares,1,0,1
2017,Teruel,44245,Valdeltormo,2,2,0
2017,Teruel,44246,Valderrobres,22,28,-6
2017,Teruel,44247,Valjunquera,1,5,-4
2017,Teruel,44249,Vallecillo (El),0,1,-1
2017,Teruel,44250,Veguillas de la Sierra,0,1,-1
2017,Teruel,44251,Villafranca del Campo,1,5,-4
2017,Teruel,44252,Villahermosa del Campo,0,1,-1
2017,Teruel,44256,Villanueva del Rebollar de la Sierra,1,0,1
2017,Teruel,44257,Villar del Cobo,0,3,-3
2017,Teruel,44258,Villar del Salz,0,2,-2
2017,Teruel,44260,Villarluengo,2,1,1
2017,Teruel,44261,Villarquemado,7,9,-2
2017,Teruel,44262,Villarroya de los Pinares,0,1,-1
2017,Teruel,44263,Villastar,5,8,-3
2017,Teruel,44264,Villel,1,9,-8
2017,Teruel,44265,Vinaceite,0,5,-5
2017,Teruel,44266,Visiedo,2,4,-2
2017,Zaragoza,50001,Abanto,0,3,-3
2017,Zaragoza,50002,Acered,0,4,-4
2017,Zaragoza,50004,Aguarón,4,15,-11
2017,Zaragoza,50005,Aguilón,1,2,-1
2017,Zaragoza,50003,Agón,1,7,-6
2017,Zaragoza,50006,Ainzón,6,26,-20
2017,Zaragoza,50008,Alagón,53,60,-7
2017,Zaragoza,50009,Alarba,0,4,-4
2017,Zaragoza,50011,Albeta,1,2,-1
2017,Zaragoza,50013,Alcalá de Ebro,0,4,-4
2017,Zaragoza,50014,Alcalá de Moncayo,0,4,-4
2017,Zaragoza,50015,Alconchel de Ariza,1,0,1
2017,Zaragoza,50017,Alfajarín,22,26,-4
2017,Zaragoza,50018,Alfamén,11,13,-2
2017,Zaragoza,50019,Alforque,0,1,-1
2017,Zaragoza,50020,Alhama de Aragón,7,11,-4
2017,Zaragoza,50022,Almolda (La),3,9,-6
2017,Zaragoza,50023,Almonacid de la Cuba,1,10,-9
2017,Zaragoza,50024,Almonacid de la Sierra,7,20,-13
2017,Zaragoza,50025,Almunia de Doña Godina (La),81,94,-13
2017,Zaragoza,50026,Alpartir,2,5,-3
2017,Zaragoza,50027,Ambel,1,3,-2
2017,Zaragoza,50029,Aniñón,1,13,-12
2017,Zaragoza,50031,Aranda de Moncayo,0,3,-3
2017,Zaragoza,50034,Ariza,10,19,-9
2017,Zaragoza,50035,Artieda,0,1,-1
2017,Zaragoza,50032,Arándiga,1,6,-5
2017,Zaragoza,50036,Asín,0,2,-2
2017,Zaragoza,50037,Atea,2,4,-2
2017,Zaragoza,50038,Ateca,8,23,-15
2017,Zaragoza,50039,Azuara,3,6,-3
2017,Zaragoza,50030,Añón de Moncayo,1,4,-3
2017,Zaragoza,50044,Bardallur,2,7,-5
2017,Zaragoza,50045,Belchite,9,27,-18
2017,Zaragoza,50046,Belmonte de Gracián,1,8,-7
2017,Zaragoza,50901,Biel,0,5,-5
2017,Zaragoza,50050,Bijuesca,0,3,-3
2017,Zaragoza,50051,Biota,0,24,-24
2017,Zaragoza,50052,Bisimbre,0,2,-2
2017,Zaragoza,50053,Boquiñeni,4,16,-12
2017,Zaragoza,50054,Bordalba,0,1,-1
2017,Zaragoza,50055,Borja,37,66,-29
2017,Zaragoza,50056,Botorrita,4,5,-1
2017,Zaragoza,50057,Brea de Aragón,8,13,-5
2017,Zaragoza,50058,Bubierca,0,1,-1
2017,Zaragoza,50059,Bujaraloz,13,15,-2
2017,Zaragoza,50060,Bulbuente,1,4,-3
2017,Zaragoza,50061,Bureta,1,3,-2
2017,Zaragoza,50062,Burgo de Ebro (El),16,21,-5
2017,Zaragoza,50043,Bárboles,0,2,-2
2017,Zaragoza,50064,Cabañas de Ebro,1,8,-7
2017,Zaragoza,50066,Cadrete,47,14,33
2017,Zaragoza,50067,Calatayud,126,227,-101
2017,Zaragoza,50068,Calatorao,24,39,-15
2017,Zaragoza,50070,Calmarza,0,1,-1
2017,Zaragoza,50071,Campillo de Aragón,0,3,-3
2017,Zaragoza,50072,Carenas,0,5,-5
2017,Zaragoza,50073,Cariñena,26,40,-14
2017,Zaragoza,50074,Caspe,114,102,12
2017,Zaragoza,50075,Castejón de Alarba,0,2,-2
2017,Zaragoza,50076,Castejón de las Armas,0,2,-2
2017,Zaragoza,50077,Castejón de Valdejasa,2,2,0
2017,Zaragoza,50078,Castiliscar,0,2,-2
2017,Zaragoza,50079,Cervera de la Cañada,0,5,-5
2017,Zaragoza,50080,Cerveruela,0,1,-1
2017,Zaragoza,50081,Cetina,1,8,-7
2017,Zaragoza,50092,Chiprana,3,4,-1
2017,Zaragoza,50093,Chodes,0,4,-4
2017,Zaragoza,50082,Cimballa,0,2,-2
2017,Zaragoza,50083,Cinco Olivas,0,2,-2
2017,Zaragoza,50084,Clarés de Ribota,0,2,-2
2017,Zaragoza,50085,Codo,0,3,-3
2017,Zaragoza,50086,Codos,0,2,-2
2017,Zaragoza,50087,Contamina,0,1,-1
2017,Zaragoza,50088,Cosuenda,1,5,-4
2017,Zaragoza,50089,Cuarte de Huerva,204,31,173
2017,Zaragoza,50090,Cubel,0,6,-6
2017,Zaragoza,50091,Cuerlas (Las),0,2,-2
2017,Zaragoza,50094,Daroca,12,39,-27
2017,Zaragoza,50095,Ejea de los Caballeros,135,187,-52
2017,Zaragoza,50098,Encinacorba,1,4,-3
2017,Zaragoza,50100,Erla,0,3,-3
2017,Zaragoza,50101,Escatrón,4,18,-14
2017,Zaragoza,50102,Fabara,3,19,-16
2017,Zaragoza,50104,Farlete,1,3,-2
2017,Zaragoza,50106,Fayos (Los),0,3,-3
2017,Zaragoza,50105,Fayón,6,9,-3
2017,Zaragoza,50107,Figueruelas,9,12,-3
2017,Zaragoza,50108,Fombuena,0,1,-1
2017,Zaragoza,50109,Frago (El),0,2,-2
2017,Zaragoza,50110,Frasno (El),1,5,-4
2017,Zaragoza,50111,Fréscano,2,4,-2
2017,Zaragoza,50113,Fuendejalón,7,7,0
2017,Zaragoza,50114,Fuendetodos,1,3,-2
2017,Zaragoza,50115,Fuentes de Ebro,41,45,-4
2017,Zaragoza,50116,Fuentes de Jiloca,1,6,-5
2017,Zaragoza,50117,Gallocanta,1,0,1
2017,Zaragoza,50118,Gallur,23,36,-13
2017,Zaragoza,50119,Gelsa,8,26,-18
2017,Zaragoza,50121,Gotor,0,6,-6
2017,Zaragoza,50123,Grisén,5,10,-5
2017,Zaragoza,50124,Herrera de los Navarros,4,7,-3
2017,Zaragoza,50125,Ibdes,1,5,-4
2017,Zaragoza,50126,Illueca,8,34,-26
2017,Zaragoza,50128,Isuerre,0,1,-1
2017,Zaragoza,50129,Jaraba,0,9,-9
2017,Zaragoza,50130,Jarque de Moncayo,4,8,-4
2017,Zaragoza,50131,Jaulín,1,5,-4
2017,Zaragoza,50132,Joyosa (La),12,8,4
2017,Zaragoza,50133,Lagata,0,2,-2
2017,Zaragoza,50134,Langa del Castillo,1,2,-1
2017,Zaragoza,50135,Layana,1,4,-3
2017,Zaragoza,50137,Leciñena,3,28,-25
2017,Zaragoza,50139,Letux,1,10,-9
2017,Zaragoza,50141,Lituénigo,2,2,0
2017,Zaragoza,50142,Lobera de Onsella,1,1,0
2017,Zaragoza,50143,Longares,2,16,-14
2017,Zaragoza,50146,Lucena de Jalón,1,3,-2
2017,Zaragoza,50147,Luceni,10,12,-2
2017,Zaragoza,50148,Luesia,0,6,-6
2017,Zaragoza,50150,Lumpiaque,11,12,-1
2017,Zaragoza,50151,Luna,3,19,-16
2017,Zaragoza,50136,Lécera,2,15,-13
2017,Zaragoza,50152,Maella,18,31,-13
2017,Zaragoza,50153,Magallón,6,20,-14
2017,Zaragoza,50154,Mainar,0,3,-3
2017,Zaragoza,50155,Malanquilla,0,1,-1
2017,Zaragoza,50156,Maleján,0,2,-2
2017,Zaragoza,50160,Mallén,22,38,-16
2017,Zaragoza,50159,Maluenda,1,13,-12
2017,Zaragoza,50157,Malón,3,10,-7
2017,Zaragoza,50161,Manchones,3,4,-1
2017,Zaragoza,50162,Mara,1,4,-3
2017,Zaragoza,50163,María de Huerva,73,27,46
2017,Zaragoza,50164,Mediana de Aragón,0,3,-3
2017,Zaragoza,50165,Mequinenza,7,31,-24
2017,Zaragoza,50166,Mesones de Isuela,1,1,0
2017,Zaragoza,50167,Mezalocha,0,5,-5
2017,Zaragoza,50169,Miedes de Aragón,3,5,-2
2017,Zaragoza,50170,Monegrillo,1,4,-3
2017,Zaragoza,50171,Moneva,0,1,-1
2017,Zaragoza,50172,Monreal de Ariza,1,2,-1
2017,Zaragoza,50173,Monterde,0,2,-2
2017,Zaragoza,50174,Montón,0,1,-1
2017,Zaragoza,50175,Morata de Jalón,3,25,-22
2017,Zaragoza,50176,Morata de Jiloca,2,3,-1
2017,Zaragoza,50178,Moros,0,9,-9
2017,Zaragoza,50177,Morés,0,7,-7
2017,Zaragoza,50179,Moyuela,0,9,-9
2017,Zaragoza,50180,Mozota,0,3,-3
2017,Zaragoza,50181,Muel,2,11,-9
2017,Zaragoza,50182,Muela (La),60,25,35
2017,Zaragoza,50183,Munébrega,0,2,-2
2017,Zaragoza,50184,Murero,0,1,-1
2017,Zaragoza,50185,Murillo de Gállego,0,0,0
2017,Zaragoza,50187,Nigüella,0,2,-2
2017,Zaragoza,50189,Nonaspe,7,18,-11
2017,Zaragoza,50190,Novallas,7,18,-11
2017,Zaragoza,50191,Novillas,5,10,-5
2017,Zaragoza,50193,Nuez de Ebro,8,8,0
2017,Zaragoza,50192,Nuévalos,4,6,-2
2017,Zaragoza,50194,Olvés,0,4,-4
2017,Zaragoza,50195,Orcajo,0,1,-1
2017,Zaragoza,50196,Orera,0,4,-4
2017,Zaragoza,50197,Orés,0,2,-2
2017,Zaragoza,50199,Osera de Ebro,4,12,-8
2017,Zaragoza,50200,Paniza,2,9,-7
2017,Zaragoza,50201,Paracuellos de Jiloca,5,7,-2
2017,Zaragoza,50202,Paracuellos de la Ribera,0,2,-2
2017,Zaragoza,50203,Pastriz,9,13,-4
2017,Zaragoza,50204,Pedrola,32,25,7
2017,Zaragoza,50205,Pedrosas (Las),0,3,-3
2017,Zaragoza,50206,Perdiguera,0,6,-6
2017,Zaragoza,50207,Piedratajada,0,3,-3
2017,Zaragoza,50208,Pina de Ebro,13,35,-22
2017,Zaragoza,50209,Pinseque,50,54,-4
2017,Zaragoza,50210,Pintanos (Los),0,1,-1
2017,Zaragoza,50211,Plasencia de Jalón,3,9,-6
2017,Zaragoza,50212,Pleitas,0,0,0
2017,Zaragoza,50213,Plenas,0,2,-2
2017,Zaragoza,50215,Pozuel de Ariza,0,1,-1
2017,Zaragoza,50216,Pozuelo de Aragón,2,0,2
2017,Zaragoza,50217,Pradilla de Ebro,3,5,-2
2017,Zaragoza,50218,Puebla de Albortón,1,2,-1
2017,Zaragoza,50219,Puebla de Alfindén (La),57,23,34
2017,Zaragoza,50220,Puendeluna,0,1,-1
2017,Zaragoza,50222,Quinto,15,23,-8
2017,Zaragoza,50223,Remolinos,5,17,-12
2017,Zaragoza,50224,Retascón,1,1,0
2017,Zaragoza,50225,Ricla,23,35,-12
2017,Zaragoza,50227,Romanos,1,6,-5
2017,Zaragoza,50228,Rueda de Jalón,5,3,2
2017,Zaragoza,50229,Ruesca,0,2,-2
2017,Zaragoza,50231,Salillas de Jalón,3,6,-3
2017,Zaragoza,50232,Salvatierra de Esca,1,3,-2
2017,Zaragoza,50233,Samper del Salz,0,1,-1
2017,Zaragoza,50234,San Martín de la Virgen de Moncayo,2,5,-3
2017,Zaragoza,50235,San Mateo de Gállego,32,31,1
2017,Zaragoza,50236,Santa Cruz de Grío,0,3,-3
2017,Zaragoza,50237,Santa Cruz de Moncayo,0,3,-3
2017,Zaragoza,50238,Santa Eulalia de Gállego,1,1,0
2017,Zaragoza,50239,Santed,0,3,-3
2017,Zaragoza,50241,Saviñán,3,9,-6
2017,Zaragoza,50242,Sediles,0,4,-4
2017,Zaragoza,50243,Sestrica,0,6,-6
2017,Zaragoza,50244,Sierra de Luna,3,3,0
2017,Zaragoza,50245,Sigüés,1,3,-2
2017,Zaragoza,50246,Sisamón,0,1,-1
2017,Zaragoza,50247,Sobradiel,10,12,-2
2017,Zaragoza,50248,Sos del Rey Católico,5,8,-3
2017,Zaragoza,50230,Sádaba,6,32,-26
2017,Zaragoza,50240,Sástago,7,27,-20
2017,Zaragoza,50249,Tabuenca,0,8,-8
2017,Zaragoza,50250,Talamantes,0,0,0
2017,Zaragoza,50251,Tarazona,67,110,-43
2017,Zaragoza,50252,Tauste,51,93,-42
2017,Zaragoza,50253,Terrer,0,11,-11
2017,Zaragoza,50254,Tierga,0,1,-1
2017,Zaragoza,50255,Tobed,0,7,-7
2017,Zaragoza,50256,Torralba de los Frailes,0,2,-2
2017,Zaragoza,50257,Torralba de Ribota,0,3,-3
2017,Zaragoza,50259,Torrehermosa,0,1,-1
2017,Zaragoza,50260,Torrelapaja,0,1,-1
2017,Zaragoza,50261,Torrellas,0,8,-8
2017,Zaragoza,50262,Torres de Berrellén,8,15,-7
2017,Zaragoza,50263,Torrijo de la Cañada,2,4,-2
2017,Zaragoza,50264,Tosos,0,3,-3
2017,Zaragoza,50266,Trasobares,0,5,-5
2017,Zaragoza,50267,Uncastillo,2,15,-13
2017,Zaragoza,50269,Urrea de Jalón,4,17,-13
2017,Zaragoza,50270,Urriés,0,1,-1
2017,Zaragoza,50271,Used,0,8,-8
2017,Zaragoza,50272,Utebo,167,107,60
2017,Zaragoza,50274,Val de San Martín,0,2,-2
2017,Zaragoza,50275,Valmadrid,1,7,-6
2017,Zaragoza,50276,Valpalmas,0,2,-2
2017,Zaragoza,50278,Velilla de Ebro,1,2,-1
2017,Zaragoza,50280,Vera de Moncayo,2,8,-6
2017,Zaragoza,50281,Vierlas,1,1,0
2017,Zaragoza,50283,Villadoz,2,2,0
2017,Zaragoza,50284,Villafeliche,0,2,-2
2017,Zaragoza,50285,Villafranca de Ebro,12,14,-2
2017,Zaragoza,50286,Villalba de Perejil,0,2,-2
2017,Zaragoza,50287,Villalengua,1,6,-5
2017,Zaragoza,50903,Villamayor de Gállego,15,21,-6
2017,Zaragoza,50288,Villanueva de Gállego,30,50,-20
2017,Zaragoza,50290,Villanueva de Huerva,2,6,-4
2017,Zaragoza,50289,Villanueva de Jiloca,0,3,-3
2017,Zaragoza,50291,Villar de los Navarros,1,2,-1
2017,Zaragoza,50292,Villarreal de Huerva,4,2,2
2017,Zaragoza,50293,Villarroya de la Sierra,1,11,-10
2017,Zaragoza,50294,Villarroya del Campo,2,0,2
2017,Zaragoza,50282,Vilueña (La),0,2,-2
2017,Zaragoza,50296,Zaida (La),2,8,-6
2017,Zaragoza,50297,Zaragoza,5619,6558,-939
2017,Zaragoza,50298,Zuera,70,70,0
2017,Zaragoza,50099,Épila,50,58,-8
2016,Huesca,22001,Abiego,1,1,0
2016,Huesca,22002,Abizanda,0,3,-3
2016,Huesca,22003,Adahuesca,3,3,0
2016,Huesca,22004,Agüero,0,5,-5
2016,Huesca,22007,Albalate de Cinca,7,18,-11
2016,Huesca,22008,Albalatillo,1,2,-1
2016,Huesca,22009,Albelda,4,12,-8
2016,Huesca,22011,Albero Alto,0,1,-1
2016,Huesca,22012,Albero Bajo,0,3,-3
2016,Huesca,22013,Alberuela de Tubo,3,5,-2
2016,Huesca,22014,Alcalá de Gurrea,1,6,-5
2016,Huesca,22015,Alcalá del Obispo,0,4,-4
2016,Huesca,22016,Alcampell,3,17,-14
2016,Huesca,22017,Alcolea de Cinca,8,23,-15
2016,Huesca,22018,Alcubierre,1,5,-4
2016,Huesca,22019,Alerre,0,1,-1
2016,Huesca,22020,Alfántega,0,1,-1
2016,Huesca,22021,Almudévar,14,41,-27
2016,Huesca,22022,Almunia de San Juan,6,10,-4
2016,Huesca,22023,Almuniente,3,5,-2
2016,Huesca,22024,Alquézar,0,7,-7
2016,Huesca,22025,Altorricón,8,33,-25
2016,Huesca,22027,Angüés,1,11,-10
2016,Huesca,22028,Ansó,4,6,-2
2016,Huesca,22029,Antillón,0,1,-1
2016,Huesca,22032,Aragüés del Puerto,1,1,0
2016,Huesca,22036,Argavieso,0,3,-3
2016,Huesca,22037,Arguis,1,1,0
2016,Huesca,22035,Arén,1,2,-1
2016,Huesca,22039,Ayerbe,5,16,-11
2016,Huesca,22040,Azanuy-Alins,1,1,0
2016,Huesca,22041,Azara,1,4,-3
2016,Huesca,22907,Aínsa-Sobrarbe,19,26,-7
2016,Huesca,22006,Aísa,0,4,-4
2016,Huesca,22043,Baells,0,2,-2
2016,Huesca,22044,Bailo,0,2,-2
2016,Huesca,22045,Baldellou,0,2,-2
2016,Huesca,22046,Ballobar,11,13,-2
2016,Huesca,22047,Banastás,0,2,-2
2016,Huesca,22048,Barbastro,143,193,-50
2016,Huesca,22049,Barbués,0,1,-1
2016,Huesca,22052,Belver de Cinca,10,33,-23
2016,Huesca,22053,Benabarre,8,36,-28
2016,Huesca,22054,Benasque,23,10,13
2016,Huesca,22246,Beranuy,1,2,-1
2016,Huesca,22055,Berbegal,2,3,-1
2016,Huesca,22057,Bielsa,3,6,-3
2016,Huesca,22058,Bierge,0,4,-4
2016,Huesca,22059,Biescas,10,15,-5
2016,Huesca,22060,Binaced,13,15,-2
2016,Huesca,22061,Binéfar,80,94,-14
2016,Huesca,22062,Bisaurri,0,3,-3
2016,Huesca,22063,Biscarrués,2,1,1
2016,Huesca,22064,Blecua y Torres,0,3,-3
2016,Huesca,22066,Boltaña,6,8,-2
2016,Huesca,22067,Bonansa,0,1,-1
2016,Huesca,22069,Broto,6,7,-1
2016,Huesca,22051,Bárcabo,0,4,-4
2016,Huesca,22072,Caldearenas,2,6,-4
2016,Huesca,22074,Campo,0,1,-1
2016,Huesca,22075,Camporrells,1,4,-3
2016,Huesca,22076,Canal de Berdún,2,5,-3
2016,Huesca,22077,Candasnos,2,2,0
2016,Huesca,22078,Canfranc,4,3,1
2016,Huesca,22079,Capdesaso,1,4,-3
2016,Huesca,22080,Capella,2,4,-2
2016,Huesca,22081,Casbas de Huesca,1,1,0
2016,Huesca,22083,Castejón de Monegros,1,7,-6
2016,Huesca,22084,Castejón de Sos,3,8,-5
2016,Huesca,22082,Castejón del Puente,1,4,-3
2016,Huesca,22086,Castiello de Jaca,2,0,2
2016,Huesca,22087,Castigaleu,1,2,-1
2016,Huesca,22088,Castillazuelo,0,1,-1
2016,Huesca,22089,Castillonroy,4,7,-3
2016,Huesca,22094,Chalamera,1,0,1
2016,Huesca,22096,Chimillas,1,3,-2
2016,Huesca,22095,Chía,2,2,0
2016,Huesca,22090,Colungo,1,0,1
2016,Huesca,22099,Esplús,1,11,-10
2016,Huesca,22102,Estada,0,4,-4
2016,Huesca,22103,Estadilla,4,12,-8
2016,Huesca,22105,Estopiñán del Castillo,0,5,-5
2016,Huesca,22106,Fago,1,0,1
2016,Huesca,22107,Fanlo,0,1,-1
2016,Huesca,22109,Fiscal,1,2,-1
2016,Huesca,22110,Fonz,2,16,-14
2016,Huesca,22111,Foradada del Toscar,0,1,-1
2016,Huesca,22112,Fraga,173,131,42
2016,Huesca,22113,Fueva (La),7,8,-1
2016,Huesca,22114,Gistaín,1,1,0
2016,Huesca,22115,Grado (El),0,11,-11
2016,Huesca,22117,Graus,30,52,-22
2016,Huesca,22116,Grañén,8,25,-17
2016,Huesca,22119,Gurrea de Gállego,9,18,-9
2016,Huesca,22122,Hoz de Jaca,0,1,-1
2016,Huesca,22908,Hoz y Costeán,2,5,-3
2016,Huesca,22124,Huerto,2,3,-1
2016,Huesca,22125,Huesca,475,543,-68
2016,Huesca,22126,Ibieca,0,2,-2
2016,Huesca,22127,Igriés,3,4,-1
2016,Huesca,22128,Ilche,0,2,-2
2016,Huesca,22129,Isábena,1,3,-2
2016,Huesca,22130,Jaca,129,149,-20
2016,Huesca,22133,Labuerda,1,2,-1
2016,Huesca,22135,Laluenga,1,4,-3
2016,Huesca,22136,Lalueza,7,16,-9
2016,Huesca,22137,Lanaja,1,21,-20
2016,Huesca,22139,Laperdiguera,0,1,-1
2016,Huesca,22141,Lascellas-Ponzano,0,5,-5
2016,Huesca,22142,Lascuarre,3,3,0
2016,Huesca,22143,Laspaúles,2,2,0
2016,Huesca,22144,Laspuña,3,2,1
2016,Huesca,22149,Loarre,3,5,-2
2016,Huesca,22150,Loporzano,3,5,-2
2016,Huesca,22151,Loscorrales,0,1,-1
2016,Huesca,22905,Lupiñén-Ortilla,1,4,-3
2016,Huesca,22155,Monesma y Cajigar,0,2,-2
2016,Huesca,22156,Monflorite-Lascasas,4,3,1
2016,Huesca,22157,Montanuy,0,5,-5
2016,Huesca,22158,Monzón,144,166,-22
2016,Huesca,22160,Naval,1,3,-2
2016,Huesca,22162,Novales,0,1,-1
2016,Huesca,22163,Nueno,3,2,1
2016,Huesca,22164,Olvena,1,0,1
2016,Huesca,22165,Ontiñena,1,6,-5
2016,Huesca,22167,Osso de Cinca,4,10,-6
2016,Huesca,22168,Palo,0,0,0
2016,Huesca,22170,Panticosa,10,9,1
2016,Huesca,22174,Peralta de Alcofea,0,8,-8
2016,Huesca,22175,Peralta de Calasanz,1,3,-2
2016,Huesca,22176,Peraltilla,0,2,-2
2016,Huesca,22177,Perarrúa,1,0,1
2016,Huesca,22178,Pertusa,0,3,-3
2016,Huesca,22172,Peñalba,2,7,-5
2016,Huesca,22173,Peñas de Riglos (Las),2,2,0
2016,Huesca,22181,Piracés,0,1,-1
2016,Huesca,22182,Plan,2,2,0
2016,Huesca,22184,Poleñino,1,3,-2
2016,Huesca,22186,Pozán de Vero,1,4,-3
2016,Huesca,22187,Puebla de Castro (La),3,4,-1
2016,Huesca,22188,Puente de Montañana,0,1,-1
2016,Huesca,22902,Puente la Reina de Jaca,0,4,-4
2016,Huesca,22190,Pueyo de Araguás (El),0,3,-3
2016,Huesca,22193,Pueyo de Santa Cruz,1,6,-5
2016,Huesca,22189,Puértolas,3,2,1
2016,Huesca,22195,Quicena,0,6,-6
2016,Huesca,22197,Robres,2,7,-5
2016,Huesca,22199,Sabiñánigo,64,91,-27
2016,Huesca,22200,Sahún,2,1,1
2016,Huesca,22201,Salas Altas,1,7,-6
2016,Huesca,22202,Salas Bajas,2,1,1
2016,Huesca,22203,Salillas,1,4,-3
2016,Huesca,22204,Sallent de Gállego,10,10,0
2016,Huesca,22205,San Esteban de Litera,1,5,-4
2016,Huesca,22207,San Juan de Plan,1,2,-1
2016,Huesca,22903,San Miguel del Cinca,11,13,-2
2016,Huesca,22206,Sangarrén,0,4,-4
2016,Huesca,22208,Santa Cilia,1,4,-3
2016,Huesca,22209,Santa Cruz de la Serós,0,2,-2
2016,Huesca,22906,Santa María de Dulcis,0,5,-5
2016,Huesca,22212,Santaliestra y San Quílez,1,0,1
2016,Huesca,22213,Sariñena,36,46,-10
2016,Huesca,22214,Secastilla,0,1,-1
2016,Huesca,22215,Seira,0,3,-3
2016,Huesca,22217,Sena,0,10,-10
2016,Huesca,22220,Sesa,1,5,-4
2016,Huesca,22221,Sesué,1,0,1
2016,Huesca,22222,Siétamo,7,4,3
2016,Huesca,22223,Sopeira,0,1,-1
2016,Huesca,22904,Sotonera (La),2,9,-7
2016,Huesca,22225,Tamarite de Litera,23,34,-11
2016,Huesca,22226,Tardienta,6,13,-7
2016,Huesca,22227,Tella-Sin,0,2,-2
2016,Huesca,22228,Tierz,4,4,0
2016,Huesca,22229,Tolva,0,1,-1
2016,Huesca,22230,Torla-Ordesa,1,3,-2
2016,Huesca,22232,Torralba de Aragón,0,3,-3
2016,Huesca,22234,Torrente de Cinca,2,6,-4
2016,Huesca,22235,Torres de Alcanadre,0,1,-1
2016,Huesca,22236,Torres de Barbués,0,3,-3
2016,Huesca,22239,Tramaced,0,1,-1
2016,Huesca,22243,Valle de Bardají,0,1,-1
2016,Huesca,22901,Valle de Hecho,4,13,-9
2016,Huesca,22245,Velilla de Cinca,9,4,5
2016,Huesca,22909,Vencillón,0,9,-9
2016,Huesca,22248,Vicién,0,3,-3
2016,Huesca,22249,Villanova,1,0,1
2016,Huesca,22251,Villanueva de Sigena,2,6,-4
2016,Huesca,22250,Villanúa,5,2,3
2016,Huesca,22252,Yebra de Basa,0,1,-1
2016,Huesca,22254,Zaidín,14,24,-10
2016,Teruel,44004,Aguaviva,2,12,-10
2016,Teruel,44005,Aguilar del Alfambra,0,2,-2
2016,Teruel,44006,Alacón,0,8,-8
2016,Teruel,44007,Alba,1,6,-5
2016,Teruel,44008,Albalate del Arzobispo,10,19,-9
2016,Teruel,44009,Albarracín,7,14,-7
2016,Teruel,44010,Albentosa,0,3,-3
2016,Teruel,44011,Alcaine,0,1,-1
2016,Teruel,44012,Alcalá de la Selva,0,4,-4
2016,Teruel,44013,Alcañiz,148,141,7
2016,Teruel,44014,Alcorisa,29,34,-5
2016,Teruel,44016,Alfambra,3,6,-3
2016,Teruel,44017,Aliaga,4,5,-1
2016,Teruel,44021,Allepuz,2,2,0
2016,Teruel,44022,Alloza,4,5,-1
2016,Teruel,44018,Almohaja,0,1,-1
2016,Teruel,44019,Alobras,0,1,-1
2016,Teruel,44020,Alpeñés,0,1,-1
2016,Teruel,44025,Andorra,81,81,0
2016,Teruel,44026,Arcos de las Salinas,3,1,2
2016,Teruel,44027,Arens de Lledó,1,5,-4
2016,Teruel,44028,Argente,1,5,-4
2016,Teruel,44029,Ariño,3,7,-4
2016,Teruel,44031,Azaila,1,2,-1
2016,Teruel,44035,Barrachina,0,4,-4
2016,Teruel,44034,Bañón,1,5,-4
2016,Teruel,44037,Beceite,2,5,-3
2016,Teruel,44039,Bello,0,4,-4
2016,Teruel,44038,Belmonte de San José,2,3,-1
2016,Teruel,44040,Berge,2,5,-3
2016,Teruel,44041,Bezas,0,1,-1
2016,Teruel,44042,Blancas,0,6,-6
2016,Teruel,44043,Blesa,0,4,-4
2016,Teruel,44044,Bordón,0,4,-4
2016,Teruel,44045,Bronchales,2,2,0
2016,Teruel,44046,Bueña,0,3,-3
2016,Teruel,44032,Bádenas,0,1,-1
2016,Teruel,44033,Báguena,1,7,-6
2016,Teruel,44048,Cabra de Mora,0,2,-2
2016,Teruel,44049,Calaceite,9,12,-3
2016,Teruel,44050,Calamocha,41,56,-15
2016,Teruel,44051,Calanda,20,56,-36
2016,Teruel,44052,Calomarde,0,1,-1
2016,Teruel,44054,Camarena de la Sierra,0,2,-2
2016,Teruel,44055,Camarillas,2,3,-1
2016,Teruel,44053,Camañas,1,2,-1
2016,Teruel,44056,Caminreal,3,12,-9
2016,Teruel,44059,Cantavieja,3,9,-6
2016,Teruel,44064,Cascante del Río,0,1,-1
2016,Teruel,44065,Castejón de Tornos,0,1,-1
2016,Teruel,44066,Castel de Cabra,1,5,-4
2016,Teruel,44070,Castellar (El),0,2,-2
2016,Teruel,44071,Castellote,2,9,-7
2016,Teruel,44067,Castelnou,5,2,3
2016,Teruel,44068,Castelserás,6,11,-5
2016,Teruel,44060,Cañada de Benatanduz,0,0,0
2016,Teruel,44061,Cañada de Verich (La),0,2,-2
2016,Teruel,44062,Cañada Vellida,0,2,-2
2016,Teruel,44063,Cañizar del Olivar,3,1,2
2016,Teruel,44074,Cedrillas,5,6,-1
2016,Teruel,44075,Celadas,4,4,0
2016,Teruel,44076,Cella,21,26,-5
2016,Teruel,44077,Cerollera (La),2,1,1
2016,Teruel,44080,Codoñera (La),2,4,-2
2016,Teruel,44082,Corbalán,1,2,-1
2016,Teruel,44084,Cortes de Aragón,1,2,-1
2016,Teruel,44086,Cretas,1,11,-10
2016,Teruel,44087,Crivillén,0,1,-1
2016,Teruel,44088,Cuba (La),0,1,-1
2016,Teruel,44089,Cubla,0,1,-1
2016,Teruel,44090,Cucalón,0,1,-1
2016,Teruel,44092,Cuervo (El),0,2,-2
2016,Teruel,44093,Cuevas de Almudén,2,2,0
2016,Teruel,44094,Cuevas Labradas,0,2,-2
2016,Teruel,44096,Ejulve,0,4,-4
2016,Teruel,44097,Escorihuela,0,8,-8
2016,Teruel,44099,Escucha,7,8,-1
2016,Teruel,44100,Estercuel,0,3,-3
2016,Teruel,44103,Formiche Alto,1,4,-3
2016,Teruel,44106,Fortanete,1,3,-2
2016,Teruel,44107,Foz-Calanda,1,2,-1
2016,Teruel,44108,Fresneda (La),2,8,-6
2016,Teruel,44109,Frías de Albarracín,1,1,0
2016,Teruel,44110,Fuenferrada,0,1,-1
2016,Teruel,44112,Fuentes Claras,0,9,-9
2016,Teruel,44113,Fuentes de Rubielos,2,1,1
2016,Teruel,44114,Fuentespalda,2,5,-3
2016,Teruel,44105,Fórnoles,1,2,-1
2016,Teruel,44116,Gargallo,1,3,-2
2016,Teruel,44117,Gea de Albarracín,2,10,-8
2016,Teruel,44118,Ginebrosa (La),3,2,1
2016,Teruel,44119,Griegos,0,2,-2
2016,Teruel,44120,Guadalaviar,2,3,-1
2016,Teruel,44121,Gúdar,1,0,1
2016,Teruel,44123,Hinojosa de Jarque,2,1,1
2016,Teruel,44124,Hoz de la Vieja (La),0,2,-2
2016,Teruel,44125,Huesa del Común,0,3,-3
2016,Teruel,44122,Híjar,8,25,-17
2016,Teruel,44126,Iglesuela del Cid (La),1,3,-2
2016,Teruel,44127,Jabaloyas,0,2,-2
2016,Teruel,44128,Jarque de la Val,0,2,-2
2016,Teruel,44129,Jatiel,1,1,0
2016,Teruel,44130,Jorcas,1,0,1
2016,Teruel,44131,Josa,1,0,1
2016,Teruel,44132,Lagueruela,4,2,2
2016,Teruel,44135,Libros,0,5,-5
2016,Teruel,44136,Lidón,0,1,-1
2016,Teruel,44137,Linares de Mora,3,4,-1
2016,Teruel,44141,Lledó,3,3,0
2016,Teruel,44138,Loscos,0,2,-2
2016,Teruel,44143,Manzanera,7,5,2
2016,Teruel,44144,Martín del Río,5,2,3
2016,Teruel,44145,Mas de las Matas,5,22,-17
2016,Teruel,44146,Mata de los Olmos (La),3,1,2
2016,Teruel,44147,Mazaleón,4,7,-3
2016,Teruel,44148,Mezquita de Jarque,1,3,-2
2016,Teruel,44149,Mirambel,0,2,-2
2016,Teruel,44151,Molinos,2,7,-5
2016,Teruel,44152,Monforte de Moyuela,0,1,-1
2016,Teruel,44153,Monreal del Campo,13,34,-21
2016,Teruel,44154,Monroyo,3,6,-3
2016,Teruel,44155,Montalbán,6,15,-9
2016,Teruel,44156,Monteagudo del Castillo,1,0,1
2016,Teruel,44157,Monterde de Albarracín,0,4,-4
2016,Teruel,44158,Mora de Rubielos,16,19,-3
2016,Teruel,44160,Mosqueruela,4,10,-6
2016,Teruel,44161,Muniesa,3,11,-8
2016,Teruel,44163,Noguera de Albarracín,0,3,-3
2016,Teruel,44165,Nogueruelas,1,3,-2
2016,Teruel,44168,Odón,1,4,-3
2016,Teruel,44169,Ojos Negros,1,7,-6
2016,Teruel,44171,Olba,0,7,-7
2016,Teruel,44172,Oliete,0,5,-5
2016,Teruel,44173,Olmos (Los),1,2,-1
2016,Teruel,44174,Orihuela del Tremedal,2,4,-2
2016,Teruel,44175,Orrios,1,3,-2
2016,Teruel,44176,Palomar de Arroyos,0,4,-4
2016,Teruel,44177,Pancrudo,2,4,-2
2016,Teruel,44178,Parras de Castellote (Las),0,2,-2
2016,Teruel,44181,Peralejos,1,6,-5
2016,Teruel,44182,Perales del Alfambra,0,4,-4
2016,Teruel,44179,Peñarroya de Tastavins,3,6,-3
2016,Teruel,44184,Plou,1,0,1
2016,Teruel,44185,Pobo (El),1,4,-3
2016,Teruel,44187,Portellada (La),1,4,-3
2016,Teruel,44189,Pozondón,0,2,-2
2016,Teruel,44190,Pozuel del Campo,0,1,-1
2016,Teruel,44191,Puebla de Híjar (La),12,13,-1
2016,Teruel,44192,Puebla de Valverde (La),6,9,-3
2016,Teruel,44193,Puertomingalvo,1,5,-4
2016,Teruel,44195,Rillo,0,2,-2
2016,Teruel,44196,Riodeva,0,2,-2
2016,Teruel,44198,Royuela,0,2,-2
2016,Teruel,44200,Rubielos de la Cérida,0,1,-1
2016,Teruel,44201,Rubielos de Mora,4,7,-3
2016,Teruel,44194,Ráfales,2,2,0
2016,Teruel,44197,Ródenas,0,2,-2
2016,Teruel,44203,Salcedillo,0,1,-1
2016,Teruel,44204,Saldón,0,1,-1
2016,Teruel,44205,Samper de Calanda,1,14,-13
2016,Teruel,44206,San Agustín,1,1,0
2016,Teruel,44207,San Martín del Río,0,3,-3
2016,Teruel,44208,Santa Cruz de Nogueras,0,0,0
2016,Teruel,44209,Santa Eulalia,8,19,-11
2016,Teruel,44210,Sarrión,16,15,1
2016,Teruel,44212,Seno,0,3,-3
2016,Teruel,44213,Singra,0,1,-1
2016,Teruel,44215,Terriente,1,0,1
2016,Teruel,44216,Teruel,330,316,14
2016,Teruel,44218,Tormón,0,1,-1
2016,Teruel,44219,Tornos,1,6,-5
2016,Teruel,44220,Torralba de los Sisones,0,2,-2
2016,Teruel,44225,Torre del Compte,0,1,-1
2016,Teruel,44227,Torre los Negros,0,2,-2
2016,Teruel,44221,Torrecilla de Alcañiz,2,4,-2
2016,Teruel,44222,Torrecilla del Rebollar,0,1,-1
2016,Teruel,44226,Torrelacárcel,1,5,-4
2016,Teruel,44228,Torremocha de Jiloca,0,3,-3
2016,Teruel,44229,Torres de Albarracín,1,3,-2
2016,Teruel,44230,Torrevelilla,3,4,-1
2016,Teruel,44231,Torrijas,0,1,-1
2016,Teruel,44232,Torrijo del Campo,1,5,-4
2016,Teruel,44235,Tramacastilla,0,1,-1
2016,Teruel,44236,Tronchón,0,1,-1
2016,Teruel,44237,Urrea de Gaén,2,5,-3
2016,Teruel,44238,Utrillas,17,28,-11
2016,Teruel,44240,Valbona,2,4,-2
2016,Teruel,44241,Valdealgorfa,3,9,-6
2016,Teruel,44244,Valdelinares,0,1,-1
2016,Teruel,44245,Valdeltormo,4,6,-2
2016,Teruel,44246,Valderrobres,25,30,-5
2016,Teruel,44247,Valjunquera,3,10,-7
2016,Teruel,44251,Villafranca del Campo,2,6,-4
2016,Teruel,44257,Villar del Cobo,1,0,1
2016,Teruel,44258,Villar del Salz,0,1,-1
2016,Teruel,44260,Villarluengo,0,2,-2
2016,Teruel,44261,Villarquemado,8,11,-3
2016,Teruel,44262,Villarroya de los Pinares,1,3,-2
2016,Teruel,44263,Villastar,7,8,-1
2016,Teruel,44264,Villel,1,4,-3
2016,Teruel,44265,Vinaceite,3,4,-1
2016,Teruel,44266,Visiedo,3,6,-3
2016,Teruel,44267,Vivel del Río Martín,1,1,0
2016,Zaragoza,50001,Abanto,0,4,-4
2016,Zaragoza,50002,Acered,1,5,-4
2016,Zaragoza,50004,Aguarón,2,13,-11
2016,Zaragoza,50005,Aguilón,1,5,-4
2016,Zaragoza,50003,Agón,1,2,-1
2016,Zaragoza,50006,Ainzón,5,18,-13
2016,Zaragoza,50007,Aladrén,0,1,-1
2016,Zaragoza,50008,Alagón,67,61,6
2016,Zaragoza,50009,Alarba,0,1,-1
2016,Zaragoza,50011,Albeta,1,2,-1
2016,Zaragoza,50012,Alborge,1,1,0
2016,Zaragoza,50013,Alcalá de Ebro,3,0,3
2016,Zaragoza,50014,Alcalá de Moncayo,1,4,-3
2016,Zaragoza,50015,Alconchel de Ariza,0,5,-5
2016,Zaragoza,50016,Aldehuela de Liestos,0,1,-1
2016,Zaragoza,50017,Alfajarín,22,13,9
2016,Zaragoza,50018,Alfamén,18,23,-5
2016,Zaragoza,50019,Alforque,0,1,-1
2016,Zaragoza,50020,Alhama de Aragón,11,13,-2
2016,Zaragoza,50022,Almolda (La),0,9,-9
2016,Zaragoza,50023,Almonacid de la Cuba,1,8,-7
2016,Zaragoza,50024,Almonacid de la Sierra,2,15,-13
2016,Zaragoza,50025,Almunia de Doña Godina (La),67,72,-5
2016,Zaragoza,50026,Alpartir,2,4,-2
2016,Zaragoza,50027,Ambel,1,4,-3
2016,Zaragoza,50028,Anento,0,2,-2
2016,Zaragoza,50029,Aniñón,1,7,-6
2016,Zaragoza,50031,Aranda de Moncayo,0,4,-4
2016,Zaragoza,50034,Ariza,9,20,-11
2016,Zaragoza,50032,Arándiga,0,8,-8
2016,Zaragoza,50036,Asín,0,2,-2
2016,Zaragoza,50037,Atea,0,3,-3
2016,Zaragoza,50038,Ateca,6,20,-14
2016,Zaragoza,50039,Azuara,2,5,-3
2016,Zaragoza,50030,Añón de Moncayo,0,4,-4
2016,Zaragoza,50040,Badules,1,1,0
2016,Zaragoza,50044,Bardallur,1,4,-3
2016,Zaragoza,50045,Belchite,5,26,-21
2016,Zaragoza,50046,Belmonte de Gracián,0,2,-2
2016,Zaragoza,50048,Berrueco,1,0,1
2016,Zaragoza,50901,Biel,1,4,-3
2016,Zaragoza,50050,Bijuesca,0,1,-1
2016,Zaragoza,50051,Biota,5,12,-7
2016,Zaragoza,50052,Bisimbre,0,2,-2
2016,Zaragoza,50053,Boquiñeni,2,9,-7
2016,Zaragoza,50054,Bordalba,0,2,-2
2016,Zaragoza,50055,Borja,41,56,-15
2016,Zaragoza,50056,Botorrita,3,4,-1
2016,Zaragoza,50057,Brea de Aragón,8,11,-3
2016,Zaragoza,50058,Bubierca,0,2,-2
2016,Zaragoza,50059,Bujaraloz,10,19,-9
2016,Zaragoza,50060,Bulbuente,0,4,-4
2016,Zaragoza,50061,Bureta,1,4,-3
2016,Zaragoza,50062,Burgo de Ebro (El),36,13,23
2016,Zaragoza,50063,Buste (El),1,0,1
2016,Zaragoza,50043,Bárboles,1,9,-8
2016,Zaragoza,50064,Cabañas de Ebro,2,10,-8
2016,Zaragoza,50065,Cabolafuente,1,0,1
2016,Zaragoza,50066,Cadrete,28,29,-1
2016,Zaragoza,50067,Calatayud,158,205,-47
2016,Zaragoza,50068,Calatorao,21,26,-5
2016,Zaragoza,50070,Calmarza,0,2,-2
2016,Zaragoza,50071,Campillo de Aragón,0,3,-3
2016,Zaragoza,50072,Carenas,1,5,-4
2016,Zaragoza,50073,Cariñena,24,44,-20
2016,Zaragoza,50074,Caspe,100,102,-2
2016,Zaragoza,50075,Castejón de Alarba,0,2,-2
2016,Zaragoza,50076,Castejón de las Armas,0,6,-6
2016,Zaragoza,50077,Castejón de Valdejasa,0,5,-5
2016,Zaragoza,50078,Castiliscar,1,2,-1
2016,Zaragoza,50079,Cervera de la Cañada,1,6,-5
2016,Zaragoza,50080,Cerveruela,0,0,0
2016,Zaragoza,50081,Cetina,1,12,-11
2016,Zaragoza,50092,Chiprana,7,3,4
2016,Zaragoza,50093,Chodes,1,3,-2
2016,Zaragoza,50082,Cimballa,0,3,-3
2016,Zaragoza,50083,Cinco Olivas,0,2,-2
2016,Zaragoza,50084,Clarés de Ribota,0,3,-3
2016,Zaragoza,50085,Codo,0,3,-3
2016,Zaragoza,50086,Codos,0,4,-4
2016,Zaragoza,50087,Contamina,1,2,-1
2016,Zaragoza,50088,Cosuenda,2,4,-2
2016,Zaragoza,50089,Cuarte de Huerva,206,22,184
2016,Zaragoza,50090,Cubel,3,2,1
2016,Zaragoza,50094,Daroca,22,17,5
2016,Zaragoza,50095,Ejea de los Caballeros,126,176,-50
2016,Zaragoza,50096,Embid de Ariza,0,1,-1
2016,Zaragoza,50098,Encinacorba,0,4,-4
2016,Zaragoza,50100,Erla,3,6,-3
2016,Zaragoza,50101,Escatrón,7,24,-17
2016,Zaragoza,50102,Fabara,3,13,-10
2016,Zaragoza,50104,Farlete,2,7,-5
2016,Zaragoza,50106,Fayos (Los),0,5,-5
2016,Zaragoza,50105,Fayón,1,6,-5
2016,Zaragoza,50107,Figueruelas,9,15,-6
2016,Zaragoza,50108,Fombuena,0,1,-1
2016,Zaragoza,50110,Frasno (El),1,5,-4
2016,Zaragoza,50111,Fréscano,0,5,-5
2016,Zaragoza,50113,Fuendejalón,5,7,-2
2016,Zaragoza,50114,Fuendetodos,0,1,-1
2016,Zaragoza,50115,Fuentes de Ebro,40,50,-10
2016,Zaragoza,50116,Fuentes de Jiloca,0,9,-9
2016,Zaragoza,50117,Gallocanta,0,1,-1
2016,Zaragoza,50118,Gallur,13,25,-12
2016,Zaragoza,50119,Gelsa,5,13,-8
2016,Zaragoza,50120,Godojos,0,1,-1
2016,Zaragoza,50121,Gotor,0,1,-1
2016,Zaragoza,50122,Grisel,1,2,-1
2016,Zaragoza,50123,Grisén,9,10,-1
2016,Zaragoza,50124,Herrera de los Navarros,1,3,-2
2016,Zaragoza,50125,Ibdes,3,8,-5
2016,Zaragoza,50126,Illueca,18,27,-9
2016,Zaragoza,50129,Jaraba,1,3,-2
2016,Zaragoza,50130,Jarque de Moncayo,2,11,-9
2016,Zaragoza,50131,Jaulín,2,7,-5
2016,Zaragoza,50132,Joyosa (La),7,8,-1
2016,Zaragoza,50133,Lagata,0,1,-1
2016,Zaragoza,50134,Langa del Castillo,1,1,0
2016,Zaragoza,50135,Layana,0,2,-2
2016,Zaragoza,50138,Lechón,0,1,-1
2016,Zaragoza,50137,Leciñena,3,18,-15
2016,Zaragoza,50139,Letux,0,8,-8
2016,Zaragoza,50140,Litago,0,3,-3
2016,Zaragoza,50141,Lituénigo,1,3,-2
2016,Zaragoza,50142,Lobera de Onsella,0,1,-1
2016,Zaragoza,50143,Longares,5,9,-4
2016,Zaragoza,50146,Lucena de Jalón,2,3,-1
2016,Zaragoza,50147,Luceni,3,12,-9
2016,Zaragoza,50148,Luesia,1,8,-7
2016,Zaragoza,50150,Lumpiaque,4,20,-16
2016,Zaragoza,50151,Luna,0,10,-10
2016,Zaragoza,50136,Lécera,2,12,-10
2016,Zaragoza,50152,Maella,17,26,-9
2016,Zaragoza,50153,Magallón,9,18,-9
2016,Zaragoza,50154,Mainar,0,1,-1
2016,Zaragoza,50156,Maleján,1,3,-2
2016,Zaragoza,50160,Mallén,26,31,-5
2016,Zaragoza,50159,Maluenda,6,16,-10
2016,Zaragoza,50157,Malón,2,5,-3
2016,Zaragoza,50161,Manchones,1,2,-1
2016,Zaragoza,50162,Mara,0,4,-4
2016,Zaragoza,50902,Marracos,0,3,-3
2016,Zaragoza,50163,María de Huerva,98,14,84
2016,Zaragoza,50164,Mediana de Aragón,5,3,2
2016,Zaragoza,50165,Mequinenza,14,25,-11
2016,Zaragoza,50166,Mesones de Isuela,1,6,-5
2016,Zaragoza,50167,Mezalocha,2,1,1
2016,Zaragoza,50169,Miedes de Aragón,1,1,0
2016,Zaragoza,50170,Monegrillo,1,2,-1
2016,Zaragoza,50171,Moneva,0,3,-3
2016,Zaragoza,50172,Monreal de Ariza,0,4,-4
2016,Zaragoza,50173,Monterde,0,2,-2
2016,Zaragoza,50174,Montón,0,2,-2
2016,Zaragoza,50175,Morata de Jalón,3,20,-17
2016,Zaragoza,50176,Morata de Jiloca,0,3,-3
2016,Zaragoza,50178,Moros,1,11,-10
2016,Zaragoza,50177,Morés,1,6,-5
2016,Zaragoza,50179,Moyuela,0,5,-5
2016,Zaragoza,50180,Mozota,1,0,1
2016,Zaragoza,50181,Muel,10,20,-10
2016,Zaragoza,50182,Muela (La),69,21,48
2016,Zaragoza,50183,Munébrega,1,8,-7
2016,Zaragoza,50184,Murero,1,6,-5
2016,Zaragoza,50185,Murillo de Gállego,1,0,1
2016,Zaragoza,50187,Nigüella,0,3,-3
2016,Zaragoza,50189,Nonaspe,8,10,-2
2016,Zaragoza,50190,Novallas,7,15,-8
2016,Zaragoza,50191,Novillas,1,12,-11
2016,Zaragoza,50193,Nuez de Ebro,7,5,2
2016,Zaragoza,50192,Nuévalos,0,4,-4
2016,Zaragoza,50194,Olvés,0,2,-2
2016,Zaragoza,50195,Orcajo,1,0,1
2016,Zaragoza,50196,Orera,0,4,-4
2016,Zaragoza,50197,Orés,0,3,-3
2016,Zaragoza,50199,Osera de Ebro,2,8,-6
2016,Zaragoza,50200,Paniza,6,14,-8
2016,Zaragoza,50201,Paracuellos de Jiloca,1,6,-5
2016,Zaragoza,50202,Paracuellos de la Ribera,0,8,-8
2016,Zaragoza,50203,Pastriz,6,12,-6
2016,Zaragoza,50204,Pedrola,24,37,-13
2016,Zaragoza,50205,Pedrosas (Las),1,4,-3
2016,Zaragoza,50206,Perdiguera,2,6,-4
2016,Zaragoza,50208,Pina de Ebro,28,26,2
2016,Zaragoza,50209,Pinseque,48,41,7
2016,Zaragoza,50210,Pintanos (Los),0,1,-1
2016,Zaragoza,50211,Plasencia de Jalón,1,4,-3
2016,Zaragoza,50212,Pleitas,0,3,-3
2016,Zaragoza,50214,Pomer,0,1,-1
2016,Zaragoza,50215,Pozuel de Ariza,0,1,-1
2016,Zaragoza,50216,Pozuelo de Aragón,1,3,-2
2016,Zaragoza,50217,Pradilla de Ebro,5,12,-7
2016,Zaragoza,50218,Puebla de Albortón,1,1,0
2016,Zaragoza,50219,Puebla de Alfindén (La),75,22,53
2016,Zaragoza,50220,Puendeluna,0,3,-3
2016,Zaragoza,50222,Quinto,13,21,-8
2016,Zaragoza,50223,Remolinos,5,19,-14
2016,Zaragoza,50224,Retascón,0,1,-1
2016,Zaragoza,50225,Ricla,23,25,-2
2016,Zaragoza,50227,Romanos,0,6,-6
2016,Zaragoza,50228,Rueda de Jalón,5,6,-1
2016,Zaragoza,50229,Ruesca,0,1,-1
2016,Zaragoza,50231,Salillas de Jalón,1,13,-12
2016,Zaragoza,50232,Salvatierra de Esca,1,2,-1
2016,Zaragoza,50233,Samper del Salz,0,1,-1
2016,Zaragoza,50234,San Martín de la Virgen de Moncayo,4,4,0
2016,Zaragoza,50235,San Mateo de Gállego,25,35,-10
2016,Zaragoza,50236,Santa Cruz de Grío,0,1,-1
2016,Zaragoza,50237,Santa Cruz de Moncayo,2,3,-1
2016,Zaragoza,50238,Santa Eulalia de Gállego,1,4,-3
2016,Zaragoza,50241,Saviñán,3,12,-9
2016,Zaragoza,50243,Sestrica,0,7,-7
2016,Zaragoza,50244,Sierra de Luna,2,9,-7
2016,Zaragoza,50246,Sisamón,0,1,-1
2016,Zaragoza,50247,Sobradiel,10,13,-3
2016,Zaragoza,50248,Sos del Rey Católico,7,10,-3
2016,Zaragoza,50230,Sádaba,6,38,-32
2016,Zaragoza,50240,Sástago,10,12,-2
2016,Zaragoza,50249,Tabuenca,0,9,-9
2016,Zaragoza,50251,Tarazona,74,126,-52
2016,Zaragoza,50252,Tauste,61,89,-28
2016,Zaragoza,50253,Terrer,0,13,-13
2016,Zaragoza,50254,Tierga,1,3,-2
2016,Zaragoza,50255,Tobed,1,4,-3
2016,Zaragoza,50256,Torralba de los Frailes,0,1,-1
2016,Zaragoza,50257,Torralba de Ribota,0,2,-2
2016,Zaragoza,50258,Torralbilla,0,2,-2
2016,Zaragoza,50259,Torrehermosa,0,3,-3
2016,Zaragoza,50261,Torrellas,2,3,-1
2016,Zaragoza,50262,Torres de Berrellén,6,14,-8
2016,Zaragoza,50263,Torrijo de la Cañada,1,6,-5
2016,Zaragoza,50264,Tosos,0,3,-3
2016,Zaragoza,50265,Trasmoz,0,2,-2
2016,Zaragoza,50266,Trasobares,0,4,-4
2016,Zaragoza,50267,Uncastillo,2,10,-8
2016,Zaragoza,50269,Urrea de Jalón,2,6,-4
2016,Zaragoza,50270,Urriés,0,1,-1
2016,Zaragoza,50271,Used,1,3,-2
2016,Zaragoza,50272,Utebo,148,94,54
2016,Zaragoza,50274,Val de San Martín,0,1,-1
2016,Zaragoza,50275,Valmadrid,0,1,-1
2016,Zaragoza,50276,Valpalmas,0,2,-2
2016,Zaragoza,50277,Valtorres,1,6,-5
2016,Zaragoza,50278,Velilla de Ebro,0,2,-2
2016,Zaragoza,50279,Velilla de Jiloca,0,3,-3
2016,Zaragoza,50280,Vera de Moncayo,1,10,-9
2016,Zaragoza,50281,Vierlas,0,3,-3
2016,Zaragoza,50283,Villadoz,1,0,1
2016,Zaragoza,50284,Villafeliche,0,3,-3
2016,Zaragoza,50285,Villafranca de Ebro,8,10,-2
2016,Zaragoza,50286,Villalba de Perejil,0,2,-2
2016,Zaragoza,50287,Villalengua,0,4,-4
2016,Zaragoza,50903,Villamayor de Gállego,14,29,-15
2016,Zaragoza,50288,Villanueva de Gállego,18,40,-22
2016,Zaragoza,50290,Villanueva de Huerva,2,8,-6
2016,Zaragoza,50289,Villanueva de Jiloca,0,1,-1
2016,Zaragoza,50292,Villarreal de Huerva,5,0,5
2016,Zaragoza,50293,Villarroya de la Sierra,3,12,-9
2016,Zaragoza,50294,Villarroya del Campo,0,1,-1
2016,Zaragoza,50295,Vistabella,0,0,0
2016,Zaragoza,50296,Zaida (La),2,7,-5
2016,Zaragoza,50297,Zaragoza,5837,6241,-404
2016,Zaragoza,50298,Zuera,94,65,29
2016,Zaragoza,50099,Épila,46,48,-2
2015,Huesca,22001,Abiego,0,2,-2
2015,Huesca,22002,Abizanda,1,1,0
2015,Huesca,22003,Adahuesca,2,2,0
2015,Huesca,22004,Agüero,0,5,-5
2015,Huesca,22007,Albalate de Cinca,14,13,1
2015,Huesca,22008,Albalatillo,0,2,-2
2015,Huesca,22009,Albelda,4,27,-23
2015,Huesca,22011,Albero Alto,2,1,1
2015,Huesca,22012,Albero Bajo,0,2,-2
2015,Huesca,22013,Alberuela de Tubo,2,2,0
2015,Huesca,22014,Alcalá de Gurrea,0,8,-8
2015,Huesca,22015,Alcalá del Obispo,2,4,-2
2015,Huesca,22016,Alcampell,2,15,-13
2015,Huesca,22017,Alcolea de Cinca,4,7,-3
2015,Huesca,22018,Alcubierre,2,14,-12
2015,Huesca,22019,Alerre,0,3,-3
2015,Huesca,22020,Alfántega,2,3,-1
2015,Huesca,22021,Almudévar,26,36,-10
2015,Huesca,22022,Almunia de San Juan,4,8,-4
2015,Huesca,22023,Almuniente,1,8,-7
2015,Huesca,22024,Alquézar,2,2,0
2015,Huesca,22025,Altorricón,8,12,-4
2015,Huesca,22027,Angüés,2,12,-10
2015,Huesca,22028,Ansó,3,9,-6
2015,Huesca,22029,Antillón,0,2,-2
2015,Huesca,22032,Aragüés del Puerto,1,0,1
2015,Huesca,22036,Argavieso,0,1,-1
2015,Huesca,22037,Arguis,1,1,0
2015,Huesca,22035,Arén,1,4,-3
2015,Huesca,22039,Ayerbe,2,26,-24
2015,Huesca,22040,Azanuy-Alins,2,4,-2
2015,Huesca,22041,Azara,1,3,-2
2015,Huesca,22042,Azlor,0,3,-3
2015,Huesca,22907,Aínsa-Sobrarbe,28,26,2
2015,Huesca,22006,Aísa,0,4,-4
2015,Huesca,22043,Baells,0,2,-2
2015,Huesca,22044,Bailo,1,2,-1
2015,Huesca,22045,Baldellou,0,3,-3
2015,Huesca,22046,Ballobar,9,16,-7
2015,Huesca,22047,Banastás,2,3,-1
2015,Huesca,22048,Barbastro,168,184,-16
2015,Huesca,22049,Barbués,0,1,-1
2015,Huesca,22052,Belver de Cinca,10,31,-21
2015,Huesca,22053,Benabarre,7,29,-22
2015,Huesca,22054,Benasque,14,7,7
2015,Huesca,22246,Beranuy,0,2,-2
2015,Huesca,22055,Berbegal,0,7,-7
2015,Huesca,22057,Bielsa,4,6,-2
2015,Huesca,22058,Bierge,1,2,-1
2015,Huesca,22059,Biescas,9,17,-8
2015,Huesca,22060,Binaced,14,20,-6
2015,Huesca,22061,Binéfar,73,104,-31
2015,Huesca,22062,Bisaurri,2,3,-1
2015,Huesca,22063,Biscarrués,0,3,-3
2015,Huesca,22064,Blecua y Torres,2,1,1
2015,Huesca,22066,Boltaña,10,14,-4
2015,Huesca,22067,Bonansa,1,3,-2
2015,Huesca,22069,Broto,2,7,-5
2015,Huesca,22051,Bárcabo,0,1,-1
2015,Huesca,22072,Caldearenas,2,2,0
2015,Huesca,22074,Campo,0,3,-3
2015,Huesca,22075,Camporrells,1,1,0
2015,Huesca,22076,Canal de Berdún,0,2,-2
2015,Huesca,22077,Candasnos,0,7,-7
2015,Huesca,22078,Canfranc,5,5,0
2015,Huesca,22079,Capdesaso,0,3,-3
2015,Huesca,22080,Capella,1,7,-6
2015,Huesca,22081,Casbas de Huesca,1,4,-3
2015,Huesca,22083,Castejón de Monegros,2,16,-14
2015,Huesca,22084,Castejón de Sos,6,8,-2
2015,Huesca,22082,Castejón del Puente,0,5,-5
2015,Huesca,22085,Castelflorite,0,4,-4
2015,Huesca,22086,Castiello de Jaca,1,5,-4
2015,Huesca,22087,Castigaleu,0,4,-4
2015,Huesca,22088,Castillazuelo,0,6,-6
2015,Huesca,22089,Castillonroy,2,3,-1
2015,Huesca,22094,Chalamera,0,2,-2
2015,Huesca,22096,Chimillas,1,6,-5
2015,Huesca,22095,Chía,1,3,-2
2015,Huesca,22099,Esplús,1,11,-10
2015,Huesca,22102,Estada,0,5,-5
2015,Huesca,22103,Estadilla,5,15,-10
2015,Huesca,22105,Estopiñán del Castillo,1,3,-2
2015,Huesca,22106,Fago,0,0,0
2015,Huesca,22107,Fanlo,1,1,0
2015,Huesca,22109,Fiscal,2,4,-2
2015,Huesca,22110,Fonz,5,13,-8
2015,Huesca,22111,Foradada del Toscar,1,2,-1
2015,Huesca,22112,Fraga,163,146,17
2015,Huesca,22113,Fueva (La),7,7,0
2015,Huesca,22114,Gistaín,0,1,-1
2015,Huesca,22115,Grado (El),0,8,-8
2015,Huesca,22117,Graus,35,54,-19
2015,Huesca,22116,Grañén,5,27,-22
2015,Huesca,22119,Gurrea de Gállego,8,25,-17
2015,Huesca,22122,Hoz de Jaca,0,1,-1
2015,Huesca,22908,Hoz y Costeán,0,4,-4
2015,Huesca,22124,Huerto,2,6,-4
2015,Huesca,22125,Huesca,538,581,-43
2015,Huesca,22126,Ibieca,0,1,-1
2015,Huesca,22127,Igriés,10,13,-3
2015,Huesca,22128,Ilche,2,4,-2
2015,Huesca,22129,Isábena,1,2,-1
2015,Huesca,22130,Jaca,134,164,-30
2015,Huesca,22131,Jasa,0,2,-2
2015,Huesca,22133,Labuerda,3,1,2
2015,Huesca,22135,Laluenga,1,3,-2
2015,Huesca,22136,Lalueza,7,18,-11
2015,Huesca,22137,Lanaja,7,25,-18
2015,Huesca,22139,Laperdiguera,0,2,-2
2015,Huesca,22141,Lascellas-Ponzano,1,3,-2
2015,Huesca,22142,Lascuarre,1,1,0
2015,Huesca,22143,Laspaúles,0,9,-9
2015,Huesca,22144,Laspuña,1,6,-5
2015,Huesca,22149,Loarre,2,5,-3
2015,Huesca,22150,Loporzano,0,6,-6
2015,Huesca,22151,Loscorrales,2,3,-1
2015,Huesca,22905,Lupiñén-Ortilla,1,1,0
2015,Huesca,22155,Monesma y Cajigar,1,3,-2
2015,Huesca,22156,Monflorite-Lascasas,3,3,0
2015,Huesca,22157,Montanuy,0,3,-3
2015,Huesca,22158,Monzón,170,181,-11
2015,Huesca,22160,Naval,2,2,0
2015,Huesca,22162,Novales,0,3,-3
2015,Huesca,22163,Nueno,4,5,-1
2015,Huesca,22164,Olvena,0,1,-1
2015,Huesca,22165,Ontiñena,3,10,-7
2015,Huesca,22167,Osso de Cinca,4,9,-5
2015,Huesca,22170,Panticosa,8,8,0
2015,Huesca,22174,Peralta de Alcofea,3,13,-10
2015,Huesca,22175,Peralta de Calasanz,0,3,-3
2015,Huesca,22176,Peraltilla,3,1,2
2015,Huesca,22177,Perarrúa,0,3,-3
2015,Huesca,22178,Pertusa,0,1,-1
2015,Huesca,22172,Peñalba,3,6,-3
2015,Huesca,22173,Peñas de Riglos (Las),1,1,0
2015,Huesca,22181,Piracés,0,1,-1
2015,Huesca,22182,Plan,2,6,-4
2015,Huesca,22184,Poleñino,3,4,-1
2015,Huesca,22186,Pozán de Vero,2,7,-5
2015,Huesca,22187,Puebla de Castro (La),0,4,-4
2015,Huesca,22188,Puente de Montañana,0,1,-1
2015,Huesca,22902,Puente la Reina de Jaca,3,4,-1
2015,Huesca,22193,Pueyo de Santa Cruz,5,4,1
2015,Huesca,22189,Puértolas,3,3,0
2015,Huesca,22195,Quicena,2,2,0
2015,Huesca,22197,Robres,6,8,-2
2015,Huesca,22199,Sabiñánigo,68,92,-24
2015,Huesca,22200,Sahún,4,3,1
2015,Huesca,22201,Salas Altas,2,8,-6
2015,Huesca,22202,Salas Bajas,0,5,-5
2015,Huesca,22203,Salillas,2,2,0
2015,Huesca,22204,Sallent de Gállego,12,9,3
2015,Huesca,22205,San Esteban de Litera,5,11,-6
2015,Huesca,22207,San Juan de Plan,0,3,-3
2015,Huesca,22903,San Miguel del Cinca,4,14,-10
2015,Huesca,22206,Sangarrén,0,4,-4
2015,Huesca,22208,Santa Cilia,1,0,1
2015,Huesca,22209,Santa Cruz de la Serós,1,1,0
2015,Huesca,22906,Santa María de Dulcis,1,3,-2
2015,Huesca,22212,Santaliestra y San Quílez,0,1,-1
2015,Huesca,22213,Sariñena,38,45,-7
2015,Huesca,22214,Secastilla,1,4,-3
2015,Huesca,22215,Seira,0,2,-2
2015,Huesca,22217,Sena,2,5,-3
2015,Huesca,22220,Sesa,0,5,-5
2015,Huesca,22221,Sesué,1,3,-2
2015,Huesca,22222,Siétamo,6,4,2
2015,Huesca,22904,Sotonera (La),4,17,-13
2015,Huesca,22225,Tamarite de Litera,21,59,-38
2015,Huesca,22226,Tardienta,10,20,-10
2015,Huesca,22227,Tella-Sin,1,3,-2
2015,Huesca,22228,Tierz,8,2,6
2015,Huesca,22229,Tolva,0,4,-4
2015,Huesca,22230,Torla-Ordesa,4,2,2
2015,Huesca,22233,Torre la Ribera,0,0,0
2015,Huesca,22234,Torrente de Cinca,1,10,-9
2015,Huesca,22235,Torres de Alcanadre,0,4,-4
2015,Huesca,22236,Torres de Barbués,1,9,-8
2015,Huesca,22242,Valfarta,0,2,-2
2015,Huesca,22901,Valle de Hecho,5,12,-7
2015,Huesca,22245,Velilla de Cinca,2,5,-3
2015,Huesca,22909,Vencillón,0,3,-3
2015,Huesca,22249,Villanova,2,0,2
2015,Huesca,22251,Villanueva de Sigena,0,6,-6
2015,Huesca,22250,Villanúa,3,1,2
2015,Huesca,22252,Yebra de Basa,0,2,-2
2015,Huesca,22253,Yésero,0,0,0
2015,Huesca,22254,Zaidín,11,17,-6
2015,Teruel,44004,Aguaviva,4,7,-3
2015,Teruel,44005,Aguilar del Alfambra,2,2,0
2015,Teruel,44006,Alacón,0,6,-6
2015,Teruel,44007,Alba,1,7,-6
2015,Teruel,44008,Albalate del Arzobispo,15,28,-13
2015,Teruel,44009,Albarracín,8,17,-9
2015,Teruel,44010,Albentosa,1,3,-2
2015,Teruel,44011,Alcaine,1,3,-2
2015,Teruel,44012,Alcalá de la Selva,0,0,0
2015,Teruel,44013,Alcañiz,156,148,8
2015,Teruel,44014,Alcorisa,29,37,-8
2015,Teruel,44016,Alfambra,2,5,-3
2015,Teruel,44017,Aliaga,1,2,-1
2015,Teruel,44021,Allepuz,0,0,0
2015,Teruel,44022,Alloza,4,8,-4
2015,Teruel,44019,Alobras,0,4,-4
2015,Teruel,44025,Andorra,43,77,-34
2015,Teruel,44026,Arcos de las Salinas,0,1,-1
2015,Teruel,44027,Arens de Lledó,1,4,-3
2015,Teruel,44028,Argente,0,4,-4
2015,Teruel,44029,Ariño,7,15,-8
2015,Teruel,44031,Azaila,0,2,-2
2015,Teruel,44035,Barrachina,0,1,-1
2015,Teruel,44037,Beceite,7,4,3
2015,Teruel,44039,Bello,0,1,-1
2015,Teruel,44038,Belmonte de San José,0,5,-5
2015,Teruel,44040,Berge,6,0,6
2015,Teruel,44041,Bezas,0,3,-3
2015,Teruel,44042,Blancas,0,1,-1
2015,Teruel,44043,Blesa,0,2,-2
2015,Teruel,44044,Bordón,1,1,0
2015,Teruel,44045,Bronchales,1,4,-3
2015,Teruel,44046,Bueña,0,1,-1
2015,Teruel,44047,Burbáguena,0,12,-12
2015,Teruel,44032,Bádenas,0,1,-1
2015,Teruel,44033,Báguena,0,9,-9
2015,Teruel,44048,Cabra de Mora,0,2,-2
2015,Teruel,44049,Calaceite,7,10,-3
2015,Teruel,44050,Calamocha,30,69,-39
2015,Teruel,44051,Calanda,23,45,-22
2015,Teruel,44052,Calomarde,0,1,-1
2015,Teruel,44054,Camarena de la Sierra,2,3,-1
2015,Teruel,44055,Camarillas,0,2,-2
2015,Teruel,44053,Camañas,1,3,-2
2015,Teruel,44056,Caminreal,0,17,-17
2015,Teruel,44059,Cantavieja,4,8,-4
2015,Teruel,44064,Cascante del Río,0,2,-2
2015,Teruel,44065,Castejón de Tornos,0,1,-1
2015,Teruel,44066,Castel de Cabra,1,2,-1
2015,Teruel,44070,Castellar (El),0,2,-2
2015,Teruel,44071,Castellote,2,11,-9
2015,Teruel,44067,Castelnou,2,5,-3
2015,Teruel,44068,Castelserás,2,14,-12
2015,Teruel,44061,Cañada de Verich (La),0,2,-2
2015,Teruel,44062,Cañada Vellida,0,1,-1
2015,Teruel,44063,Cañizar del Olivar,2,0,2
2015,Teruel,44074,Cedrillas,5,6,-1
2015,Teruel,44075,Celadas,2,8,-6
2015,Teruel,44076,Cella,18,45,-27
2015,Teruel,44077,Cerollera (La),0,6,-6
2015,Teruel,44080,Codoñera (La),0,3,-3
2015,Teruel,44084,Cortes de Aragón,1,3,-2
2015,Teruel,44085,Cosa,0,1,-1
2015,Teruel,44086,Cretas,5,8,-3
2015,Teruel,44087,Crivillén,0,1,-1
2015,Teruel,44088,Cuba (La),1,1,0
2015,Teruel,44089,Cubla,0,2,-2
2015,Teruel,44092,Cuervo (El),0,1,-1
2015,Teruel,44093,Cuevas de Almudén,0,3,-3
2015,Teruel,44094,Cuevas Labradas,1,5,-4
2015,Teruel,44096,Ejulve,0,2,-2
2015,Teruel,44097,Escorihuela,0,3,-3
2015,Teruel,44099,Escucha,12,7,5
2015,Teruel,44100,Estercuel,1,6,-5
2015,Teruel,44103,Formiche Alto,0,0,0
2015,Teruel,44106,Fortanete,2,3,-1
2015,Teruel,44107,Foz-Calanda,1,4,-3
2015,Teruel,44108,Fresneda (La),3,7,-4
2015,Teruel,44110,Fuenferrada,0,2,-2
2015,Teruel,44111,Fuentes Calientes,2,2,0
2015,Teruel,44112,Fuentes Claras,5,14,-9
2015,Teruel,44113,Fuentes de Rubielos,0,2,-2
2015,Teruel,44114,Fuentespalda,2,3,-1
2015,Teruel,44105,Fórnoles,0,2,-2
2015,Teruel,44115,Galve,0,4,-4
2015,Teruel,44116,Gargallo,0,1,-1
2015,Teruel,44117,Gea de Albarracín,1,6,-5
2015,Teruel,44118,Ginebrosa (La),1,4,-3
2015,Teruel,44119,Griegos,0,3,-3
2015,Teruel,44120,Guadalaviar,1,4,-3
2015,Teruel,44121,Gúdar,1,1,0
2015,Teruel,44123,Hinojosa de Jarque,0,1,-1
2015,Teruel,44124,Hoz de la Vieja (La),1,2,-1
2015,Teruel,44125,Huesa del Común,0,4,-4
2015,Teruel,44122,Híjar,6,28,-22
2015,Teruel,44126,Iglesuela del Cid (La),2,11,-9
2015,Teruel,44128,Jarque de la Val,0,3,-3
2015,Teruel,44130,Jorcas,1,2,-1
2015,Teruel,44131,Josa,0,1,-1
2015,Teruel,44132,Lagueruela,2,0,2
2015,Teruel,44135,Libros,0,4,-4
2015,Teruel,44136,Lidón,0,1,-1
2015,Teruel,44137,Linares de Mora,0,4,-4
2015,Teruel,44141,Lledó,0,0,0
2015,Teruel,44138,Loscos,0,4,-4
2015,Teruel,44143,Manzanera,4,5,-1
2015,Teruel,44144,Martín del Río,2,5,-3
2015,Teruel,44145,Mas de las Matas,8,17,-9
2015,Teruel,44146,Mata de los Olmos (La),1,2,-1
2015,Teruel,44147,Mazaleón,1,8,-7
2015,Teruel,44148,Mezquita de Jarque,0,2,-2
2015,Teruel,44149,Mirambel,0,3,-3
2015,Teruel,44151,Molinos,0,4,-4
2015,Teruel,44152,Monforte de Moyuela,0,1,-1
2015,Teruel,44153,Monreal del Campo,31,53,-22
2015,Teruel,44154,Monroyo,2,3,-1
2015,Teruel,44155,Montalbán,9,21,-12
2015,Teruel,44157,Monterde de Albarracín,0,3,-3
2015,Teruel,44158,Mora de Rubielos,11,23,-12
2015,Teruel,44160,Mosqueruela,6,7,-1
2015,Teruel,44161,Muniesa,4,12,-8
2015,Teruel,44163,Noguera de Albarracín,0,1,-1
2015,Teruel,44165,Nogueruelas,1,2,-1
2015,Teruel,44167,Obón,0,3,-3
2015,Teruel,44169,Ojos Negros,3,6,-3
2015,Teruel,44171,Olba,1,3,-2
2015,Teruel,44172,Oliete,2,7,-5
2015,Teruel,44173,Olmos (Los),1,1,0
2015,Teruel,44174,Orihuela del Tremedal,1,5,-4
2015,Teruel,44175,Orrios,0,3,-3
2015,Teruel,44176,Palomar de Arroyos,3,3,0
2015,Teruel,44177,Pancrudo,0,4,-4
2015,Teruel,44181,Peralejos,1,6,-5
2015,Teruel,44182,Perales del Alfambra,1,5,-4
2015,Teruel,44179,Peñarroya de Tastavins,2,8,-6
2015,Teruel,44183,Pitarque,0,2,-2
2015,Teruel,44185,Pobo (El),1,0,1
2015,Teruel,44187,Portellada (La),1,3,-2
2015,Teruel,44189,Pozondón,0,3,-3
2015,Teruel,44190,Pozuel del Campo,0,4,-4
2015,Teruel,44191,Puebla de Híjar (La),5,6,-1
2015,Teruel,44192,Puebla de Valverde (La),3,7,-4
2015,Teruel,44193,Puertomingalvo,0,5,-5
2015,Teruel,44195,Rillo,0,5,-5
2015,Teruel,44196,Riodeva,0,5,-5
2015,Teruel,44198,Royuela,0,6,-6
2015,Teruel,44201,Rubielos de Mora,3,6,-3
2015,Teruel,44194,Ráfales,3,2,1
2015,Teruel,44197,Ródenas,1,3,-2
2015,Teruel,44205,Samper de Calanda,5,13,-8
2015,Teruel,44206,San Agustín,0,3,-3
2015,Teruel,44207,San Martín del Río,0,4,-4
2015,Teruel,44208,Santa Cruz de Nogueras,0,1,-1
2015,Teruel,44209,Santa Eulalia,3,16,-13
2015,Teruel,44210,Sarrión,17,14,3
2015,Teruel,44211,Segura de los Baños,0,1,-1
2015,Teruel,44212,Seno,0,3,-3
2015,Teruel,44213,Singra,0,3,-3
2015,Teruel,44215,Terriente,0,4,-4
2015,Teruel,44216,Teruel,325,338,-13
2015,Teruel,44218,Tormón,0,1,-1
2015,Teruel,44219,Tornos,0,6,-6
2015,Teruel,44220,Torralba de los Sisones,1,2,-1
2015,Teruel,44224,Torre de las Arcas,0,1,-1
2015,Teruel,44225,Torre del Compte,1,7,-6
2015,Teruel,44221,Torrecilla de Alcañiz,1,3,-2
2015,Teruel,44222,Torrecilla del Rebollar,0,1,-1
2015,Teruel,44226,Torrelacárcel,1,5,-4
2015,Teruel,44228,Torremocha de Jiloca,0,2,-2
2015,Teruel,44229,Torres de Albarracín,0,5,-5
2015,Teruel,44230,Torrevelilla,1,1,0
2015,Teruel,44232,Torrijo del Campo,1,6,-5
2015,Teruel,44234,Tramacastiel,0,1,-1
2015,Teruel,44235,Tramacastilla,0,3,-3
2015,Teruel,44236,Tronchón,0,3,-3
2015,Teruel,44237,Urrea de Gaén,0,9,-9
2015,Teruel,44238,Utrillas,20,38,-18
2015,Teruel,44239,Valacloche,0,1,-1
2015,Teruel,44240,Valbona,1,5,-4
2015,Teruel,44241,Valdealgorfa,2,11,-9
2015,Teruel,44243,Valdecuenca,0,1,-1
2015,Teruel,44244,Valdelinares,1,1,0
2015,Teruel,44245,Valdeltormo,1,10,-9
2015,Teruel,44246,Valderrobres,22,27,-5
2015,Teruel,44247,Valjunquera,2,5,-3
2015,Teruel,44250,Veguillas de la Sierra,0,1,-1
2015,Teruel,44251,Villafranca del Campo,2,4,-2
2015,Teruel,44252,Villahermosa del Campo,0,2,-2
2015,Teruel,44257,Villar del Cobo,2,4,-2
2015,Teruel,44258,Villar del Salz,1,1,0
2015,Teruel,44260,Villarluengo,2,3,-1
2015,Teruel,44261,Villarquemado,6,16,-10
2015,Teruel,44262,Villarroya de los Pinares,0,3,-3
2015,Teruel,44263,Villastar,6,4,2
2015,Teruel,44264,Villel,5,5,0
2015,Teruel,44265,Vinaceite,2,3,-1
2015,Teruel,44267,Vivel del Río Martín,0,4,-4
2015,Zaragoza,50001,Abanto,0,3,-3
2015,Zaragoza,50002,Acered,0,4,-4
2015,Zaragoza,50004,Aguarón,4,18,-14
2015,Zaragoza,50005,Aguilón,0,2,-2
2015,Zaragoza,50003,Agón,1,3,-2
2015,Zaragoza,50006,Ainzón,5,15,-10
2015,Zaragoza,50008,Alagón,58,75,-17
2015,Zaragoza,50009,Alarba,0,1,-1
2015,Zaragoza,50010,Alberite de San Juan,0,2,-2
2015,Zaragoza,50011,Albeta,0,1,-1
2015,Zaragoza,50012,Alborge,0,2,-2
2015,Zaragoza,50013,Alcalá de Ebro,1,5,-4
2015,Zaragoza,50014,Alcalá de Moncayo,0,2,-2
2015,Zaragoza,50015,Alconchel de Ariza,1,1,0
2015,Zaragoza,50016,Aldehuela de Liestos,0,2,-2
2015,Zaragoza,50017,Alfajarín,18,14,4
2015,Zaragoza,50018,Alfamén,15,17,-2
2015,Zaragoza,50020,Alhama de Aragón,5,17,-12
2015,Zaragoza,50021,Almochuel,0,1,-1
2015,Zaragoza,50022,Almolda (La),2,14,-12
2015,Zaragoza,50023,Almonacid de la Cuba,2,1,1
2015,Zaragoza,50024,Almonacid de la Sierra,1,15,-14
2015,Zaragoza,50025,Almunia de Doña Godina (La),77,85,-8
2015,Zaragoza,50026,Alpartir,3,6,-3
2015,Zaragoza,50027,Ambel,4,5,-1
2015,Zaragoza,50029,Aniñón,4,14,-10
2015,Zaragoza,50031,Aranda de Moncayo,1,6,-5
2015,Zaragoza,50034,Ariza,4,17,-13
2015,Zaragoza,50035,Artieda,0,1,-1
2015,Zaragoza,50032,Arándiga,2,6,-4
2015,Zaragoza,50036,Asín,0,3,-3
2015,Zaragoza,50037,Atea,0,2,-2
2015,Zaragoza,50038,Ateca,9,31,-22
2015,Zaragoza,50039,Azuara,0,9,-9
2015,Zaragoza,50030,Añón de Moncayo,0,7,-7
2015,Zaragoza,50040,Badules,0,2,-2
2015,Zaragoza,50042,Balconchán,0,1,-1
2015,Zaragoza,50044,Bardallur,1,1,0
2015,Zaragoza,50045,Belchite,7,31,-24
2015,Zaragoza,50046,Belmonte de Gracián,0,1,-1
2015,Zaragoza,50047,Berdejo,0,0,0
2015,Zaragoza,50048,Berrueco,0,0,0
2015,Zaragoza,50901,Biel,0,2,-2
2015,Zaragoza,50050,Bijuesca,1,0,1
2015,Zaragoza,50051,Biota,2,17,-15
2015,Zaragoza,50053,Boquiñeni,3,15,-12
2015,Zaragoza,50054,Bordalba,0,1,-1
2015,Zaragoza,50055,Borja,57,59,-2
2015,Zaragoza,50056,Botorrita,5,5,0
2015,Zaragoza,50057,Brea de Aragón,11,19,-8
2015,Zaragoza,50058,Bubierca,0,3,-3
2015,Zaragoza,50059,Bujaraloz,2,9,-7
2015,Zaragoza,50060,Bulbuente,1,3,-2
2015,Zaragoza,50061,Bureta,0,6,-6
2015,Zaragoza,50062,Burgo de Ebro (El),15,13,2
2015,Zaragoza,50063,Buste (El),1,0,1
2015,Zaragoza,50043,Bárboles,0,1,-1
2015,Zaragoza,50064,Cabañas de Ebro,3,11,-8
2015,Zaragoza,50065,Cabolafuente,0,4,-4
2015,Zaragoza,50066,Cadrete,42,25,17
2015,Zaragoza,50067,Calatayud,149,231,-82
2015,Zaragoza,50068,Calatorao,31,33,-2
2015,Zaragoza,50069,Calcena,0,4,-4
2015,Zaragoza,50070,Calmarza,1,4,-3
2015,Zaragoza,50071,Campillo de Aragón,1,1,0
2015,Zaragoza,50072,Carenas,1,3,-2
2015,Zaragoza,50073,Cariñena,30,35,-5
2015,Zaragoza,50074,Caspe,112,101,11
2015,Zaragoza,50075,Castejón de Alarba,0,3,-3
2015,Zaragoza,50076,Castejón de las Armas,0,2,-2
2015,Zaragoza,50077,Castejón de Valdejasa,0,4,-4
2015,Zaragoza,50078,Castiliscar,1,3,-2
2015,Zaragoza,50079,Cervera de la Cañada,1,2,-1
2015,Zaragoza,50081,Cetina,4,16,-12
2015,Zaragoza,50092,Chiprana,9,10,-1
2015,Zaragoza,50093,Chodes,1,3,-2
2015,Zaragoza,50082,Cimballa,0,2,-2
2015,Zaragoza,50084,Clarés de Ribota,0,4,-4
2015,Zaragoza,50085,Codo,0,3,-3
2015,Zaragoza,50086,Codos,0,12,-12
2015,Zaragoza,50088,Cosuenda,1,8,-7
2015,Zaragoza,50089,Cuarte de Huerva,237,33,204
2015,Zaragoza,50090,Cubel,0,6,-6
2015,Zaragoza,50091,Cuerlas (Las),0,2,-2
2015,Zaragoza,50094,Daroca,12,42,-30
2015,Zaragoza,50095,Ejea de los Caballeros,118,164,-46
2015,Zaragoza,50098,Encinacorba,0,4,-4
2015,Zaragoza,50100,Erla,0,7,-7
2015,Zaragoza,50101,Escatrón,10,23,-13
2015,Zaragoza,50102,Fabara,2,12,-10
2015,Zaragoza,50104,Farlete,0,5,-5
2015,Zaragoza,50106,Fayos (Los),0,4,-4
2015,Zaragoza,50105,Fayón,6,6,0
2015,Zaragoza,50107,Figueruelas,10,24,-14
2015,Zaragoza,50110,Frasno (El),0,7,-7
2015,Zaragoza,50111,Fréscano,3,3,0
2015,Zaragoza,50113,Fuendejalón,5,11,-6
2015,Zaragoza,50114,Fuendetodos,0,5,-5
2015,Zaragoza,50115,Fuentes de Ebro,43,50,-7
2015,Zaragoza,50116,Fuentes de Jiloca,0,7,-7
2015,Zaragoza,50117,Gallocanta,0,3,-3
2015,Zaragoza,50118,Gallur,14,45,-31
2015,Zaragoza,50119,Gelsa,5,17,-12
2015,Zaragoza,50120,Godojos,0,3,-3
2015,Zaragoza,50121,Gotor,0,1,-1
2015,Zaragoza,50122,Grisel,1,2,-1
2015,Zaragoza,50123,Grisén,3,9,-6
2015,Zaragoza,50124,Herrera de los Navarros,1,11,-10
2015,Zaragoza,50125,Ibdes,1,8,-7
2015,Zaragoza,50126,Illueca,14,35,-21
2015,Zaragoza,50128,Isuerre,0,2,-2
2015,Zaragoza,50129,Jaraba,2,4,-2
2015,Zaragoza,50130,Jarque de Moncayo,2,10,-8
2015,Zaragoza,50131,Jaulín,0,8,-8
2015,Zaragoza,50132,Joyosa (La),17,6,11
2015,Zaragoza,50133,Lagata,2,3,-1
2015,Zaragoza,50134,Langa del Castillo,0,1,-1
2015,Zaragoza,50135,Layana,0,1,-1
2015,Zaragoza,50138,Lechón,0,2,-2
2015,Zaragoza,50137,Leciñena,13,17,-4
2015,Zaragoza,50139,Letux,0,3,-3
2015,Zaragoza,50140,Litago,0,2,-2
2015,Zaragoza,50141,Lituénigo,1,2,-1
2015,Zaragoza,50142,Lobera de Onsella,0,2,-2
2015,Zaragoza,50143,Longares,4,10,-6
2015,Zaragoza,50146,Lucena de Jalón,3,8,-5
2015,Zaragoza,50147,Luceni,10,23,-13
2015,Zaragoza,50148,Luesia,0,11,-11
2015,Zaragoza,50150,Lumpiaque,6,16,-10
2015,Zaragoza,50151,Luna,2,16,-14
2015,Zaragoza,50136,Lécera,6,11,-5
2015,Zaragoza,50152,Maella,16,40,-24
2015,Zaragoza,50153,Magallón,1,12,-11
2015,Zaragoza,50154,Mainar,0,3,-3
2015,Zaragoza,50155,Malanquilla,0,2,-2
2015,Zaragoza,50156,Maleján,1,6,-5
2015,Zaragoza,50160,Mallén,27,26,1
2015,Zaragoza,50159,Maluenda,3,19,-16
2015,Zaragoza,50157,Malón,1,13,-12
2015,Zaragoza,50161,Manchones,0,1,-1
2015,Zaragoza,50162,Mara,1,3,-2
2015,Zaragoza,50902,Marracos,0,2,-2
2015,Zaragoza,50163,María de Huerva,87,21,66
2015,Zaragoza,50164,Mediana de Aragón,1,7,-6
2015,Zaragoza,50165,Mequinenza,22,27,-5
2015,Zaragoza,50166,Mesones de Isuela,0,5,-5
2015,Zaragoza,50167,Mezalocha,0,4,-4
2015,Zaragoza,50169,Miedes de Aragón,2,13,-11
2015,Zaragoza,50170,Monegrillo,2,12,-10
2015,Zaragoza,50171,Moneva,0,1,-1
2015,Zaragoza,50172,Monreal de Ariza,1,8,-7
2015,Zaragoza,50173,Monterde,0,2,-2
2015,Zaragoza,50175,Morata de Jalón,5,19,-14
2015,Zaragoza,50176,Morata de Jiloca,1,4,-3
2015,Zaragoza,50178,Moros,1,8,-7
2015,Zaragoza,50177,Morés,3,8,-5
2015,Zaragoza,50179,Moyuela,0,5,-5
2015,Zaragoza,50180,Mozota,0,1,-1
2015,Zaragoza,50181,Muel,10,21,-11
2015,Zaragoza,50182,Muela (La),74,24,50
2015,Zaragoza,50183,Munébrega,2,9,-7
2015,Zaragoza,50184,Murero,0,0,0
2015,Zaragoza,50185,Murillo de Gállego,0,0,0
2015,Zaragoza,50187,Nigüella,0,3,-3
2015,Zaragoza,50189,Nonaspe,2,17,-15
2015,Zaragoza,50190,Novallas,1,12,-11
2015,Zaragoza,50191,Novillas,1,10,-9
2015,Zaragoza,50193,Nuez de Ebro,12,3,9
2015,Zaragoza,50192,Nuévalos,5,3,2
2015,Zaragoza,50196,Orera,0,2,-2
2015,Zaragoza,50197,Orés,0,2,-2
2015,Zaragoza,50199,Osera de Ebro,1,10,-9
2015,Zaragoza,50200,Paniza,0,8,-8
2015,Zaragoza,50201,Paracuellos de Jiloca,8,12,-4
2015,Zaragoza,50202,Paracuellos de la Ribera,0,3,-3
2015,Zaragoza,50203,Pastriz,11,19,-8
2015,Zaragoza,50204,Pedrola,28,27,1
2015,Zaragoza,50205,Pedrosas (Las),0,2,-2
2015,Zaragoza,50206,Perdiguera,5,6,-1
2015,Zaragoza,50207,Piedratajada,0,1,-1
2015,Zaragoza,50208,Pina de Ebro,10,15,-5
2015,Zaragoza,50209,Pinseque,60,69,-9
2015,Zaragoza,50210,Pintanos (Los),0,1,-1
2015,Zaragoza,50211,Plasencia de Jalón,1,3,-2
2015,Zaragoza,50212,Pleitas,0,1,-1
2015,Zaragoza,50213,Plenas,0,3,-3
2015,Zaragoza,50214,Pomer,0,1,-1
2015,Zaragoza,50215,Pozuel de Ariza,0,2,-2
2015,Zaragoza,50216,Pozuelo de Aragón,1,6,-5
2015,Zaragoza,50217,Pradilla de Ebro,3,9,-6
2015,Zaragoza,50218,Puebla de Albortón,0,3,-3
2015,Zaragoza,50219,Puebla de Alfindén (La),90,28,62
2015,Zaragoza,50220,Puendeluna,0,2,-2
2015,Zaragoza,50222,Quinto,13,25,-12
2015,Zaragoza,50223,Remolinos,1,17,-16
2015,Zaragoza,50224,Retascón,0,1,-1
2015,Zaragoza,50225,Ricla,20,28,-8
2015,Zaragoza,50227,Romanos,0,2,-2
2015,Zaragoza,50228,Rueda de Jalón,1,2,-1
2015,Zaragoza,50229,Ruesca,0,1,-1
2015,Zaragoza,50231,Salillas de Jalón,2,7,-5
2015,Zaragoza,50232,Salvatierra de Esca,1,2,-1
2015,Zaragoza,50233,Samper del Salz,0,2,-2
2015,Zaragoza,50234,San Martín de la Virgen de Moncayo,2,4,-2
2015,Zaragoza,50235,San Mateo de Gállego,29,29,0
2015,Zaragoza,50236,Santa Cruz de Grío,0,3,-3
2015,Zaragoza,50237,Santa Cruz de Moncayo,0,1,-1
2015,Zaragoza,50238,Santa Eulalia de Gállego,0,2,-2
2015,Zaragoza,50239,Santed,0,1,-1
2015,Zaragoza,50241,Saviñán,1,21,-20
2015,Zaragoza,50243,Sestrica,0,8,-8
2015,Zaragoza,50244,Sierra de Luna,0,1,-1
2015,Zaragoza,50245,Sigüés,0,3,-3
2015,Zaragoza,50246,Sisamón,0,1,-1
2015,Zaragoza,50247,Sobradiel,10,12,-2
2015,Zaragoza,50248,Sos del Rey Católico,3,4,-1
2015,Zaragoza,50230,Sádaba,2,32,-30
2015,Zaragoza,50240,Sástago,9,28,-19
2015,Zaragoza,50249,Tabuenca,2,3,-1
2015,Zaragoza,50250,Talamantes,0,2,-2
2015,Zaragoza,50251,Tarazona,72,107,-35
2015,Zaragoza,50252,Tauste,46,90,-44
2015,Zaragoza,50253,Terrer,1,13,-12
2015,Zaragoza,50254,Tierga,1,3,-2
2015,Zaragoza,50255,Tobed,0,6,-6
2015,Zaragoza,50256,Torralba de los Frailes,0,2,-2
2015,Zaragoza,50257,Torralba de Ribota,0,3,-3
2015,Zaragoza,50258,Torralbilla,0,2,-2
2015,Zaragoza,50259,Torrehermosa,0,2,-2
2015,Zaragoza,50261,Torrellas,1,10,-9
2015,Zaragoza,50262,Torres de Berrellén,12,16,-4
2015,Zaragoza,50263,Torrijo de la Cañada,0,5,-5
2015,Zaragoza,50264,Tosos,1,10,-9
2015,Zaragoza,50265,Trasmoz,0,3,-3
2015,Zaragoza,50266,Trasobares,0,2,-2
2015,Zaragoza,50267,Uncastillo,0,17,-17
2015,Zaragoza,50268,Undués de Lerda,2,0,2
2015,Zaragoza,50269,Urrea de Jalón,3,7,-4
2015,Zaragoza,50270,Urriés,1,2,-1
2015,Zaragoza,50271,Used,0,5,-5
2015,Zaragoza,50272,Utebo,171,80,91
2015,Zaragoza,50274,Val de San Martín,0,2,-2
2015,Zaragoza,50273,Valdehorna,0,1,-1
2015,Zaragoza,50275,Valmadrid,0,3,-3
2015,Zaragoza,50276,Valpalmas,0,2,-2
2015,Zaragoza,50277,Valtorres,0,3,-3
2015,Zaragoza,50278,Velilla de Ebro,0,4,-4
2015,Zaragoza,50279,Velilla de Jiloca,1,4,-3
2015,Zaragoza,50280,Vera de Moncayo,3,3,0
2015,Zaragoza,50281,Vierlas,3,2,1
2015,Zaragoza,50283,Villadoz,0,1,-1
2015,Zaragoza,50284,Villafeliche,0,7,-7
2015,Zaragoza,50285,Villafranca de Ebro,7,10,-3
2015,Zaragoza,50286,Villalba de Perejil,1,0,1
2015,Zaragoza,50287,Villalengua,1,4,-3
2015,Zaragoza,50903,Villamayor de Gállego,11,27,-16
2015,Zaragoza,50288,Villanueva de Gállego,43,38,5
2015,Zaragoza,50290,Villanueva de Huerva,1,11,-10
2015,Zaragoza,50289,Villanueva de Jiloca,0,2,-2
2015,Zaragoza,50291,Villar de los Navarros,0,3,-3
2015,Zaragoza,50292,Villarreal de Huerva,2,3,-1
2015,Zaragoza,50293,Villarroya de la Sierra,0,17,-17
2015,Zaragoza,50294,Villarroya del Campo,0,3,-3
2015,Zaragoza,50282,Vilueña (La),0,1,-1
2015,Zaragoza,50295,Vistabella,0,2,-2
2015,Zaragoza,50296,Zaida (La),1,3,-2
2015,Zaragoza,50297,Zaragoza,6107,6448,-341
2015,Zaragoza,50298,Zuera,88,82,6
2015,Zaragoza,50099,Épila,57,53,4
2014,Huesca,22001,Abiego,0,4,-4
2014,Huesca,22002,Abizanda,1,1,0
2014,Huesca,22003,Adahuesca,3,1,2
2014,Huesca,22004,Agüero,0,4,-4
2014,Huesca,22007,Albalate de Cinca,11,12,-1
2014,Huesca,22008,Albalatillo,0,4,-4
2014,Huesca,22009,Albelda,3,10,-7
2014,Huesca,22011,Albero Alto,1,1,0
2014,Huesca,22012,Albero Bajo,1,0,1
2014,Huesca,22013,Alberuela de Tubo,1,4,-3
2014,Huesca,22014,Alcalá de Gurrea,1,3,-2
2014,Huesca,22015,Alcalá del Obispo,4,4,0
2014,Huesca,22016,Alcampell,1,7,-6
2014,Huesca,22017,Alcolea de Cinca,9,25,-16
2014,Huesca,22018,Alcubierre,2,5,-3
2014,Huesca,22019,Alerre,0,3,-3
2014,Huesca,22020,Alfántega,1,2,-1
2014,Huesca,22021,Almudévar,24,36,-12
2014,Huesca,22022,Almunia de San Juan,6,10,-4
2014,Huesca,22023,Almuniente,2,5,-3
2014,Huesca,22024,Alquézar,0,2,-2
2014,Huesca,22025,Altorricón,11,12,-1
2014,Huesca,22027,Angüés,0,6,-6
2014,Huesca,22028,Ansó,1,10,-9
2014,Huesca,22032,Aragüés del Puerto,0,4,-4
2014,Huesca,22036,Argavieso,0,1,-1
2014,Huesca,22037,Arguis,0,1,-1
2014,Huesca,22035,Arén,1,1,0
2014,Huesca,22039,Ayerbe,9,16,-7
2014,Huesca,22040,Azanuy-Alins,1,4,-3
2014,Huesca,22041,Azara,1,2,-1
2014,Huesca,22042,Azlor,0,2,-2
2014,Huesca,22907,Aínsa-Sobrarbe,27,25,2
2014,Huesca,22006,Aísa,2,2,0
2014,Huesca,22043,Baells,1,2,-1
2014,Huesca,22044,Bailo,0,4,-4
2014,Huesca,22045,Baldellou,0,1,-1
2014,Huesca,22046,Ballobar,9,16,-7
2014,Huesca,22047,Banastás,2,1,1
2014,Huesca,22048,Barbastro,146,197,-51
2014,Huesca,22049,Barbués,0,1,-1
2014,Huesca,22050,Barbuñales,0,1,-1
2014,Huesca,22052,Belver de Cinca,10,37,-27
2014,Huesca,22053,Benabarre,6,23,-17
2014,Huesca,22054,Benasque,12,14,-2
2014,Huesca,22246,Beranuy,1,1,0
2014,Huesca,22055,Berbegal,0,9,-9
2014,Huesca,22057,Bielsa,6,5,1
2014,Huesca,22058,Bierge,3,3,0
2014,Huesca,22059,Biescas,8,18,-10
2014,Huesca,22060,Binaced,8,24,-16
2014,Huesca,22061,Binéfar,76,86,-10
2014,Huesca,22062,Bisaurri,0,1,-1
2014,Huesca,22063,Biscarrués,0,2,-2
2014,Huesca,22064,Blecua y Torres,1,1,0
2014,Huesca,22066,Boltaña,12,8,4
2014,Huesca,22068,Borau,1,0,1
2014,Huesca,22069,Broto,5,6,-1
2014,Huesca,22072,Caldearenas,0,3,-3
2014,Huesca,22074,Campo,1,5,-4
2014,Huesca,22075,Camporrells,0,4,-4
2014,Huesca,22076,Canal de Berdún,1,2,-1
2014,Huesca,22077,Candasnos,0,5,-5
2014,Huesca,22078,Canfranc,0,4,-4
2014,Huesca,22079,Capdesaso,0,5,-5
2014,Huesca,22080,Capella,1,4,-3
2014,Huesca,22081,Casbas de Huesca,0,7,-7
2014,Huesca,22083,Castejón de Monegros,1,8,-7
2014,Huesca,22084,Castejón de Sos,3,3,0
2014,Huesca,22082,Castejón del Puente,2,3,-1
2014,Huesca,22085,Castelflorite,0,2,-2
2014,Huesca,22086,Castiello de Jaca,0,3,-3
2014,Huesca,22088,Castillazuelo,0,4,-4
2014,Huesca,22089,Castillonroy,1,8,-7
2014,Huesca,22094,Chalamera,0,1,-1
2014,Huesca,22096,Chimillas,1,9,-8
2014,Huesca,22095,Chía,0,2,-2
2014,Huesca,22090,Colungo,0,2,-2
2014,Huesca,22099,Esplús,4,5,-1
2014,Huesca,22102,Estada,1,1,0
2014,Huesca,22103,Estadilla,4,15,-11
2014,Huesca,22105,Estopiñán del Castillo,0,1,-1
2014,Huesca,22107,Fanlo,1,1,0
2014,Huesca,22109,Fiscal,0,2,-2
2014,Huesca,22110,Fonz,3,16,-13
2014,Huesca,22111,Foradada del Toscar,0,1,-1
2014,Huesca,22112,Fraga,154,140,14
2014,Huesca,22113,Fueva (La),4,11,-7
2014,Huesca,22114,Gistaín,1,3,-2
2014,Huesca,22115,Grado (El),2,6,-4
2014,Huesca,22117,Graus,21,55,-34
2014,Huesca,22116,Grañén,3,29,-26
2014,Huesca,22119,Gurrea de Gállego,3,20,-17
2014,Huesca,22122,Hoz de Jaca,0,2,-2
2014,Huesca,22908,Hoz y Costeán,0,3,-3
2014,Huesca,22124,Huerto,0,5,-5
2014,Huesca,22125,Huesca,511,526,-15
2014,Huesca,22126,Ibieca,0,4,-4
2014,Huesca,22127,Igriés,7,6,1
2014,Huesca,22128,Ilche,0,4,-4
2014,Huesca,22129,Isábena,0,5,-5
2014,Huesca,22130,Jaca,100,112,-12
2014,Huesca,22131,Jasa,0,2,-2
2014,Huesca,22133,Labuerda,0,1,-1
2014,Huesca,22135,Laluenga,0,4,-4
2014,Huesca,22136,Lalueza,5,16,-11
2014,Huesca,22137,Lanaja,4,25,-21
2014,Huesca,22139,Laperdiguera,0,1,-1
2014,Huesca,22141,Lascellas-Ponzano,0,4,-4
2014,Huesca,22142,Lascuarre,2,1,1
2014,Huesca,22143,Laspaúles,0,3,-3
2014,Huesca,22144,Laspuña,0,3,-3
2014,Huesca,22149,Loarre,2,5,-3
2014,Huesca,22150,Loporzano,2,3,-1
2014,Huesca,22151,Loscorrales,0,2,-2
2014,Huesca,22905,Lupiñén-Ortilla,1,5,-4
2014,Huesca,22155,Monesma y Cajigar,0,2,-2
2014,Huesca,22156,Monflorite-Lascasas,2,0,2
2014,Huesca,22157,Montanuy,1,3,-2
2014,Huesca,22158,Monzón,195,182,13
2014,Huesca,22160,Naval,1,4,-3
2014,Huesca,22162,Novales,1,3,-2
2014,Huesca,22163,Nueno,4,5,-1
2014,Huesca,22164,Olvena,1,2,-1
2014,Huesca,22165,Ontiñena,5,9,-4
2014,Huesca,22167,Osso de Cinca,6,11,-5
2014,Huesca,22170,Panticosa,3,7,-4
2014,Huesca,22174,Peralta de Alcofea,1,8,-7
2014,Huesca,22175,Peralta de Calasanz,0,6,-6
2014,Huesca,22176,Peraltilla,1,1,0
2014,Huesca,22178,Pertusa,0,5,-5
2014,Huesca,22172,Peñalba,2,4,-2
2014,Huesca,22173,Peñas de Riglos (Las),2,7,-5
2014,Huesca,22182,Plan,0,5,-5
2014,Huesca,22184,Poleñino,2,5,-3
2014,Huesca,22186,Pozán de Vero,0,6,-6
2014,Huesca,22187,Puebla de Castro (La),5,6,-1
2014,Huesca,22902,Puente la Reina de Jaca,2,4,-2
2014,Huesca,22190,Pueyo de Araguás (El),0,3,-3
2014,Huesca,22193,Pueyo de Santa Cruz,4,4,0
2014,Huesca,22189,Puértolas,3,2,1
2014,Huesca,22195,Quicena,0,6,-6
2014,Huesca,22197,Robres,4,4,0
2014,Huesca,22199,Sabiñánigo,67,100,-33
2014,Huesca,22200,Sahún,0,4,-4
2014,Huesca,22201,Salas Altas,2,13,-11
2014,Huesca,22202,Salas Bajas,4,0,4
2014,Huesca,22203,Salillas,1,1,0
2014,Huesca,22204,Sallent de Gállego,7,10,-3
2014,Huesca,22205,San Esteban de Litera,4,4,0
2014,Huesca,22207,San Juan de Plan,2,2,0
2014,Huesca,22903,San Miguel del Cinca,6,9,-3
2014,Huesca,22206,Sangarrén,0,1,-1
2014,Huesca,22208,Santa Cilia,0,3,-3
2014,Huesca,22209,Santa Cruz de la Serós,0,1,-1
2014,Huesca,22906,Santa María de Dulcis,0,3,-3
2014,Huesca,22212,Santaliestra y San Quílez,0,1,-1
2014,Huesca,22213,Sariñena,26,42,-16
2014,Huesca,22214,Secastilla,1,2,-1
2014,Huesca,22215,Seira,1,0,1
2014,Huesca,22217,Sena,5,12,-7
2014,Huesca,22218,Senés de Alcubierre,0,2,-2
2014,Huesca,22220,Sesa,0,2,-2
2014,Huesca,22221,Sesué,1,0,1
2014,Huesca,22222,Siétamo,7,4,3
2014,Huesca,22904,Sotonera (La),3,14,-11
2014,Huesca,22225,Tamarite de Litera,25,57,-32
2014,Huesca,22226,Tardienta,8,16,-8
2014,Huesca,22227,Tella-Sin,1,4,-3
2014,Huesca,22228,Tierz,8,0,8
2014,Huesca,22230,Torla-Ordesa,2,6,-4
2014,Huesca,22232,Torralba de Aragón,0,1,-1
2014,Huesca,22233,Torre la Ribera,1,2,-1
2014,Huesca,22234,Torrente de Cinca,0,4,-4
2014,Huesca,22235,Torres de Alcanadre,1,2,-1
2014,Huesca,22236,Torres de Barbués,1,4,-3
2014,Huesca,22239,Tramaced,0,3,-3
2014,Huesca,22242,Valfarta,1,1,0
2014,Huesca,22243,Valle de Bardají,0,2,-2
2014,Huesca,22901,Valle de Hecho,5,13,-8
2014,Huesca,22244,Valle de Lierp,0,3,-3
2014,Huesca,22245,Velilla de Cinca,1,10,-9
2014,Huesca,22909,Vencillón,1,4,-3
2014,Huesca,22247,Viacamp y Litera,0,1,-1
2014,Huesca,22249,Villanova,1,2,-1
2014,Huesca,22251,Villanueva de Sigena,3,4,-1
2014,Huesca,22250,Villanúa,5,1,4
2014,Huesca,22252,Yebra de Basa,2,4,-2
2014,Huesca,22253,Yésero,1,0,1
2014,Huesca,22254,Zaidín,7,13,-6
2014,Teruel,44001,Ababuj,1,0,1
2014,Teruel,44002,Abejuela,1,0,1
2014,Teruel,44004,Aguaviva,4,8,-4
2014,Teruel,44006,Alacón,0,8,-8
2014,Teruel,44007,Alba,0,1,-1
2014,Teruel,44008,Albalate del Arzobispo,12,23,-11
2014,Teruel,44009,Albarracín,8,13,-5
2014,Teruel,44010,Albentosa,4,4,0
2014,Teruel,44011,Alcaine,2,0,2
2014,Teruel,44012,Alcalá de la Selva,0,3,-3
2014,Teruel,44013,Alcañiz,163,158,5
2014,Teruel,44014,Alcorisa,27,47,-20
2014,Teruel,44016,Alfambra,3,4,-1
2014,Teruel,44017,Aliaga,1,6,-5
2014,Teruel,44021,Allepuz,0,3,-3
2014,Teruel,44022,Alloza,3,5,-2
2014,Teruel,44018,Almohaja,0,1,-1
2014,Teruel,44019,Alobras,0,2,-2
2014,Teruel,44020,Alpeñés,0,1,-1
2014,Teruel,44025,Andorra,64,73,-9
2014,Teruel,44026,Arcos de las Salinas,1,0,1
2014,Teruel,44027,Arens de Lledó,0,2,-2
2014,Teruel,44028,Argente,2,4,-2
2014,Teruel,44029,Ariño,6,14,-8
2014,Teruel,44031,Azaila,0,5,-5
2014,Teruel,44035,Barrachina,0,2,-2
2014,Teruel,44034,Bañón,0,6,-6
2014,Teruel,44036,Bea,0,1,-1
2014,Teruel,44037,Beceite,3,12,-9
2014,Teruel,44039,Bello,0,6,-6
2014,Teruel,44038,Belmonte de San José,0,2,-2
2014,Teruel,44040,Berge,0,3,-3
2014,Teruel,44042,Blancas,1,3,-2
2014,Teruel,44043,Blesa,0,1,-1
2014,Teruel,44044,Bordón,2,1,1
2014,Teruel,44045,Bronchales,0,4,-4
2014,Teruel,44046,Bueña,0,3,-3
2014,Teruel,44047,Burbáguena,1,20,-19
2014,Teruel,44033,Báguena,0,2,-2
2014,Teruel,44049,Calaceite,7,19,-12
2014,Teruel,44050,Calamocha,42,57,-15
2014,Teruel,44051,Calanda,33,56,-23
2014,Teruel,44052,Calomarde,0,3,-3
2014,Teruel,44054,Camarena de la Sierra,0,1,-1
2014,Teruel,44055,Camarillas,0,3,-3
2014,Teruel,44053,Camañas,0,1,-1
2014,Teruel,44056,Caminreal,2,11,-9
2014,Teruel,44059,Cantavieja,11,9,2
2014,Teruel,44064,Cascante del Río,0,1,-1
2014,Teruel,44066,Castel de Cabra,1,4,-3
2014,Teruel,44070,Castellar (El),0,0,0
2014,Teruel,44071,Castellote,2,9,-7
2014,Teruel,44067,Castelnou,1,1,0
2014,Teruel,44068,Castelserás,13,6,7
2014,Teruel,44061,Cañada de Verich (La),0,5,-5
2014,Teruel,44062,Cañada Vellida,0,3,-3
2014,Teruel,44063,Cañizar del Olivar,1,2,-1
2014,Teruel,44074,Cedrillas,2,9,-7
2014,Teruel,44075,Celadas,1,4,-3
2014,Teruel,44076,Cella,14,40,-26
2014,Teruel,44077,Cerollera (La),1,1,0
2014,Teruel,44080,Codoñera (La),3,11,-8
2014,Teruel,44082,Corbalán,0,3,-3
2014,Teruel,44084,Cortes de Aragón,0,4,-4
2014,Teruel,44085,Cosa,0,3,-3
2014,Teruel,44086,Cretas,2,7,-5
2014,Teruel,44087,Crivillén,0,1,-1
2014,Teruel,44088,Cuba (La),1,2,-1
2014,Teruel,44089,Cubla,0,2,-2
2014,Teruel,44090,Cucalón,0,1,-1
2014,Teruel,44092,Cuervo (El),0,3,-3
2014,Teruel,44093,Cuevas de Almudén,1,1,0
2014,Teruel,44094,Cuevas Labradas,0,2,-2
2014,Teruel,44096,Ejulve,2,2,0
2014,Teruel,44097,Escorihuela,0,4,-4
2014,Teruel,44099,Escucha,6,10,-4
2014,Teruel,44100,Estercuel,0,3,-3
2014,Teruel,44101,Ferreruela de Huerva,0,2,-2
2014,Teruel,44103,Formiche Alto,0,1,-1
2014,Teruel,44106,Fortanete,2,5,-3
2014,Teruel,44107,Foz-Calanda,1,3,-2
2014,Teruel,44108,Fresneda (La),5,5,0
2014,Teruel,44109,Frías de Albarracín,2,4,-2
2014,Teruel,44111,Fuentes Calientes,0,4,-4
2014,Teruel,44112,Fuentes Claras,0,10,-10
2014,Teruel,44113,Fuentes de Rubielos,0,2,-2
2014,Teruel,44114,Fuentespalda,0,6,-6
2014,Teruel,44115,Galve,1,1,0
2014,Teruel,44116,Gargallo,1,2,-1
2014,Teruel,44117,Gea de Albarracín,0,7,-7
2014,Teruel,44118,Ginebrosa (La),1,3,-2
2014,Teruel,44119,Griegos,1,0,1
2014,Teruel,44120,Guadalaviar,2,2,0
2014,Teruel,44123,Hinojosa de Jarque,0,3,-3
2014,Teruel,44124,Hoz de la Vieja (La),1,0,1
2014,Teruel,44125,Huesa del Común,0,2,-2
2014,Teruel,44122,Híjar,12,27,-15
2014,Teruel,44126,Iglesuela del Cid (La),2,8,-6
2014,Teruel,44127,Jabaloyas,0,1,-1
2014,Teruel,44128,Jarque de la Val,1,2,-1
2014,Teruel,44129,Jatiel,0,2,-2
2014,Teruel,44130,Jorcas,0,1,-1
2014,Teruel,44135,Libros,0,4,-4
2014,Teruel,44137,Linares de Mora,2,3,-1
2014,Teruel,44141,Lledó,2,3,-1
2014,Teruel,44138,Loscos,1,1,0
2014,Teruel,44143,Manzanera,3,7,-4
2014,Teruel,44144,Martín del Río,3,3,0
2014,Teruel,44145,Mas de las Matas,15,16,-1
2014,Teruel,44146,Mata de los Olmos (La),4,2,2
2014,Teruel,44147,Mazaleón,3,4,-1
2014,Teruel,44148,Mezquita de Jarque,1,6,-5
2014,Teruel,44149,Mirambel,1,2,-1
2014,Teruel,44150,Miravete de la Sierra,0,2,-2
2014,Teruel,44151,Molinos,1,0,1
2014,Teruel,44153,Monreal del Campo,30,33,-3
2014,Teruel,44154,Monroyo,1,0,1
2014,Teruel,44155,Montalbán,13,17,-4
2014,Teruel,44156,Monteagudo del Castillo,0,2,-2
2014,Teruel,44157,Monterde de Albarracín,0,1,-1
2014,Teruel,44158,Mora de Rubielos,18,15,3
2014,Teruel,44159,Moscardón,0,1,-1
2014,Teruel,44160,Mosqueruela,3,4,-1
2014,Teruel,44161,Muniesa,7,12,-5
2014,Teruel,44165,Nogueruelas,0,1,-1
2014,Teruel,44168,Odón,2,7,-5
2014,Teruel,44169,Ojos Negros,2,13,-11
2014,Teruel,44171,Olba,1,1,0
2014,Teruel,44172,Oliete,1,9,-8
2014,Teruel,44173,Olmos (Los),2,4,-2
2014,Teruel,44174,Orihuela del Tremedal,4,8,-4
2014,Teruel,44175,Orrios,0,2,-2
2014,Teruel,44176,Palomar de Arroyos,1,0,1
2014,Teruel,44177,Pancrudo,1,3,-2
2014,Teruel,44180,Peracense,0,1,-1
2014,Teruel,44182,Perales del Alfambra,0,3,-3
2014,Teruel,44179,Peñarroya de Tastavins,4,4,0
2014,Teruel,44183,Pitarque,0,2,-2
2014,Teruel,44185,Pobo (El),0,1,-1
2014,Teruel,44187,Portellada (La),3,3,0
2014,Teruel,44189,Pozondón,0,3,-3
2014,Teruel,44190,Pozuel del Campo,0,1,-1
2014,Teruel,44191,Puebla de Híjar (La),2,14,-12
2014,Teruel,44192,Puebla de Valverde (La),1,5,-4
2014,Teruel,44193,Puertomingalvo,0,3,-3
2014,Teruel,44195,Rillo,0,6,-6
2014,Teruel,44196,Riodeva,3,3,0
2014,Teruel,44198,Royuela,1,5,-4
2014,Teruel,44201,Rubielos de Mora,7,4,3
2014,Teruel,44194,Ráfales,0,3,-3
2014,Teruel,44197,Ródenas,0,2,-2
2014,Teruel,44204,Saldón,0,1,-1
2014,Teruel,44205,Samper de Calanda,3,17,-14
2014,Teruel,44206,San Agustín,1,2,-1
2014,Teruel,44207,San Martín del Río,0,6,-6
2014,Teruel,44208,Santa Cruz de Nogueras,0,2,-2
2014,Teruel,44209,Santa Eulalia,8,20,-12
2014,Teruel,44210,Sarrión,14,12,2
2014,Teruel,44211,Segura de los Baños,1,0,1
2014,Teruel,44212,Seno,0,1,-1
2014,Teruel,44213,Singra,0,2,-2
2014,Teruel,44215,Terriente,0,2,-2
2014,Teruel,44216,Teruel,356,308,48
2014,Teruel,44218,Tormón,0,1,-1
2014,Teruel,44219,Tornos,0,2,-2
2014,Teruel,44220,Torralba de los Sisones,0,3,-3
2014,Teruel,44223,Torre de Arcas,0,1,-1
2014,Teruel,44224,Torre de las Arcas,0,1,-1
2014,Teruel,44225,Torre del Compte,0,1,-1
2014,Teruel,44227,Torre los Negros,0,1,-1
2014,Teruel,44221,Torrecilla de Alcañiz,0,5,-5
2014,Teruel,44222,Torrecilla del Rebollar,0,1,-1
2014,Teruel,44226,Torrelacárcel,2,7,-5
2014,Teruel,44228,Torremocha de Jiloca,1,4,-3
2014,Teruel,44229,Torres de Albarracín,0,3,-3
2014,Teruel,44230,Torrevelilla,2,3,-1
2014,Teruel,44231,Torrijas,0,4,-4
2014,Teruel,44232,Torrijo del Campo,2,7,-5
2014,Teruel,44234,Tramacastiel,0,5,-5
2014,Teruel,44235,Tramacastilla,0,1,-1
2014,Teruel,44236,Tronchón,0,1,-1
2014,Teruel,44237,Urrea de Gaén,0,9,-9
2014,Teruel,44238,Utrillas,30,28,2
2014,Teruel,44239,Valacloche,0,1,-1
2014,Teruel,44240,Valbona,1,0,1
2014,Teruel,44241,Valdealgorfa,5,6,-1
2014,Teruel,44243,Valdecuenca,0,1,-1
2014,Teruel,44244,Valdelinares,0,5,-5
2014,Teruel,44245,Valdeltormo,4,7,-3
2014,Teruel,44246,Valderrobres,28,28,0
2014,Teruel,44247,Valjunquera,1,11,-10
2014,Teruel,44251,Villafranca del Campo,1,3,-2
2014,Teruel,44252,Villahermosa del Campo,1,1,0
2014,Teruel,44256,Villanueva del Rebollar de la Sierra,0,1,-1
2014,Teruel,44257,Villar del Cobo,0,2,-2
2014,Teruel,44258,Villar del Salz,1,2,-1
2014,Teruel,44260,Villarluengo,0,3,-3
2014,Teruel,44261,Villarquemado,5,16,-11
2014,Teruel,44262,Villarroya de los Pinares,0,3,-3
2014,Teruel,44263,Villastar,10,7,3
2014,Teruel,44264,Villel,3,4,-1
2014,Teruel,44265,Vinaceite,1,1,0
2014,Teruel,44266,Visiedo,0,1,-1
2014,Teruel,44267,Vivel del Río Martín,0,2,-2
2014,Zaragoza,50001,Abanto,0,1,-1
2014,Zaragoza,50002,Acered,0,1,-1
2014,Zaragoza,50004,Aguarón,2,9,-7
2014,Zaragoza,50005,Aguilón,0,3,-3
2014,Zaragoza,50003,Agón,0,3,-3
2014,Zaragoza,50006,Ainzón,7,21,-14
2014,Zaragoza,50008,Alagón,58,69,-11
2014,Zaragoza,50010,Alberite de San Juan,0,1,-1
2014,Zaragoza,50011,Albeta,1,0,1
2014,Zaragoza,50012,Alborge,0,1,-1
2014,Zaragoza,50013,Alcalá de Ebro,2,4,-2
2014,Zaragoza,50014,Alcalá de Moncayo,0,1,-1
2014,Zaragoza,50015,Alconchel de Ariza,0,4,-4
2014,Zaragoza,50017,Alfajarín,17,17,0
2014,Zaragoza,50018,Alfamén,14,19,-5
2014,Zaragoza,50019,Alforque,0,1,-1
2014,Zaragoza,50020,Alhama de Aragón,11,13,-2
2014,Zaragoza,50022,Almolda (La),5,9,-4
2014,Zaragoza,50023,Almonacid de la Cuba,0,7,-7
2014,Zaragoza,50024,Almonacid de la Sierra,3,14,-11
2014,Zaragoza,50025,Almunia de Doña Godina (La),91,77,14
2014,Zaragoza,50026,Alpartir,2,3,-1
2014,Zaragoza,50027,Ambel,0,3,-3
2014,Zaragoza,50029,Aniñón,1,7,-6
2014,Zaragoza,50031,Aranda de Moncayo,1,4,-3
2014,Zaragoza,50034,Ariza,8,14,-6
2014,Zaragoza,50035,Artieda,0,1,-1
2014,Zaragoza,50032,Arándiga,1,9,-8
2014,Zaragoza,50036,Asín,0,6,-6
2014,Zaragoza,50037,Atea,0,4,-4
2014,Zaragoza,50038,Ateca,1,27,-26
2014,Zaragoza,50039,Azuara,0,12,-12
2014,Zaragoza,50030,Añón de Moncayo,0,6,-6
2014,Zaragoza,50044,Bardallur,1,3,-2
2014,Zaragoza,50045,Belchite,6,25,-19
2014,Zaragoza,50046,Belmonte de Gracián,0,2,-2
2014,Zaragoza,50047,Berdejo,0,1,-1
2014,Zaragoza,50901,Biel,0,1,-1
2014,Zaragoza,50050,Bijuesca,0,2,-2
2014,Zaragoza,50051,Biota,3,14,-11
2014,Zaragoza,50052,Bisimbre,0,2,-2
2014,Zaragoza,50053,Boquiñeni,2,9,-7
2014,Zaragoza,50054,Bordalba,0,1,-1
2014,Zaragoza,50055,Borja,55,56,-1
2014,Zaragoza,50056,Botorrita,6,7,-1
2014,Zaragoza,50057,Brea de Aragón,11,22,-11
2014,Zaragoza,50058,Bubierca,0,0,0
2014,Zaragoza,50059,Bujaraloz,6,9,-3
2014,Zaragoza,50060,Bulbuente,0,5,-5
2014,Zaragoza,50061,Bureta,2,5,-3
2014,Zaragoza,50062,Burgo de Ebro (El),26,20,6
2014,Zaragoza,50063,Buste (El),0,1,-1
2014,Zaragoza,50043,Bárboles,3,3,0
2014,Zaragoza,50064,Cabañas de Ebro,1,5,-4
2014,Zaragoza,50066,Cadrete,44,13,31
2014,Zaragoza,50067,Calatayud,171,213,-42
2014,Zaragoza,50068,Calatorao,21,31,-10
2014,Zaragoza,50071,Campillo de Aragón,0,4,-4
2014,Zaragoza,50072,Carenas,1,4,-3
2014,Zaragoza,50073,Cariñena,22,54,-32
2014,Zaragoza,50074,Caspe,117,103,14
2014,Zaragoza,50075,Castejón de Alarba,1,1,0
2014,Zaragoza,50076,Castejón de las Armas,0,2,-2
2014,Zaragoza,50077,Castejón de Valdejasa,1,2,-1
2014,Zaragoza,50078,Castiliscar,1,5,-4
2014,Zaragoza,50079,Cervera de la Cañada,0,9,-9
2014,Zaragoza,50081,Cetina,3,13,-10
2014,Zaragoza,50092,Chiprana,3,4,-1
2014,Zaragoza,50093,Chodes,1,1,0
2014,Zaragoza,50082,Cimballa,0,2,-2
2014,Zaragoza,50083,Cinco Olivas,1,3,-2
2014,Zaragoza,50084,Clarés de Ribota,0,1,-1
2014,Zaragoza,50085,Codo,1,6,-5
2014,Zaragoza,50086,Codos,1,4,-3
2014,Zaragoza,50088,Cosuenda,0,4,-4
2014,Zaragoza,50089,Cuarte de Huerva,239,30,209
2014,Zaragoza,50090,Cubel,0,1,-1
2014,Zaragoza,50091,Cuerlas (Las),0,2,-2
2014,Zaragoza,50094,Daroca,14,48,-34
2014,Zaragoza,50095,Ejea de los Caballeros,135,172,-37
2014,Zaragoza,50096,Embid de Ariza,0,3,-3
2014,Zaragoza,50098,Encinacorba,0,5,-5
2014,Zaragoza,50100,Erla,2,6,-4
2014,Zaragoza,50101,Escatrón,5,21,-16
2014,Zaragoza,50102,Fabara,9,15,-6
2014,Zaragoza,50104,Farlete,1,4,-3
2014,Zaragoza,50106,Fayos (Los),0,1,-1
2014,Zaragoza,50105,Fayón,4,2,2
2014,Zaragoza,50107,Figueruelas,5,15,-10
2014,Zaragoza,50109,Frago (El),0,4,-4
2014,Zaragoza,50110,Frasno (El),0,10,-10
2014,Zaragoza,50111,Fréscano,1,3,-2
2014,Zaragoza,50113,Fuendejalón,6,15,-9
2014,Zaragoza,50114,Fuendetodos,0,1,-1
2014,Zaragoza,50115,Fuentes de Ebro,43,43,0
2014,Zaragoza,50116,Fuentes de Jiloca,1,4,-3
2014,Zaragoza,50117,Gallocanta,0,3,-3
2014,Zaragoza,50118,Gallur,21,28,-7
2014,Zaragoza,50119,Gelsa,7,14,-7
2014,Zaragoza,50121,Gotor,0,2,-2
2014,Zaragoza,50122,Grisel,0,1,-1
2014,Zaragoza,50123,Grisén,9,8,1
2014,Zaragoza,50124,Herrera de los Navarros,3,13,-10
2014,Zaragoza,50125,Ibdes,1,12,-11
2014,Zaragoza,50126,Illueca,13,26,-13
2014,Zaragoza,50129,Jaraba,3,2,1
2014,Zaragoza,50130,Jarque de Moncayo,1,7,-6
2014,Zaragoza,50131,Jaulín,0,13,-13
2014,Zaragoza,50132,Joyosa (La),11,12,-1
2014,Zaragoza,50133,Lagata,0,2,-2
2014,Zaragoza,50134,Langa del Castillo,0,4,-4
2014,Zaragoza,50137,Leciñena,13,19,-6
2014,Zaragoza,50139,Letux,1,7,-6
2014,Zaragoza,50140,Litago,0,4,-4
2014,Zaragoza,50141,Lituénigo,0,2,-2
2014,Zaragoza,50142,Lobera de Onsella,0,1,-1
2014,Zaragoza,50143,Longares,5,9,-4
2014,Zaragoza,50146,Lucena de Jalón,2,7,-5
2014,Zaragoza,50147,Luceni,16,22,-6
2014,Zaragoza,50148,Luesia,1,11,-10
2014,Zaragoza,50149,Luesma,0,1,-1
2014,Zaragoza,50150,Lumpiaque,3,19,-16
2014,Zaragoza,50151,Luna,2,9,-7
2014,Zaragoza,50136,Lécera,1,18,-17
2014,Zaragoza,50152,Maella,16,24,-8
2014,Zaragoza,50153,Magallón,6,22,-16
2014,Zaragoza,50154,Mainar,0,3,-3
2014,Zaragoza,50155,Malanquilla,0,2,-2
2014,Zaragoza,50156,Maleján,2,2,0
2014,Zaragoza,50160,Mallén,27,44,-17
2014,Zaragoza,50159,Maluenda,4,22,-18
2014,Zaragoza,50157,Malón,3,10,-7
2014,Zaragoza,50162,Mara,0,3,-3
2014,Zaragoza,50902,Marracos,0,2,-2
2014,Zaragoza,50163,María de Huerva,107,23,84
2014,Zaragoza,50164,Mediana de Aragón,5,7,-2
2014,Zaragoza,50165,Mequinenza,13,19,-6
2014,Zaragoza,50166,Mesones de Isuela,2,5,-3
2014,Zaragoza,50167,Mezalocha,0,5,-5
2014,Zaragoza,50169,Miedes de Aragón,2,3,-1
2014,Zaragoza,50170,Monegrillo,1,8,-7
2014,Zaragoza,50172,Monreal de Ariza,0,2,-2
2014,Zaragoza,50173,Monterde,0,2,-2
2014,Zaragoza,50174,Montón,0,3,-3
2014,Zaragoza,50175,Morata de Jalón,4,10,-6
2014,Zaragoza,50176,Morata de Jiloca,0,7,-7
2014,Zaragoza,50178,Moros,0,4,-4
2014,Zaragoza,50177,Morés,0,5,-5
2014,Zaragoza,50179,Moyuela,0,7,-7
2014,Zaragoza,50180,Mozota,1,2,-1
2014,Zaragoza,50181,Muel,14,18,-4
2014,Zaragoza,50182,Muela (La),88,18,70
2014,Zaragoza,50183,Munébrega,0,4,-4
2014,Zaragoza,50184,Murero,0,3,-3
2014,Zaragoza,50185,Murillo de Gállego,0,2,-2
2014,Zaragoza,50187,Nigüella,0,1,-1
2014,Zaragoza,50189,Nonaspe,4,14,-10
2014,Zaragoza,50190,Novallas,5,17,-12
2014,Zaragoza,50191,Novillas,4,6,-2
2014,Zaragoza,50193,Nuez de Ebro,8,8,0
2014,Zaragoza,50192,Nuévalos,4,4,0
2014,Zaragoza,50194,Olvés,0,1,-1
2014,Zaragoza,50195,Orcajo,0,2,-2
2014,Zaragoza,50196,Orera,0,3,-3
2014,Zaragoza,50197,Orés,1,1,0
2014,Zaragoza,50199,Osera de Ebro,1,6,-5
2014,Zaragoza,50200,Paniza,10,11,-1
2014,Zaragoza,50201,Paracuellos de Jiloca,4,8,-4
2014,Zaragoza,50202,Paracuellos de la Ribera,0,1,-1
2014,Zaragoza,50203,Pastriz,5,11,-6
2014,Zaragoza,50204,Pedrola,24,32,-8
2014,Zaragoza,50205,Pedrosas (Las),1,1,0
2014,Zaragoza,50206,Perdiguera,4,8,-4
2014,Zaragoza,50207,Piedratajada,0,1,-1
2014,Zaragoza,50208,Pina de Ebro,24,26,-2
2014,Zaragoza,50209,Pinseque,36,49,-13
2014,Zaragoza,50211,Plasencia de Jalón,2,4,-2
2014,Zaragoza,50212,Pleitas,1,0,1
2014,Zaragoza,50213,Plenas,0,3,-3
2014,Zaragoza,50214,Pomer,0,2,-2
2014,Zaragoza,50216,Pozuelo de Aragón,2,9,-7
2014,Zaragoza,50217,Pradilla de Ebro,0,10,-10
2014,Zaragoza,50218,Puebla de Albortón,1,2,-1
2014,Zaragoza,50219,Puebla de Alfindén (La),80,27,53
2014,Zaragoza,50220,Puendeluna,0,1,-1
2014,Zaragoza,50222,Quinto,18,25,-7
2014,Zaragoza,50223,Remolinos,9,9,0
2014,Zaragoza,50224,Retascón,0,0,0
2014,Zaragoza,50225,Ricla,20,32,-12
2014,Zaragoza,50227,Romanos,0,1,-1
2014,Zaragoza,50228,Rueda de Jalón,2,6,-4
2014,Zaragoza,50231,Salillas de Jalón,0,4,-4
2014,Zaragoza,50232,Salvatierra de Esca,3,2,1
2014,Zaragoza,50233,Samper del Salz,1,2,-1
2014,Zaragoza,50234,San Martín de la Virgen de Moncayo,0,4,-4
2014,Zaragoza,50235,San Mateo de Gállego,28,30,-2
2014,Zaragoza,50236,Santa Cruz de Grío,0,3,-3
2014,Zaragoza,50238,Santa Eulalia de Gállego,0,5,-5
2014,Zaragoza,50241,Saviñán,5,13,-8
2014,Zaragoza,50242,Sediles,0,1,-1
2014,Zaragoza,50243,Sestrica,0,6,-6
2014,Zaragoza,50244,Sierra de Luna,0,2,-2
2014,Zaragoza,50245,Sigüés,1,1,0
2014,Zaragoza,50246,Sisamón,0,1,-1
2014,Zaragoza,50247,Sobradiel,15,11,4
2014,Zaragoza,50248,Sos del Rey Católico,1,5,-4
2014,Zaragoza,50230,Sádaba,5,28,-23
2014,Zaragoza,50240,Sástago,10,19,-9
2014,Zaragoza,50249,Tabuenca,0,5,-5
2014,Zaragoza,50250,Talamantes,0,2,-2
2014,Zaragoza,50251,Tarazona,100,115,-15
2014,Zaragoza,50252,Tauste,55,107,-52
2014,Zaragoza,50253,Terrer,3,8,-5
2014,Zaragoza,50254,Tierga,1,2,-1
2014,Zaragoza,50255,Tobed,0,12,-12
2014,Zaragoza,50256,Torralba de los Frailes,0,1,-1
2014,Zaragoza,50257,Torralba de Ribota,0,7,-7
2014,Zaragoza,50258,Torralbilla,0,1,-1
2014,Zaragoza,50259,Torrehermosa,0,2,-2
2014,Zaragoza,50261,Torrellas,1,7,-6
2014,Zaragoza,50262,Torres de Berrellén,7,15,-8
2014,Zaragoza,50263,Torrijo de la Cañada,0,5,-5
2014,Zaragoza,50264,Tosos,1,5,-4
2014,Zaragoza,50265,Trasmoz,0,1,-1
2014,Zaragoza,50266,Trasobares,0,3,-3
2014,Zaragoza,50267,Uncastillo,1,17,-16
2014,Zaragoza,50268,Undués de Lerda,2,0,2
2014,Zaragoza,50269,Urrea de Jalón,2,18,-16
2014,Zaragoza,50271,Used,0,5,-5
2014,Zaragoza,50272,Utebo,181,100,81
2014,Zaragoza,50274,Val de San Martín,0,1,-1
2014,Zaragoza,50273,Valdehorna,0,1,-1
2014,Zaragoza,50275,Valmadrid,0,4,-4
2014,Zaragoza,50276,Valpalmas,0,1,-1
2014,Zaragoza,50277,Valtorres,2,3,-1
2014,Zaragoza,50278,Velilla de Ebro,1,2,-1
2014,Zaragoza,50279,Velilla de Jiloca,0,3,-3
2014,Zaragoza,50280,Vera de Moncayo,1,8,-7
2014,Zaragoza,50281,Vierlas,0,1,-1
2014,Zaragoza,50283,Villadoz,0,1,-1
2014,Zaragoza,50284,Villafeliche,0,6,-6
2014,Zaragoza,50285,Villafranca de Ebro,6,11,-5
2014,Zaragoza,50286,Villalba de Perejil,1,1,0
2014,Zaragoza,50287,Villalengua,0,6,-6
2014,Zaragoza,50903,Villamayor de Gállego,14,24,-10
2014,Zaragoza,50288,Villanueva de Gállego,56,46,10
2014,Zaragoza,50290,Villanueva de Huerva,2,9,-7
2014,Zaragoza,50291,Villar de los Navarros,0,3,-3
2014,Zaragoza,50292,Villarreal de Huerva,3,3,0
2014,Zaragoza,50293,Villarroya de la Sierra,1,9,-8
2014,Zaragoza,50294,Villarroya del Campo,0,2,-2
2014,Zaragoza,50282,Vilueña (La),0,1,-1
2014,Zaragoza,50296,Zaida (La),4,11,-7
2014,Zaragoza,50297,Zaragoza,6248,6363,-115
2014,Zaragoza,50298,Zuera,79,55,24
2014,Zaragoza,50099,Épila,38,49,-11
2013,Huesca,22001,Abiego,1,3,-2
2013,Huesca,22002,Abizanda,0,0,0
2013,Huesca,22003,Adahuesca,4,3,1
2013,Huesca,22004,Agüero,1,2,-1
2013,Huesca,22007,Albalate de Cinca,13,13,0
2013,Huesca,22008,Albalatillo,0,4,-4
2013,Huesca,22009,Albelda,1,20,-19
2013,Huesca,22012,Albero Bajo,0,1,-1
2013,Huesca,22013,Alberuela de Tubo,0,5,-5
2013,Huesca,22014,Alcalá de Gurrea,0,2,-2
2013,Huesca,22015,Alcalá del Obispo,1,1,0
2013,Huesca,22016,Alcampell,4,12,-8
2013,Huesca,22017,Alcolea de Cinca,9,16,-7
2013,Huesca,22018,Alcubierre,0,11,-11
2013,Huesca,22019,Alerre,0,0,0
2013,Huesca,22020,Alfántega,1,4,-3
2013,Huesca,22021,Almudévar,25,26,-1
2013,Huesca,22022,Almunia de San Juan,4,9,-5
2013,Huesca,22023,Almuniente,4,9,-5
2013,Huesca,22024,Alquézar,3,0,3
2013,Huesca,22025,Altorricón,13,17,-4
2013,Huesca,22027,Angüés,1,12,-11
2013,Huesca,22028,Ansó,3,8,-5
2013,Huesca,22029,Antillón,0,1,-1
2013,Huesca,22032,Aragüés del Puerto,0,1,-1
2013,Huesca,22036,Argavieso,0,1,-1
2013,Huesca,22037,Arguis,0,1,-1
2013,Huesca,22035,Arén,0,3,-3
2013,Huesca,22039,Ayerbe,4,20,-16
2013,Huesca,22040,Azanuy-Alins,1,3,-2
2013,Huesca,22041,Azara,1,3,-2
2013,Huesca,22042,Azlor,2,1,1
2013,Huesca,22907,Aínsa-Sobrarbe,19,25,-6
2013,Huesca,22006,Aísa,2,4,-2
2013,Huesca,22043,Baells,0,4,-4
2013,Huesca,22044,Bailo,2,3,-1
2013,Huesca,22045,Baldellou,0,2,-2
2013,Huesca,22046,Ballobar,5,16,-11
2013,Huesca,22047,Banastás,1,0,1
2013,Huesca,22048,Barbastro,146,181,-35
2013,Huesca,22049,Barbués,0,1,-1
2013,Huesca,22050,Barbuñales,0,1,-1
2013,Huesca,22052,Belver de Cinca,9,20,-11
2013,Huesca,22053,Benabarre,6,14,-8
2013,Huesca,22054,Benasque,20,13,7
2013,Huesca,22246,Beranuy,0,2,-2
2013,Huesca,22055,Berbegal,1,6,-5
2013,Huesca,22057,Bielsa,3,6,-3
2013,Huesca,22058,Bierge,0,1,-1
2013,Huesca,22059,Biescas,9,22,-13
2013,Huesca,22060,Binaced,3,20,-17
2013,Huesca,22061,Binéfar,109,81,28
2013,Huesca,22062,Bisaurri,1,1,0
2013,Huesca,22063,Biscarrués,0,4,-4
2013,Huesca,22064,Blecua y Torres,0,3,-3
2013,Huesca,22066,Boltaña,7,8,-1
2013,Huesca,22067,Bonansa,0,1,-1
2013,Huesca,22068,Borau,0,1,-1
2013,Huesca,22069,Broto,1,6,-5
2013,Huesca,22072,Caldearenas,2,3,-1
2013,Huesca,22074,Campo,0,6,-6
2013,Huesca,22075,Camporrells,0,2,-2
2013,Huesca,22076,Canal de Berdún,0,6,-6
2013,Huesca,22077,Candasnos,0,5,-5
2013,Huesca,22078,Canfranc,2,1,1
2013,Huesca,22079,Capdesaso,1,3,-2
2013,Huesca,22080,Capella,2,4,-2
2013,Huesca,22081,Casbas de Huesca,1,2,-1
2013,Huesca,22083,Castejón de Monegros,0,12,-12
2013,Huesca,22084,Castejón de Sos,8,9,-1
2013,Huesca,22082,Castejón del Puente,0,5,-5
2013,Huesca,22085,Castelflorite,0,1,-1
2013,Huesca,22086,Castiello de Jaca,0,1,-1
2013,Huesca,22087,Castigaleu,1,2,-1
2013,Huesca,22089,Castillonroy,0,3,-3
2013,Huesca,22094,Chalamera,0,4,-4
2013,Huesca,22096,Chimillas,1,6,-5
2013,Huesca,22095,Chía,1,2,-1
2013,Huesca,22090,Colungo,0,5,-5
2013,Huesca,22099,Esplús,2,12,-10
2013,Huesca,22102,Estada,0,4,-4
2013,Huesca,22103,Estadilla,4,14,-10
2013,Huesca,22105,Estopiñán del Castillo,1,1,0
2013,Huesca,22107,Fanlo,1,2,-1
2013,Huesca,22109,Fiscal,2,2,0
2013,Huesca,22110,Fonz,3,17,-14
2013,Huesca,22111,Foradada del Toscar,2,3,-1
2013,Huesca,22112,Fraga,178,143,35
2013,Huesca,22113,Fueva (La),8,9,-1
2013,Huesca,22114,Gistaín,0,2,-2
2013,Huesca,22115,Grado (El),0,5,-5
2013,Huesca,22117,Graus,32,52,-20
2013,Huesca,22116,Grañén,13,45,-32
2013,Huesca,22119,Gurrea de Gállego,11,24,-13
2013,Huesca,22908,Hoz y Costeán,1,4,-3
2013,Huesca,22124,Huerto,2,5,-3
2013,Huesca,22125,Huesca,563,513,50
2013,Huesca,22126,Ibieca,0,2,-2
2013,Huesca,22127,Igriés,5,7,-2
2013,Huesca,22128,Ilche,0,3,-3
2013,Huesca,22129,Isábena,0,2,-2
2013,Huesca,22130,Jaca,118,139,-21
2013,Huesca,22131,Jasa,1,2,-1
2013,Huesca,22133,Labuerda,1,0,1
2013,Huesca,22135,Laluenga,1,7,-6
2013,Huesca,22136,Lalueza,5,11,-6
2013,Huesca,22137,Lanaja,4,20,-16
2013,Huesca,22139,Laperdiguera,0,1,-1
2013,Huesca,22142,Lascuarre,2,1,1
2013,Huesca,22143,Laspaúles,2,2,0
2013,Huesca,22144,Laspuña,7,2,5
2013,Huesca,22149,Loarre,0,3,-3
2013,Huesca,22150,Loporzano,1,8,-7
2013,Huesca,22151,Loscorrales,1,0,1
2013,Huesca,22905,Lupiñén-Ortilla,1,3,-2
2013,Huesca,22155,Monesma y Cajigar,0,1,-1
2013,Huesca,22156,Monflorite-Lascasas,0,3,-3
2013,Huesca,22157,Montanuy,2,6,-4
2013,Huesca,22158,Monzón,176,168,8
2013,Huesca,22160,Naval,1,3,-2
2013,Huesca,22162,Novales,1,2,-1
2013,Huesca,22163,Nueno,5,2,3
2013,Huesca,22164,Olvena,0,2,-2
2013,Huesca,22165,Ontiñena,3,7,-4
2013,Huesca,22167,Osso de Cinca,7,8,-1
2013,Huesca,22168,Palo,1,2,-1
2013,Huesca,22170,Panticosa,8,5,3
2013,Huesca,22174,Peralta de Alcofea,5,6,-1
2013,Huesca,22175,Peralta de Calasanz,1,2,-1
2013,Huesca,22176,Peraltilla,6,3,3
2013,Huesca,22178,Pertusa,0,1,-1
2013,Huesca,22172,Peñalba,4,4,0
2013,Huesca,22173,Peñas de Riglos (Las),2,3,-1
2013,Huesca,22182,Plan,2,4,-2
2013,Huesca,22184,Poleñino,2,2,0
2013,Huesca,22186,Pozán de Vero,3,5,-2
2013,Huesca,22187,Puebla de Castro (La),2,5,-3
2013,Huesca,22902,Puente la Reina de Jaca,1,8,-7
2013,Huesca,22190,Pueyo de Araguás (El),1,2,-1
2013,Huesca,22193,Pueyo de Santa Cruz,3,5,-2
2013,Huesca,22189,Puértolas,2,1,1
2013,Huesca,22195,Quicena,3,2,1
2013,Huesca,22197,Robres,8,5,3
2013,Huesca,22199,Sabiñánigo,76,87,-11
2013,Huesca,22200,Sahún,0,1,-1
2013,Huesca,22201,Salas Altas,1,9,-8
2013,Huesca,22202,Salas Bajas,0,2,-2
2013,Huesca,22203,Salillas,1,3,-2
2013,Huesca,22204,Sallent de Gállego,8,5,3
2013,Huesca,22205,San Esteban de Litera,2,12,-10
2013,Huesca,22207,San Juan de Plan,1,2,-1
2013,Huesca,22903,San Miguel del Cinca,9,6,3
2013,Huesca,22206,Sangarrén,2,2,0
2013,Huesca,22208,Santa Cilia,0,1,-1
2013,Huesca,22209,Santa Cruz de la Serós,2,1,1
2013,Huesca,22906,Santa María de Dulcis,2,0,2
2013,Huesca,22212,Santaliestra y San Quílez,1,0,1
2013,Huesca,22213,Sariñena,31,38,-7
2013,Huesca,22214,Secastilla,1,1,0
2013,Huesca,22215,Seira,1,2,-1
2013,Huesca,22217,Sena,4,7,-3
2013,Huesca,22220,Sesa,3,3,0
2013,Huesca,22221,Sesué,0,4,-4
2013,Huesca,22222,Siétamo,6,4,2
2013,Huesca,22223,Sopeira,0,1,-1
2013,Huesca,22904,Sotonera (La),4,12,-8
2013,Huesca,22225,Tamarite de Litera,26,49,-23
2013,Huesca,22226,Tardienta,14,16,-2
2013,Huesca,22227,Tella-Sin,0,2,-2
2013,Huesca,22228,Tierz,11,2,9
2013,Huesca,22229,Tolva,0,2,-2
2013,Huesca,22230,Torla-Ordesa,2,2,0
2013,Huesca,22232,Torralba de Aragón,2,0,2
2013,Huesca,22233,Torre la Ribera,1,3,-2
2013,Huesca,22234,Torrente de Cinca,0,7,-7
2013,Huesca,22235,Torres de Alcanadre,0,3,-3
2013,Huesca,22236,Torres de Barbués,1,6,-5
2013,Huesca,22242,Valfarta,0,2,-2
2013,Huesca,22901,Valle de Hecho,0,13,-13
2013,Huesca,22245,Velilla de Cinca,5,6,-1
2013,Huesca,22909,Vencillón,2,4,-2
2013,Huesca,22248,Vicién,1,1,0
2013,Huesca,22249,Villanova,2,0,2
2013,Huesca,22251,Villanueva de Sigena,1,6,-5
2013,Huesca,22250,Villanúa,1,6,-5
2013,Huesca,22252,Yebra de Basa,2,2,0
2013,Huesca,22253,Yésero,1,1,0
2013,Huesca,22254,Zaidín,14,26,-12
2013,Teruel,44001,Ababuj,1,0,1
2013,Teruel,44002,Abejuela,0,1,-1
2013,Teruel,44003,Aguatón,0,1,-1
2013,Teruel,44004,Aguaviva,4,8,-4
2013,Teruel,44005,Aguilar del Alfambra,0,1,-1
2013,Teruel,44006,Alacón,0,3,-3
2013,Teruel,44007,Alba,0,5,-5
2013,Teruel,44008,Albalate del Arzobispo,13,37,-24
2013,Teruel,44009,Albarracín,7,20,-13
2013,Teruel,44010,Albentosa,2,4,-2
2013,Teruel,44011,Alcaine,2,0,2
2013,Teruel,44012,Alcalá de la Selva,2,9,-7
2013,Teruel,44013,Alcañiz,168,148,20
2013,Teruel,44014,Alcorisa,27,38,-11
2013,Teruel,44016,Alfambra,1,7,-6
2013,Teruel,44017,Aliaga,5,2,3
2013,Teruel,44021,Allepuz,0,4,-4
2013,Teruel,44022,Alloza,1,15,-14
2013,Teruel,44018,Almohaja,0,1,-1
2013,Teruel,44019,Alobras,0,1,-1
2013,Teruel,44025,Andorra,76,72,4
2013,Teruel,44026,Arcos de las Salinas,0,2,-2
2013,Teruel,44027,Arens de Lledó,0,3,-3
2013,Teruel,44028,Argente,0,5,-5
2013,Teruel,44029,Ariño,2,9,-7
2013,Teruel,44031,Azaila,0,2,-2
2013,Teruel,44035,Barrachina,0,4,-4
2013,Teruel,44034,Bañón,0,5,-5
2013,Teruel,44037,Beceite,7,10,-3
2013,Teruel,44039,Bello,0,7,-7
2013,Teruel,44038,Belmonte de San José,0,2,-2
2013,Teruel,44040,Berge,0,2,-2
2013,Teruel,44041,Bezas,0,1,-1
2013,Teruel,44042,Blancas,0,3,-3
2013,Teruel,44043,Blesa,0,1,-1
2013,Teruel,44044,Bordón,0,2,-2
2013,Teruel,44045,Bronchales,2,4,-2
2013,Teruel,44046,Bueña,0,1,-1
2013,Teruel,44047,Burbáguena,0,15,-15
2013,Teruel,44032,Bádenas,1,1,0
2013,Teruel,44033,Báguena,1,9,-8
2013,Teruel,44048,Cabra de Mora,1,1,0
2013,Teruel,44049,Calaceite,5,19,-14
2013,Teruel,44050,Calamocha,31,42,-11
2013,Teruel,44051,Calanda,32,50,-18
2013,Teruel,44052,Calomarde,0,2,-2
2013,Teruel,44053,Camañas,0,2,-2
2013,Teruel,44056,Caminreal,4,13,-9
2013,Teruel,44059,Cantavieja,6,13,-7
2013,Teruel,44064,Cascante del Río,0,1,-1
2013,Teruel,44066,Castel de Cabra,0,2,-2
2013,Teruel,44070,Castellar (El),0,1,-1
2013,Teruel,44071,Castellote,3,16,-13
2013,Teruel,44067,Castelnou,1,2,-1
2013,Teruel,44068,Castelserás,7,11,-4
2013,Teruel,44060,Cañada de Benatanduz,0,1,-1
2013,Teruel,44061,Cañada de Verich (La),0,2,-2
2013,Teruel,44062,Cañada Vellida,0,1,-1
2013,Teruel,44063,Cañizar del Olivar,0,2,-2
2013,Teruel,44074,Cedrillas,5,8,-3
2013,Teruel,44075,Celadas,2,6,-4
2013,Teruel,44076,Cella,16,28,-12
2013,Teruel,44077,Cerollera (La),0,2,-2
2013,Teruel,44080,Codoñera (La),3,2,1
2013,Teruel,44082,Corbalán,1,0,1
2013,Teruel,44084,Cortes de Aragón,0,4,-4
2013,Teruel,44085,Cosa,0,3,-3
2013,Teruel,44086,Cretas,4,10,-6
2013,Teruel,44088,Cuba (La),0,2,-2
2013,Teruel,44090,Cucalón,1,2,-1
2013,Teruel,44092,Cuervo (El),0,4,-4
2013,Teruel,44093,Cuevas de Almudén,3,1,2
2013,Teruel,44094,Cuevas Labradas,0,1,-1
2013,Teruel,44096,Ejulve,1,4,-3
2013,Teruel,44097,Escorihuela,1,2,-1
2013,Teruel,44099,Escucha,8,10,-2
2013,Teruel,44100,Estercuel,3,3,0
2013,Teruel,44101,Ferreruela de Huerva,0,1,-1
2013,Teruel,44103,Formiche Alto,0,3,-3
2013,Teruel,44106,Fortanete,1,1,0
2013,Teruel,44107,Foz-Calanda,2,2,0
2013,Teruel,44108,Fresneda (La),5,4,1
2013,Teruel,44109,Frías de Albarracín,2,2,0
2013,Teruel,44110,Fuenferrada,1,0,1
2013,Teruel,44111,Fuentes Calientes,1,2,-1
2013,Teruel,44112,Fuentes Claras,2,7,-5
2013,Teruel,44113,Fuentes de Rubielos,1,1,0
2013,Teruel,44114,Fuentespalda,1,5,-4
2013,Teruel,44115,Galve,2,2,0
2013,Teruel,44116,Gargallo,1,3,-2
2013,Teruel,44117,Gea de Albarracín,2,6,-4
2013,Teruel,44118,Ginebrosa (La),1,0,1
2013,Teruel,44120,Guadalaviar,2,1,1
2013,Teruel,44121,Gúdar,2,1,1
2013,Teruel,44123,Hinojosa de Jarque,1,4,-3
2013,Teruel,44124,Hoz de la Vieja (La),0,1,-1
2013,Teruel,44125,Huesa del Común,0,2,-2
2013,Teruel,44122,Híjar,15,20,-5
2013,Teruel,44126,Iglesuela del Cid (La),0,3,-3
2013,Teruel,44128,Jarque de la Val,0,2,-2
2013,Teruel,44129,Jatiel,0,1,-1
2013,Teruel,44130,Jorcas,0,1,-1
2013,Teruel,44131,Josa,0,1,-1
2013,Teruel,44135,Libros,0,4,-4
2013,Teruel,44136,Lidón,0,1,-1
2013,Teruel,44137,Linares de Mora,1,6,-5
2013,Teruel,44141,Lledó,3,5,-2
2013,Teruel,44138,Loscos,0,3,-3
2013,Teruel,44143,Manzanera,3,7,-4
2013,Teruel,44144,Martín del Río,0,4,-4
2013,Teruel,44145,Mas de las Matas,13,20,-7
2013,Teruel,44146,Mata de los Olmos (La),6,4,2
2013,Teruel,44147,Mazaleón,1,9,-8
2013,Teruel,44148,Mezquita de Jarque,2,2,0
2013,Teruel,44149,Mirambel,1,1,0
2013,Teruel,44151,Molinos,3,4,-1
2013,Teruel,44152,Monforte de Moyuela,0,1,-1
2013,Teruel,44153,Monreal del Campo,28,38,-10
2013,Teruel,44154,Monroyo,3,5,-2
2013,Teruel,44155,Montalbán,7,19,-12
2013,Teruel,44156,Monteagudo del Castillo,0,1,-1
2013,Teruel,44157,Monterde de Albarracín,0,1,-1
2013,Teruel,44158,Mora de Rubielos,16,20,-4
2013,Teruel,44160,Mosqueruela,4,3,1
2013,Teruel,44161,Muniesa,5,7,-2
2013,Teruel,44163,Noguera de Albarracín,0,1,-1
2013,Teruel,44165,Nogueruelas,1,3,-2
2013,Teruel,44167,Obón,0,4,-4
2013,Teruel,44168,Odón,1,3,-2
2013,Teruel,44169,Ojos Negros,0,6,-6
2013,Teruel,44171,Olba,3,3,0
2013,Teruel,44172,Oliete,0,9,-9
2013,Teruel,44173,Olmos (Los),0,5,-5
2013,Teruel,44174,Orihuela del Tremedal,1,6,-5
2013,Teruel,44175,Orrios,0,4,-4
2013,Teruel,44176,Palomar de Arroyos,2,0,2
2013,Teruel,44177,Pancrudo,0,2,-2
2013,Teruel,44178,Parras de Castellote (Las),0,2,-2
2013,Teruel,44182,Perales del Alfambra,0,3,-3
2013,Teruel,44179,Peñarroya de Tastavins,4,7,-3
2013,Teruel,44183,Pitarque,0,0,0
2013,Teruel,44184,Plou,1,0,1
2013,Teruel,44185,Pobo (El),1,3,-2
2013,Teruel,44187,Portellada (La),5,4,1
2013,Teruel,44189,Pozondón,1,1,0
2013,Teruel,44190,Pozuel del Campo,0,1,-1
2013,Teruel,44191,Puebla de Híjar (La),9,20,-11
2013,Teruel,44192,Puebla de Valverde (La),2,7,-5
2013,Teruel,44193,Puertomingalvo,1,0,1
2013,Teruel,44195,Rillo,0,1,-1
2013,Teruel,44196,Riodeva,1,4,-3
2013,Teruel,44198,Royuela,2,3,-1
2013,Teruel,44200,Rubielos de la Cérida,0,1,-1
2013,Teruel,44201,Rubielos de Mora,8,9,-1
2013,Teruel,44194,Ráfales,0,1,-1
2013,Teruel,44197,Ródenas,1,0,1
2013,Teruel,44205,Samper de Calanda,5,10,-5
2013,Teruel,44206,San Agustín,0,3,-3
2013,Teruel,44207,San Martín del Río,0,3,-3
2013,Teruel,44208,Santa Cruz de Nogueras,0,1,-1
2013,Teruel,44209,Santa Eulalia,8,15,-7
2013,Teruel,44210,Sarrión,16,14,2
2013,Teruel,44213,Singra,0,1,-1
2013,Teruel,44215,Terriente,2,1,1
2013,Teruel,44216,Teruel,353,339,14
2013,Teruel,44217,Toril y Masegoso,0,1,-1
2013,Teruel,44218,Tormón,0,2,-2
2013,Teruel,44220,Torralba de los Sisones,1,4,-3
2013,Teruel,44223,Torre de Arcas,0,3,-3
2013,Teruel,44225,Torre del Compte,1,2,-1
2013,Teruel,44227,Torre los Negros,1,0,1
2013,Teruel,44221,Torrecilla de Alcañiz,2,7,-5
2013,Teruel,44222,Torrecilla del Rebollar,0,2,-2
2013,Teruel,44226,Torrelacárcel,3,6,-3
2013,Teruel,44228,Torremocha de Jiloca,0,4,-4
2013,Teruel,44229,Torres de Albarracín,1,1,0
2013,Teruel,44230,Torrevelilla,1,3,-2
2013,Teruel,44232,Torrijo del Campo,2,8,-6
2013,Teruel,44234,Tramacastiel,0,2,-2
2013,Teruel,44235,Tramacastilla,0,1,-1
2013,Teruel,44236,Tronchón,0,1,-1
2013,Teruel,44237,Urrea de Gaén,2,11,-9
2013,Teruel,44238,Utrillas,19,32,-13
2013,Teruel,44240,Valbona,0,1,-1
2013,Teruel,44241,Valdealgorfa,3,11,-8
2013,Teruel,44243,Valdecuenca,0,1,-1
2013,Teruel,44244,Valdelinares,1,1,0
2013,Teruel,44245,Valdeltormo,1,7,-6
2013,Teruel,44246,Valderrobres,27,37,-10
2013,Teruel,44247,Valjunquera,0,9,-9
2013,Teruel,44250,Veguillas de la Sierra,0,2,-2
2013,Teruel,44251,Villafranca del Campo,2,6,-4
2013,Teruel,44252,Villahermosa del Campo,0,1,-1
2013,Teruel,44256,Villanueva del Rebollar de la Sierra,1,1,0
2013,Teruel,44257,Villar del Cobo,1,4,-3
2013,Teruel,44260,Villarluengo,3,1,2
2013,Teruel,44261,Villarquemado,5,12,-7
2013,Teruel,44262,Villarroya de los Pinares,2,3,-1
2013,Teruel,44263,Villastar,11,4,7
2013,Teruel,44264,Villel,4,5,-1
2013,Teruel,44265,Vinaceite,2,3,-1
2013,Teruel,44266,Visiedo,2,4,-2
2013,Zaragoza,50001,Abanto,0,6,-6
2013,Zaragoza,50002,Acered,2,2,0
2013,Zaragoza,50004,Aguarón,2,9,-7
2013,Zaragoza,50005,Aguilón,1,2,-1
2013,Zaragoza,50003,Agón,1,4,-3
2013,Zaragoza,50006,Ainzón,1,16,-15
2013,Zaragoza,50007,Aladrén,0,1,-1
2013,Zaragoza,50008,Alagón,63,73,-10
2013,Zaragoza,50009,Alarba,0,2,-2
2013,Zaragoza,50010,Alberite de San Juan,0,1,-1
2013,Zaragoza,50011,Albeta,0,4,-4
2013,Zaragoza,50013,Alcalá de Ebro,1,3,-2
2013,Zaragoza,50014,Alcalá de Moncayo,1,4,-3
2013,Zaragoza,50016,Aldehuela de Liestos,0,2,-2
2013,Zaragoza,50017,Alfajarín,32,23,9
2013,Zaragoza,50018,Alfamén,8,22,-14
2013,Zaragoza,50019,Alforque,0,1,-1
2013,Zaragoza,50020,Alhama de Aragón,10,13,-3
2013,Zaragoza,50022,Almolda (La),1,5,-4
2013,Zaragoza,50023,Almonacid de la Cuba,0,2,-2
2013,Zaragoza,50024,Almonacid de la Sierra,8,15,-7
2013,Zaragoza,50025,Almunia de Doña Godina (La),51,73,-22
2013,Zaragoza,50026,Alpartir,6,5,1
2013,Zaragoza,50027,Ambel,0,6,-6
2013,Zaragoza,50029,Aniñón,2,10,-8
2013,Zaragoza,50031,Aranda de Moncayo,1,3,-2
2013,Zaragoza,50033,Ardisa,0,1,-1
2013,Zaragoza,50034,Ariza,8,21,-13
2013,Zaragoza,50035,Artieda,1,2,-1
2013,Zaragoza,50032,Arándiga,0,7,-7
2013,Zaragoza,50037,Atea,0,1,-1
2013,Zaragoza,50038,Ateca,3,18,-15
2013,Zaragoza,50039,Azuara,4,17,-13
2013,Zaragoza,50030,Añón de Moncayo,3,5,-2
2013,Zaragoza,50040,Badules,0,1,-1
2013,Zaragoza,50044,Bardallur,2,4,-2
2013,Zaragoza,50045,Belchite,7,18,-11
2013,Zaragoza,50046,Belmonte de Gracián,1,6,-5
2013,Zaragoza,50901,Biel,0,1,-1
2013,Zaragoza,50050,Bijuesca,0,1,-1
2013,Zaragoza,50051,Biota,1,19,-18
2013,Zaragoza,50052,Bisimbre,0,3,-3
2013,Zaragoza,50053,Boquiñeni,11,10,1
2013,Zaragoza,50055,Borja,39,50,-11
2013,Zaragoza,50056,Botorrita,2,3,-1
2013,Zaragoza,50057,Brea de Aragón,6,29,-23
2013,Zaragoza,50058,Bubierca,0,2,-2
2013,Zaragoza,50059,Bujaraloz,3,13,-10
2013,Zaragoza,50060,Bulbuente,1,8,-7
2013,Zaragoza,50061,Bureta,0,7,-7
2013,Zaragoza,50062,Burgo de Ebro (El),36,17,19
2013,Zaragoza,50063,Buste (El),0,0,0
2013,Zaragoza,50043,Bárboles,1,1,0
2013,Zaragoza,50064,Cabañas de Ebro,0,9,-9
2013,Zaragoza,50066,Cadrete,44,17,27
2013,Zaragoza,50067,Calatayud,154,208,-54
2013,Zaragoza,50068,Calatorao,22,25,-3
2013,Zaragoza,50069,Calcena,0,5,-5
2013,Zaragoza,50070,Calmarza,0,2,-2
2013,Zaragoza,50071,Campillo de Aragón,0,0,0
2013,Zaragoza,50072,Carenas,2,2,0
2013,Zaragoza,50073,Cariñena,27,50,-23
2013,Zaragoza,50074,Caspe,98,97,1
2013,Zaragoza,50075,Castejón de Alarba,0,1,-1
2013,Zaragoza,50076,Castejón de las Armas,0,2,-2
2013,Zaragoza,50077,Castejón de Valdejasa,1,5,-4
2013,Zaragoza,50078,Castiliscar,0,2,-2
2013,Zaragoza,50079,Cervera de la Cañada,1,7,-6
2013,Zaragoza,50081,Cetina,4,9,-5
2013,Zaragoza,50092,Chiprana,5,6,-1
2013,Zaragoza,50093,Chodes,0,0,0
2013,Zaragoza,50082,Cimballa,1,3,-2
2013,Zaragoza,50083,Cinco Olivas,0,2,-2
2013,Zaragoza,50084,Clarés de Ribota,0,3,-3
2013,Zaragoza,50085,Codo,0,7,-7
2013,Zaragoza,50086,Codos,0,2,-2
2013,Zaragoza,50087,Contamina,1,1,0
2013,Zaragoza,50088,Cosuenda,5,6,-1
2013,Zaragoza,50089,Cuarte de Huerva,229,29,200
2013,Zaragoza,50090,Cubel,1,3,-2
2013,Zaragoza,50091,Cuerlas (Las),0,1,-1
2013,Zaragoza,50094,Daroca,13,44,-31
2013,Zaragoza,50095,Ejea de los Caballeros,130,157,-27
2013,Zaragoza,50096,Embid de Ariza,0,2,-2
2013,Zaragoza,50098,Encinacorba,0,3,-3
2013,Zaragoza,50100,Erla,1,5,-4
2013,Zaragoza,50101,Escatrón,5,24,-19
2013,Zaragoza,50102,Fabara,8,18,-10
2013,Zaragoza,50104,Farlete,1,5,-4
2013,Zaragoza,50106,Fayos (Los),1,2,-1
2013,Zaragoza,50105,Fayón,2,7,-5
2013,Zaragoza,50107,Figueruelas,9,18,-9
2013,Zaragoza,50108,Fombuena,1,0,1
2013,Zaragoza,50109,Frago (El),0,1,-1
2013,Zaragoza,50110,Frasno (El),1,5,-4
2013,Zaragoza,50111,Fréscano,1,3,-2
2013,Zaragoza,50113,Fuendejalón,5,10,-5
2013,Zaragoza,50114,Fuendetodos,0,1,-1
2013,Zaragoza,50115,Fuentes de Ebro,47,42,5
2013,Zaragoza,50116,Fuentes de Jiloca,3,3,0
2013,Zaragoza,50117,Gallocanta,3,1,2
2013,Zaragoza,50118,Gallur,18,40,-22
2013,Zaragoza,50119,Gelsa,7,18,-11
2013,Zaragoza,50120,Godojos,0,2,-2
2013,Zaragoza,50121,Gotor,0,2,-2
2013,Zaragoza,50122,Grisel,0,1,-1
2013,Zaragoza,50123,Grisén,7,5,2
2013,Zaragoza,50124,Herrera de los Navarros,7,6,1
2013,Zaragoza,50125,Ibdes,1,6,-5
2013,Zaragoza,50126,Illueca,15,28,-13
2013,Zaragoza,50128,Isuerre,0,1,-1
2013,Zaragoza,50129,Jaraba,2,6,-4
2013,Zaragoza,50130,Jarque de Moncayo,4,4,0
2013,Zaragoza,50131,Jaulín,1,8,-7
2013,Zaragoza,50132,Joyosa (La),15,4,11
2013,Zaragoza,50133,Lagata,0,2,-2
2013,Zaragoza,50134,Langa del Castillo,0,2,-2
2013,Zaragoza,50138,Lechón,0,1,-1
2013,Zaragoza,50137,Leciñena,5,18,-13
2013,Zaragoza,50139,Letux,0,13,-13
2013,Zaragoza,50140,Litago,0,2,-2
2013,Zaragoza,50141,Lituénigo,1,1,0
2013,Zaragoza,50143,Longares,4,16,-12
2013,Zaragoza,50146,Lucena de Jalón,0,6,-6
2013,Zaragoza,50147,Luceni,1,16,-15
2013,Zaragoza,50148,Luesia,0,5,-5
2013,Zaragoza,50150,Lumpiaque,10,11,-1
2013,Zaragoza,50151,Luna,1,10,-9
2013,Zaragoza,50136,Lécera,3,11,-8
2013,Zaragoza,50152,Maella,13,28,-15
2013,Zaragoza,50153,Magallón,7,21,-14
2013,Zaragoza,50154,Mainar,0,1,-1
2013,Zaragoza,50155,Malanquilla,0,1,-1
2013,Zaragoza,50156,Maleján,1,5,-4
2013,Zaragoza,50160,Mallén,22,36,-14
2013,Zaragoza,50159,Maluenda,2,11,-9
2013,Zaragoza,50157,Malón,5,9,-4
2013,Zaragoza,50161,Manchones,0,1,-1
2013,Zaragoza,50162,Mara,0,4,-4
2013,Zaragoza,50163,María de Huerva,99,22,77
2013,Zaragoza,50164,Mediana de Aragón,3,3,0
2013,Zaragoza,50165,Mequinenza,22,32,-10
2013,Zaragoza,50166,Mesones de Isuela,0,9,-9
2013,Zaragoza,50167,Mezalocha,0,2,-2
2013,Zaragoza,50168,Mianos,0,1,-1
2013,Zaragoza,50169,Miedes de Aragón,2,7,-5
2013,Zaragoza,50170,Monegrillo,1,3,-2
2013,Zaragoza,50171,Moneva,0,1,-1
2013,Zaragoza,50172,Monreal de Ariza,0,2,-2
2013,Zaragoza,50173,Monterde,1,3,-2
2013,Zaragoza,50175,Morata de Jalón,5,18,-13
2013,Zaragoza,50176,Morata de Jiloca,0,5,-5
2013,Zaragoza,50178,Moros,0,10,-10
2013,Zaragoza,50177,Morés,0,6,-6
2013,Zaragoza,50179,Moyuela,0,5,-5
2013,Zaragoza,50180,Mozota,3,1,2
2013,Zaragoza,50181,Muel,18,13,5
2013,Zaragoza,50182,Muela (La),83,22,61
2013,Zaragoza,50183,Munébrega,0,10,-10
2013,Zaragoza,50184,Murero,0,3,-3
2013,Zaragoza,50185,Murillo de Gállego,2,0,2
2013,Zaragoza,50186,Navardún,0,1,-1
2013,Zaragoza,50188,Nombrevilla,0,1,-1
2013,Zaragoza,50189,Nonaspe,6,14,-8
2013,Zaragoza,50190,Novallas,8,14,-6
2013,Zaragoza,50191,Novillas,2,11,-9
2013,Zaragoza,50193,Nuez de Ebro,6,5,1
2013,Zaragoza,50192,Nuévalos,1,3,-2
2013,Zaragoza,50194,Olvés,1,1,0
2013,Zaragoza,50195,Orcajo,0,1,-1
2013,Zaragoza,50196,Orera,0,2,-2
2013,Zaragoza,50197,Orés,0,1,-1
2013,Zaragoza,50199,Osera de Ebro,3,8,-5
2013,Zaragoza,50200,Paniza,5,8,-3
2013,Zaragoza,50201,Paracuellos de Jiloca,6,9,-3
2013,Zaragoza,50202,Paracuellos de la Ribera,0,3,-3
2013,Zaragoza,50203,Pastriz,7,12,-5
2013,Zaragoza,50204,Pedrola,28,31,-3
2013,Zaragoza,50205,Pedrosas (Las),2,0,2
2013,Zaragoza,50206,Perdiguera,3,9,-6
2013,Zaragoza,50207,Piedratajada,0,1,-1
2013,Zaragoza,50208,Pina de Ebro,18,20,-2
2013,Zaragoza,50209,Pinseque,46,47,-1
2013,Zaragoza,50210,Pintanos (Los),1,1,0
2013,Zaragoza,50211,Plasencia de Jalón,1,8,-7
2013,Zaragoza,50212,Pleitas,0,1,-1
2013,Zaragoza,50213,Plenas,0,2,-2
2013,Zaragoza,50215,Pozuel de Ariza,0,1,-1
2013,Zaragoza,50216,Pozuelo de Aragón,0,9,-9
2013,Zaragoza,50217,Pradilla de Ebro,3,14,-11
2013,Zaragoza,50218,Puebla de Albortón,2,1,1
2013,Zaragoza,50219,Puebla de Alfindén (La),81,20,61
2013,Zaragoza,50220,Puendeluna,0,2,-2
2013,Zaragoza,50222,Quinto,9,20,-11
2013,Zaragoza,50223,Remolinos,5,25,-20
2013,Zaragoza,50224,Retascón,0,1,-1
2013,Zaragoza,50225,Ricla,20,26,-6
2013,Zaragoza,50227,Romanos,1,2,-1
2013,Zaragoza,50228,Rueda de Jalón,5,2,3
2013,Zaragoza,50231,Salillas de Jalón,2,4,-2
2013,Zaragoza,50232,Salvatierra de Esca,1,4,-3
2013,Zaragoza,50233,Samper del Salz,0,1,-1
2013,Zaragoza,50234,San Martín de la Virgen de Moncayo,3,8,-5
2013,Zaragoza,50235,San Mateo de Gállego,27,32,-5
2013,Zaragoza,50236,Santa Cruz de Grío,0,2,-2
2013,Zaragoza,50237,Santa Cruz de Moncayo,0,1,-1
2013,Zaragoza,50238,Santa Eulalia de Gállego,0,1,-1
2013,Zaragoza,50239,Santed,0,2,-2
2013,Zaragoza,50241,Saviñán,2,5,-3
2013,Zaragoza,50242,Sediles,0,1,-1
2013,Zaragoza,50243,Sestrica,0,7,-7
2013,Zaragoza,50244,Sierra de Luna,1,4,-3
2013,Zaragoza,50245,Sigüés,0,4,-4
2013,Zaragoza,50246,Sisamón,0,1,-1
2013,Zaragoza,50247,Sobradiel,18,13,5
2013,Zaragoza,50248,Sos del Rey Católico,5,11,-6
2013,Zaragoza,50230,Sádaba,2,30,-28
2013,Zaragoza,50240,Sástago,8,16,-8
2013,Zaragoza,50249,Tabuenca,1,3,-2
2013,Zaragoza,50251,Tarazona,96,127,-31
2013,Zaragoza,50252,Tauste,32,89,-57
2013,Zaragoza,50253,Terrer,4,9,-5
2013,Zaragoza,50254,Tierga,0,2,-2
2013,Zaragoza,50255,Tobed,0,8,-8
2013,Zaragoza,50256,Torralba de los Frailes,0,1,-1
2013,Zaragoza,50257,Torralba de Ribota,0,4,-4
2013,Zaragoza,50261,Torrellas,0,4,-4
2013,Zaragoza,50262,Torres de Berrellén,13,17,-4
2013,Zaragoza,50263,Torrijo de la Cañada,1,6,-5
2013,Zaragoza,50264,Tosos,0,3,-3
2013,Zaragoza,50266,Trasobares,0,2,-2
2013,Zaragoza,50267,Uncastillo,0,16,-16
2013,Zaragoza,50268,Undués de Lerda,1,0,1
2013,Zaragoza,50269,Urrea de Jalón,4,8,-4
2013,Zaragoza,50270,Urriés,0,1,-1
2013,Zaragoza,50271,Used,0,1,-1
2013,Zaragoza,50272,Utebo,211,83,128
2013,Zaragoza,50274,Val de San Martín,0,1,-1
2013,Zaragoza,50275,Valmadrid,1,6,-5
2013,Zaragoza,50276,Valpalmas,0,6,-6
2013,Zaragoza,50278,Velilla de Ebro,4,3,1
2013,Zaragoza,50279,Velilla de Jiloca,0,3,-3
2013,Zaragoza,50280,Vera de Moncayo,3,8,-5
2013,Zaragoza,50281,Vierlas,1,1,0
2013,Zaragoza,50284,Villafeliche,0,7,-7
2013,Zaragoza,50285,Villafranca de Ebro,5,15,-10
2013,Zaragoza,50286,Villalba de Perejil,1,1,0
2013,Zaragoza,50287,Villalengua,1,7,-6
2013,Zaragoza,50903,Villamayor de Gállego,19,23,-4
2013,Zaragoza,50288,Villanueva de Gállego,40,35,5
2013,Zaragoza,50290,Villanueva de Huerva,1,15,-14
2013,Zaragoza,50289,Villanueva de Jiloca,0,5,-5
2013,Zaragoza,50291,Villar de los Navarros,0,2,-2
2013,Zaragoza,50292,Villarreal de Huerva,2,3,-1
2013,Zaragoza,50293,Villarroya de la Sierra,1,12,-11
2013,Zaragoza,50282,Vilueña (La),1,0,1
2013,Zaragoza,50296,Zaida (La),4,5,-1
2013,Zaragoza,50297,Zaragoza,6175,6110,65
2013,Zaragoza,50298,Zuera,71,67,4
2013,Zaragoza,50099,Épila,48,62,-14
2012,Huesca,22001,Abiego,0,1,-1
2012,Huesca,22003,Adahuesca,3,4,-1
2012,Huesca,22004,Agüero,0,7,-7
2012,Huesca,22007,Albalate de Cinca,11,10,1
2012,Huesca,22008,Albalatillo,0,2,-2
2012,Huesca,22009,Albelda,3,15,-12
2012,Huesca,22011,Albero Alto,0,2,-2
2012,Huesca,22012,Albero Bajo,1,0,1
2012,Huesca,22013,Alberuela de Tubo,1,7,-6
2012,Huesca,22014,Alcalá de Gurrea,3,0,3
2012,Huesca,22015,Alcalá del Obispo,0,6,-6
2012,Huesca,22016,Alcampell,0,14,-14
2012,Huesca,22017,Alcolea de Cinca,9,8,1
2012,Huesca,22018,Alcubierre,1,6,-5
2012,Huesca,22019,Alerre,1,2,-1
2012,Huesca,22020,Alfántega,2,1,1
2012,Huesca,22021,Almudévar,21,36,-15
2012,Huesca,22022,Almunia de San Juan,13,10,3
2012,Huesca,22023,Almuniente,4,7,-3
2012,Huesca,22024,Alquézar,1,1,0
2012,Huesca,22025,Altorricón,10,18,-8
2012,Huesca,22027,Angüés,2,6,-4
2012,Huesca,22028,Ansó,4,7,-3
2012,Huesca,22029,Antillón,0,2,-2
2012,Huesca,22032,Aragüés del Puerto,1,1,0
2012,Huesca,22036,Argavieso,0,1,-1
2012,Huesca,22035,Arén,2,4,-2
2012,Huesca,22039,Ayerbe,10,14,-4
2012,Huesca,22040,Azanuy-Alins,1,8,-7
2012,Huesca,22041,Azara,1,6,-5
2012,Huesca,22042,Azlor,1,5,-4
2012,Huesca,22907,Aínsa-Sobrarbe,15,17,-2
2012,Huesca,22006,Aísa,0,2,-2
2012,Huesca,22043,Baells,0,6,-6
2012,Huesca,22044,Bailo,2,5,-3
2012,Huesca,22046,Ballobar,10,13,-3
2012,Huesca,22047,Banastás,2,2,0
2012,Huesca,22048,Barbastro,172,198,-26
2012,Huesca,22049,Barbués,0,2,-2
2012,Huesca,22050,Barbuñales,0,1,-1
2012,Huesca,22052,Belver de Cinca,8,23,-15
2012,Huesca,22053,Benabarre,5,31,-26
2012,Huesca,22054,Benasque,20,15,5
2012,Huesca,22055,Berbegal,0,5,-5
2012,Huesca,22057,Bielsa,3,1,2
2012,Huesca,22058,Bierge,1,2,-1
2012,Huesca,22059,Biescas,12,18,-6
2012,Huesca,22060,Binaced,9,29,-20
2012,Huesca,22061,Binéfar,93,80,13
2012,Huesca,22062,Bisaurri,0,2,-2
2012,Huesca,22063,Biscarrués,2,3,-1
2012,Huesca,22064,Blecua y Torres,0,4,-4
2012,Huesca,22066,Boltaña,9,11,-2
2012,Huesca,22067,Bonansa,0,0,0
2012,Huesca,22069,Broto,1,6,-5
2012,Huesca,22051,Bárcabo,0,1,-1
2012,Huesca,22072,Caldearenas,2,3,-1
2012,Huesca,22074,Campo,0,2,-2
2012,Huesca,22075,Camporrells,0,4,-4
2012,Huesca,22076,Canal de Berdún,1,12,-11
2012,Huesca,22077,Candasnos,1,2,-1
2012,Huesca,22078,Canfranc,2,4,-2
2012,Huesca,22079,Capdesaso,0,2,-2
2012,Huesca,22080,Capella,2,5,-3
2012,Huesca,22081,Casbas de Huesca,0,4,-4
2012,Huesca,22083,Castejón de Monegros,7,5,2
2012,Huesca,22084,Castejón de Sos,12,12,0
2012,Huesca,22082,Castejón del Puente,1,7,-6
2012,Huesca,22085,Castelflorite,1,1,0
2012,Huesca,22086,Castiello de Jaca,1,0,1
2012,Huesca,22087,Castigaleu,1,0,1
2012,Huesca,22088,Castillazuelo,0,4,-4
2012,Huesca,22089,Castillonroy,0,5,-5
2012,Huesca,22094,Chalamera,0,2,-2
2012,Huesca,22096,Chimillas,1,8,-7
2012,Huesca,22095,Chía,0,3,-3
2012,Huesca,22090,Colungo,0,2,-2
2012,Huesca,22099,Esplús,9,14,-5
2012,Huesca,22102,Estada,0,4,-4
2012,Huesca,22103,Estadilla,7,14,-7
2012,Huesca,22105,Estopiñán del Castillo,1,4,-3
2012,Huesca,22106,Fago,0,1,-1
2012,Huesca,22107,Fanlo,0,1,-1
2012,Huesca,22109,Fiscal,2,3,-1
2012,Huesca,22110,Fonz,3,19,-16
2012,Huesca,22111,Foradada del Toscar,0,4,-4
2012,Huesca,22112,Fraga,165,124,41
2012,Huesca,22113,Fueva (La),3,6,-3
2012,Huesca,22114,Gistaín,0,1,-1
2012,Huesca,22115,Grado (El),2,9,-7
2012,Huesca,22117,Graus,35,57,-22
2012,Huesca,22116,Grañén,20,29,-9
2012,Huesca,22119,Gurrea de Gállego,10,33,-23
2012,Huesca,22908,Hoz y Costeán,0,1,-1
2012,Huesca,22124,Huerto,0,4,-4
2012,Huesca,22125,Huesca,552,532,20
2012,Huesca,22126,Ibieca,1,1,0
2012,Huesca,22127,Igriés,9,7,2
2012,Huesca,22128,Ilche,0,3,-3
2012,Huesca,22129,Isábena,2,3,-1
2012,Huesca,22130,Jaca,115,139,-24
2012,Huesca,22131,Jasa,0,3,-3
2012,Huesca,22133,Labuerda,1,1,0
2012,Huesca,22135,Laluenga,1,0,1
2012,Huesca,22136,Lalueza,1,24,-23
2012,Huesca,22137,Lanaja,3,15,-12
2012,Huesca,22139,Laperdiguera,0,2,-2
2012,Huesca,22141,Lascellas-Ponzano,0,2,-2
2012,Huesca,22142,Lascuarre,2,4,-2
2012,Huesca,22143,Laspaúles,1,4,-3
2012,Huesca,22144,Laspuña,0,2,-2
2012,Huesca,22149,Loarre,0,5,-5
2012,Huesca,22150,Loporzano,0,6,-6
2012,Huesca,22905,Lupiñén-Ortilla,1,4,-3
2012,Huesca,22155,Monesma y Cajigar,1,2,-1
2012,Huesca,22156,Monflorite-Lascasas,2,3,-1
2012,Huesca,22157,Montanuy,1,6,-5
2012,Huesca,22158,Monzón,167,156,11
2012,Huesca,22160,Naval,2,4,-2
2012,Huesca,22162,Novales,0,3,-3
2012,Huesca,22163,Nueno,7,7,0
2012,Huesca,22165,Ontiñena,4,4,0
2012,Huesca,22167,Osso de Cinca,4,6,-2
2012,Huesca,22168,Palo,0,1,-1
2012,Huesca,22170,Panticosa,3,5,-2
2012,Huesca,22174,Peralta de Alcofea,1,11,-10
2012,Huesca,22175,Peralta de Calasanz,2,5,-3
2012,Huesca,22177,Perarrúa,1,4,-3
2012,Huesca,22178,Pertusa,0,1,-1
2012,Huesca,22172,Peñalba,1,3,-2
2012,Huesca,22173,Peñas de Riglos (Las),2,3,-1
2012,Huesca,22181,Piracés,0,2,-2
2012,Huesca,22182,Plan,3,3,0
2012,Huesca,22184,Poleñino,2,4,-2
2012,Huesca,22186,Pozán de Vero,0,6,-6
2012,Huesca,22187,Puebla de Castro (La),4,5,-1
2012,Huesca,22188,Puente de Montañana,0,3,-3
2012,Huesca,22902,Puente la Reina de Jaca,2,2,0
2012,Huesca,22190,Pueyo de Araguás (El),1,2,-1
2012,Huesca,22193,Pueyo de Santa Cruz,4,5,-1
2012,Huesca,22189,Puértolas,0,2,-2
2012,Huesca,22195,Quicena,1,3,-2
2012,Huesca,22197,Robres,4,8,-4
2012,Huesca,22199,Sabiñánigo,83,104,-21
2012,Huesca,22200,Sahún,1,3,-2
2012,Huesca,22201,Salas Altas,0,7,-7
2012,Huesca,22202,Salas Bajas,0,7,-7
2012,Huesca,22203,Salillas,0,1,-1
2012,Huesca,22204,Sallent de Gállego,6,8,-2
2012,Huesca,22205,San Esteban de Litera,2,9,-7
2012,Huesca,22207,San Juan de Plan,1,4,-3
2012,Huesca,22903,San Miguel del Cinca,9,13,-4
2012,Huesca,22206,Sangarrén,1,2,-1
2012,Huesca,22208,Santa Cilia,1,3,-2
2012,Huesca,22209,Santa Cruz de la Serós,0,0,0
2012,Huesca,22906,Santa María de Dulcis,1,4,-3
2012,Huesca,22212,Santaliestra y San Quílez,1,0,1
2012,Huesca,22213,Sariñena,33,56,-23
2012,Huesca,22215,Seira,1,2,-1
2012,Huesca,22217,Sena,4,10,-6
2012,Huesca,22220,Sesa,0,3,-3
2012,Huesca,22221,Sesué,2,1,1
2012,Huesca,22222,Siétamo,9,3,6
2012,Huesca,22223,Sopeira,0,2,-2
2012,Huesca,22904,Sotonera (La),4,20,-16
2012,Huesca,22225,Tamarite de Litera,24,54,-30
2012,Huesca,22226,Tardienta,9,15,-6
2012,Huesca,22227,Tella-Sin,0,2,-2
2012,Huesca,22228,Tierz,8,3,5
2012,Huesca,22229,Tolva,0,3,-3
2012,Huesca,22230,Torla-Ordesa,2,4,-2
2012,Huesca,22232,Torralba de Aragón,1,2,-1
2012,Huesca,22234,Torrente de Cinca,0,8,-8
2012,Huesca,22235,Torres de Alcanadre,1,3,-2
2012,Huesca,22236,Torres de Barbués,1,5,-4
2012,Huesca,22239,Tramaced,1,2,-1
2012,Huesca,22242,Valfarta,0,1,-1
2012,Huesca,22901,Valle de Hecho,2,13,-11
2012,Huesca,22245,Velilla de Cinca,2,6,-4
2012,Huesca,22909,Vencillón,4,8,-4
2012,Huesca,22247,Viacamp y Litera,0,1,-1
2012,Huesca,22249,Villanova,5,0,5
2012,Huesca,22251,Villanueva de Sigena,1,7,-6
2012,Huesca,22250,Villanúa,5,3,2
2012,Huesca,22252,Yebra de Basa,0,5,-5
2012,Huesca,22253,Yésero,0,2,-2
2012,Huesca,22254,Zaidín,7,21,-14
2012,Teruel,44002,Abejuela,0,1,-1
2012,Teruel,44004,Aguaviva,4,7,-3
2012,Teruel,44005,Aguilar del Alfambra,0,1,-1
2012,Teruel,44006,Alacón,1,9,-8
2012,Teruel,44007,Alba,1,10,-9
2012,Teruel,44008,Albalate del Arzobispo,17,35,-18
2012,Teruel,44009,Albarracín,8,19,-11
2012,Teruel,44010,Albentosa,5,0,5
2012,Teruel,44011,Alcaine,0,1,-1
2012,Teruel,44012,Alcalá de la Selva,0,6,-6
2012,Teruel,44013,Alcañiz,188,171,17
2012,Teruel,44014,Alcorisa,27,34,-7
2012,Teruel,44016,Alfambra,4,14,-10
2012,Teruel,44017,Aliaga,1,11,-10
2012,Teruel,44021,Allepuz,1,0,1
2012,Teruel,44022,Alloza,3,8,-5
2012,Teruel,44019,Alobras,0,0,0
2012,Teruel,44025,Andorra,79,79,0
2012,Teruel,44026,Arcos de las Salinas,1,2,-1
2012,Teruel,44027,Arens de Lledó,1,2,-1
2012,Teruel,44028,Argente,1,5,-4
2012,Teruel,44029,Ariño,4,9,-5
2012,Teruel,44031,Azaila,0,6,-6
2012,Teruel,44035,Barrachina,0,1,-1
2012,Teruel,44034,Bañón,3,3,0
2012,Teruel,44037,Beceite,1,8,-7
2012,Teruel,44039,Bello,0,10,-10
2012,Teruel,44038,Belmonte de San José,0,3,-3
2012,Teruel,44040,Berge,5,6,-1
2012,Teruel,44041,Bezas,0,1,-1
2012,Teruel,44042,Blancas,0,1,-1
2012,Teruel,44043,Blesa,0,1,-1
2012,Teruel,44044,Bordón,1,2,-1
2012,Teruel,44045,Bronchales,3,3,0
2012,Teruel,44047,Burbáguena,0,22,-22
2012,Teruel,44032,Bádenas,0,1,-1
2012,Teruel,44033,Báguena,2,5,-3
2012,Teruel,44048,Cabra de Mora,1,0,1
2012,Teruel,44049,Calaceite,14,14,0
2012,Teruel,44050,Calamocha,43,50,-7
2012,Teruel,44051,Calanda,23,38,-15
2012,Teruel,44052,Calomarde,0,1,-1
2012,Teruel,44054,Camarena de la Sierra,2,3,-1
2012,Teruel,44055,Camarillas,0,2,-2
2012,Teruel,44053,Camañas,2,1,1
2012,Teruel,44056,Caminreal,3,12,-9
2012,Teruel,44059,Cantavieja,9,9,0
2012,Teruel,44064,Cascante del Río,0,2,-2
2012,Teruel,44065,Castejón de Tornos,0,1,-1
2012,Teruel,44066,Castel de Cabra,1,4,-3
2012,Teruel,44071,Castellote,2,15,-13
2012,Teruel,44067,Castelnou,2,1,1
2012,Teruel,44068,Castelserás,6,14,-8
2012,Teruel,44060,Cañada de Benatanduz,0,2,-2
2012,Teruel,44061,Cañada de Verich (La),0,4,-4
2012,Teruel,44074,Cedrillas,1,10,-9
2012,Teruel,44075,Celadas,1,4,-3
2012,Teruel,44076,Cella,20,37,-17
2012,Teruel,44077,Cerollera (La),0,2,-2
2012,Teruel,44080,Codoñera (La),4,5,-1
2012,Teruel,44082,Corbalán,1,1,0
2012,Teruel,44085,Cosa,0,1,-1
2012,Teruel,44086,Cretas,6,12,-6
2012,Teruel,44087,Crivillén,0,3,-3
2012,Teruel,44089,Cubla,0,0,0
2012,Teruel,44092,Cuervo (El),1,3,-2
2012,Teruel,44093,Cuevas de Almudén,0,0,0
2012,Teruel,44094,Cuevas Labradas,0,2,-2
2012,Teruel,44096,Ejulve,0,3,-3
2012,Teruel,44097,Escorihuela,0,3,-3
2012,Teruel,44099,Escucha,4,10,-6
2012,Teruel,44100,Estercuel,2,2,0
2012,Teruel,44101,Ferreruela de Huerva,0,1,-1
2012,Teruel,44103,Formiche Alto,0,4,-4
2012,Teruel,44106,Fortanete,1,3,-2
2012,Teruel,44107,Foz-Calanda,1,2,-1
2012,Teruel,44108,Fresneda (La),2,5,-3
2012,Teruel,44109,Frías de Albarracín,1,2,-1
2012,Teruel,44110,Fuenferrada,0,3,-3
2012,Teruel,44111,Fuentes Calientes,1,2,-1
2012,Teruel,44112,Fuentes Claras,4,8,-4
2012,Teruel,44113,Fuentes de Rubielos,1,1,0
2012,Teruel,44114,Fuentespalda,4,4,0
2012,Teruel,44105,Fórnoles,1,4,-3
2012,Teruel,44115,Galve,0,3,-3
2012,Teruel,44116,Gargallo,2,0,2
2012,Teruel,44117,Gea de Albarracín,1,6,-5
2012,Teruel,44118,Ginebrosa (La),0,3,-3
2012,Teruel,44119,Griegos,2,1,1
2012,Teruel,44120,Guadalaviar,4,3,1
2012,Teruel,44121,Gúdar,2,0,2
2012,Teruel,44123,Hinojosa de Jarque,1,0,1
2012,Teruel,44124,Hoz de la Vieja (La),0,3,-3
2012,Teruel,44125,Huesa del Común,0,1,-1
2012,Teruel,44122,Híjar,15,34,-19
2012,Teruel,44126,Iglesuela del Cid (La),3,9,-6
2012,Teruel,44130,Jorcas,0,1,-1
2012,Teruel,44131,Josa,0,1,-1
2012,Teruel,44133,Lanzuela,1,0,1
2012,Teruel,44135,Libros,0,3,-3
2012,Teruel,44136,Lidón,1,1,0
2012,Teruel,44137,Linares de Mora,2,4,-2
2012,Teruel,44141,Lledó,0,4,-4
2012,Teruel,44138,Loscos,0,3,-3
2012,Teruel,44143,Manzanera,3,8,-5
2012,Teruel,44144,Martín del Río,2,6,-4
2012,Teruel,44145,Mas de las Matas,10,31,-21
2012,Teruel,44146,Mata de los Olmos (La),4,2,2
2012,Teruel,44147,Mazaleón,4,6,-2
2012,Teruel,44148,Mezquita de Jarque,1,2,-1
2012,Teruel,44149,Mirambel,1,3,-2
2012,Teruel,44150,Miravete de la Sierra,0,2,-2
2012,Teruel,44151,Molinos,4,5,-1
2012,Teruel,44153,Monreal del Campo,26,41,-15
2012,Teruel,44154,Monroyo,1,4,-3
2012,Teruel,44155,Montalbán,5,9,-4
2012,Teruel,44156,Monteagudo del Castillo,0,1,-1
2012,Teruel,44158,Mora de Rubielos,14,17,-3
2012,Teruel,44159,Moscardón,1,1,0
2012,Teruel,44160,Mosqueruela,2,5,-3
2012,Teruel,44161,Muniesa,3,18,-15
2012,Teruel,44163,Noguera de Albarracín,0,3,-3
2012,Teruel,44165,Nogueruelas,0,2,-2
2012,Teruel,44167,Obón,0,1,-1
2012,Teruel,44168,Odón,0,2,-2
2012,Teruel,44169,Ojos Negros,2,10,-8
2012,Teruel,44171,Olba,2,1,1
2012,Teruel,44172,Oliete,0,5,-5
2012,Teruel,44173,Olmos (Los),1,1,0
2012,Teruel,44174,Orihuela del Tremedal,4,5,-1
2012,Teruel,44175,Orrios,0,4,-4
2012,Teruel,44176,Palomar de Arroyos,0,1,-1
2012,Teruel,44177,Pancrudo,0,2,-2
2012,Teruel,44178,Parras de Castellote (Las),0,3,-3
2012,Teruel,44180,Peracense,0,2,-2
2012,Teruel,44181,Peralejos,0,1,-1
2012,Teruel,44182,Perales del Alfambra,1,2,-1
2012,Teruel,44179,Peñarroya de Tastavins,6,5,1
2012,Teruel,44184,Plou,1,0,1
2012,Teruel,44185,Pobo (El),1,3,-2
2012,Teruel,44187,Portellada (La),0,6,-6
2012,Teruel,44189,Pozondón,0,3,-3
2012,Teruel,44191,Puebla de Híjar (La),6,23,-17
2012,Teruel,44192,Puebla de Valverde (La),7,5,2
2012,Teruel,44193,Puertomingalvo,0,2,-2
2012,Teruel,44195,Rillo,1,2,-1
2012,Teruel,44196,Riodeva,0,0,0
2012,Teruel,44198,Royuela,0,2,-2
2012,Teruel,44199,Rubiales,0,2,-2
2012,Teruel,44200,Rubielos de la Cérida,0,1,-1
2012,Teruel,44201,Rubielos de Mora,3,6,-3
2012,Teruel,44194,Ráfales,2,3,-1
2012,Teruel,44197,Ródenas,1,2,-1
2012,Teruel,44205,Samper de Calanda,1,8,-7
2012,Teruel,44207,San Martín del Río,1,4,-3
2012,Teruel,44209,Santa Eulalia,5,21,-16
2012,Teruel,44210,Sarrión,17,9,8
2012,Teruel,44211,Segura de los Baños,0,1,-1
2012,Teruel,44212,Seno,0,2,-2
2012,Teruel,44213,Singra,0,1,-1
2012,Teruel,44215,Terriente,1,4,-3
2012,Teruel,44216,Teruel,331,318,13
2012,Teruel,44218,Tormón,0,1,-1
2012,Teruel,44219,Tornos,0,2,-2
2012,Teruel,44220,Torralba de los Sisones,1,5,-4
2012,Teruel,44223,Torre de Arcas,0,2,-2
2012,Teruel,44224,Torre de las Arcas,1,0,1
2012,Teruel,44225,Torre del Compte,0,6,-6
2012,Teruel,44227,Torre los Negros,0,1,-1
2012,Teruel,44221,Torrecilla de Alcañiz,0,6,-6
2012,Teruel,44226,Torrelacárcel,1,4,-3
2012,Teruel,44228,Torremocha de Jiloca,0,4,-4
2012,Teruel,44229,Torres de Albarracín,2,3,-1
2012,Teruel,44230,Torrevelilla,2,3,-1
2012,Teruel,44231,Torrijas,0,3,-3
2012,Teruel,44232,Torrijo del Campo,3,5,-2
2012,Teruel,44234,Tramacastiel,0,3,-3
2012,Teruel,44235,Tramacastilla,0,3,-3
2012,Teruel,44236,Tronchón,0,1,-1
2012,Teruel,44237,Urrea de Gaén,2,8,-6
2012,Teruel,44238,Utrillas,36,25,11
2012,Teruel,44240,Valbona,1,6,-5
2012,Teruel,44241,Valdealgorfa,3,5,-2
2012,Teruel,44243,Valdecuenca,0,1,-1
2012,Teruel,44244,Valdelinares,1,0,1
2012,Teruel,44245,Valdeltormo,2,5,-3
2012,Teruel,44246,Valderrobres,22,37,-15
2012,Teruel,44247,Valjunquera,2,9,-7
2012,Teruel,44250,Veguillas de la Sierra,0,2,-2
2012,Teruel,44251,Villafranca del Campo,1,5,-4
2012,Teruel,44257,Villar del Cobo,1,0,1
2012,Teruel,44258,Villar del Salz,0,2,-2
2012,Teruel,44260,Villarluengo,3,1,2
2012,Teruel,44261,Villarquemado,4,12,-8
2012,Teruel,44262,Villarroya de los Pinares,0,1,-1
2012,Teruel,44263,Villastar,11,1,10
2012,Teruel,44264,Villel,2,7,-5
2012,Teruel,44265,Vinaceite,1,6,-5
2012,Teruel,44266,Visiedo,0,2,-2
2012,Zaragoza,50001,Abanto,0,6,-6
2012,Zaragoza,50002,Acered,0,3,-3
2012,Zaragoza,50004,Aguarón,0,17,-17
2012,Zaragoza,50005,Aguilón,0,3,-3
2012,Zaragoza,50003,Agón,0,5,-5
2012,Zaragoza,50006,Ainzón,6,27,-21
2012,Zaragoza,50008,Alagón,73,78,-5
2012,Zaragoza,50009,Alarba,0,3,-3
2012,Zaragoza,50010,Alberite de San Juan,0,3,-3
2012,Zaragoza,50011,Albeta,0,1,-1
2012,Zaragoza,50012,Alborge,0,2,-2
2012,Zaragoza,50013,Alcalá de Ebro,2,2,0
2012,Zaragoza,50014,Alcalá de Moncayo,1,3,-2
2012,Zaragoza,50015,Alconchel de Ariza,0,1,-1
2012,Zaragoza,50016,Aldehuela de Liestos,0,2,-2
2012,Zaragoza,50017,Alfajarín,34,18,16
2012,Zaragoza,50018,Alfamén,10,17,-7
2012,Zaragoza,50019,Alforque,0,1,-1
2012,Zaragoza,50020,Alhama de Aragón,3,16,-13
2012,Zaragoza,50021,Almochuel,0,1,-1
2012,Zaragoza,50022,Almolda (La),1,4,-3
2012,Zaragoza,50023,Almonacid de la Cuba,0,3,-3
2012,Zaragoza,50024,Almonacid de la Sierra,3,16,-13
2012,Zaragoza,50025,Almunia de Doña Godina (La),79,96,-17
2012,Zaragoza,50026,Alpartir,3,9,-6
2012,Zaragoza,50027,Ambel,2,5,-3
2012,Zaragoza,50028,Anento,0,1,-1
2012,Zaragoza,50029,Aniñón,4,9,-5
2012,Zaragoza,50031,Aranda de Moncayo,0,3,-3
2012,Zaragoza,50033,Ardisa,0,1,-1
2012,Zaragoza,50034,Ariza,9,32,-23
2012,Zaragoza,50032,Arándiga,1,3,-2
2012,Zaragoza,50036,Asín,0,3,-3
2012,Zaragoza,50037,Atea,0,4,-4
2012,Zaragoza,50038,Ateca,7,23,-16
2012,Zaragoza,50039,Azuara,1,11,-10
2012,Zaragoza,50030,Añón de Moncayo,0,8,-8
2012,Zaragoza,50040,Badules,1,0,1
2012,Zaragoza,50044,Bardallur,2,4,-2
2012,Zaragoza,50045,Belchite,12,21,-9
2012,Zaragoza,50046,Belmonte de Gracián,0,6,-6
2012,Zaragoza,50048,Berrueco,0,1,-1
2012,Zaragoza,50901,Biel,0,4,-4
2012,Zaragoza,50050,Bijuesca,0,2,-2
2012,Zaragoza,50051,Biota,7,22,-15
2012,Zaragoza,50052,Bisimbre,0,1,-1
2012,Zaragoza,50053,Boquiñeni,3,18,-15
2012,Zaragoza,50055,Borja,37,57,-20
2012,Zaragoza,50056,Botorrita,3,7,-4
2012,Zaragoza,50057,Brea de Aragón,12,23,-11
2012,Zaragoza,50058,Bubierca,0,3,-3
2012,Zaragoza,50059,Bujaraloz,13,16,-3
2012,Zaragoza,50060,Bulbuente,0,6,-6
2012,Zaragoza,50061,Bureta,1,2,-1
2012,Zaragoza,50062,Burgo de Ebro (El),24,14,10
2012,Zaragoza,50063,Buste (El),0,1,-1
2012,Zaragoza,50043,Bárboles,1,2,-1
2012,Zaragoza,50064,Cabañas de Ebro,2,7,-5
2012,Zaragoza,50066,Cadrete,37,22,15
2012,Zaragoza,50067,Calatayud,163,248,-85
2012,Zaragoza,50068,Calatorao,20,19,1
2012,Zaragoza,50069,Calcena,0,1,-1
2012,Zaragoza,50070,Calmarza,0,2,-2
2012,Zaragoza,50071,Campillo de Aragón,0,2,-2
2012,Zaragoza,50072,Carenas,1,4,-3
2012,Zaragoza,50073,Cariñena,36,57,-21
2012,Zaragoza,50074,Caspe,102,95,7
2012,Zaragoza,50075,Castejón de Alarba,1,3,-2
2012,Zaragoza,50076,Castejón de las Armas,0,4,-4
2012,Zaragoza,50077,Castejón de Valdejasa,0,6,-6
2012,Zaragoza,50078,Castiliscar,1,6,-5
2012,Zaragoza,50079,Cervera de la Cañada,3,6,-3
2012,Zaragoza,50081,Cetina,4,15,-11
2012,Zaragoza,50092,Chiprana,3,9,-6
2012,Zaragoza,50093,Chodes,0,5,-5
2012,Zaragoza,50082,Cimballa,1,3,-2
2012,Zaragoza,50083,Cinco Olivas,0,1,-1
2012,Zaragoza,50085,Codo,0,3,-3
2012,Zaragoza,50086,Codos,1,2,-1
2012,Zaragoza,50088,Cosuenda,2,3,-1
2012,Zaragoza,50089,Cuarte de Huerva,256,42,214
2012,Zaragoza,50090,Cubel,0,1,-1
2012,Zaragoza,50091,Cuerlas (Las),0,2,-2
2012,Zaragoza,50094,Daroca,12,51,-39
2012,Zaragoza,50095,Ejea de los Caballeros,129,201,-72
2012,Zaragoza,50096,Embid de Ariza,0,1,-1
2012,Zaragoza,50098,Encinacorba,0,5,-5
2012,Zaragoza,50100,Erla,1,4,-3
2012,Zaragoza,50101,Escatrón,6,19,-13
2012,Zaragoza,50102,Fabara,12,11,1
2012,Zaragoza,50104,Farlete,0,7,-7
2012,Zaragoza,50106,Fayos (Los),3,2,1
2012,Zaragoza,50105,Fayón,5,4,1
2012,Zaragoza,50107,Figueruelas,6,13,-7
2012,Zaragoza,50109,Frago (El),0,1,-1
2012,Zaragoza,50110,Frasno (El),0,4,-4
2012,Zaragoza,50111,Fréscano,0,3,-3
2012,Zaragoza,50113,Fuendejalón,8,12,-4
2012,Zaragoza,50114,Fuendetodos,1,2,-1
2012,Zaragoza,50115,Fuentes de Ebro,44,33,11
2012,Zaragoza,50116,Fuentes de Jiloca,0,7,-7
2012,Zaragoza,50117,Gallocanta,1,0,1
2012,Zaragoza,50118,Gallur,13,34,-21
2012,Zaragoza,50119,Gelsa,9,18,-9
2012,Zaragoza,50120,Godojos,0,1,-1
2012,Zaragoza,50121,Gotor,0,3,-3
2012,Zaragoza,50122,Grisel,2,1,1
2012,Zaragoza,50123,Grisén,7,6,1
2012,Zaragoza,50124,Herrera de los Navarros,1,4,-3
2012,Zaragoza,50125,Ibdes,2,8,-6
2012,Zaragoza,50126,Illueca,18,25,-7
2012,Zaragoza,50129,Jaraba,6,3,3
2012,Zaragoza,50130,Jarque de Moncayo,3,7,-4
2012,Zaragoza,50131,Jaulín,0,15,-15
2012,Zaragoza,50132,Joyosa (La),16,5,11
2012,Zaragoza,50133,Lagata,0,1,-1
2012,Zaragoza,50134,Langa del Castillo,1,2,-1
2012,Zaragoza,50135,Layana,1,2,-1
2012,Zaragoza,50138,Lechón,0,1,-1
2012,Zaragoza,50137,Leciñena,10,18,-8
2012,Zaragoza,50139,Letux,0,6,-6
2012,Zaragoza,50140,Litago,0,4,-4
2012,Zaragoza,50141,Lituénigo,0,5,-5
2012,Zaragoza,50142,Lobera de Onsella,0,1,-1
2012,Zaragoza,50143,Longares,7,9,-2
2012,Zaragoza,50146,Lucena de Jalón,3,3,0
2012,Zaragoza,50147,Luceni,11,12,-1
2012,Zaragoza,50148,Luesia,0,5,-5
2012,Zaragoza,50150,Lumpiaque,11,14,-3
2012,Zaragoza,50151,Luna,3,15,-12
2012,Zaragoza,50136,Lécera,3,13,-10
2012,Zaragoza,50152,Maella,7,18,-11
2012,Zaragoza,50153,Magallón,6,31,-25
2012,Zaragoza,50154,Mainar,0,6,-6
2012,Zaragoza,50155,Malanquilla,0,1,-1
2012,Zaragoza,50156,Maleján,1,2,-1
2012,Zaragoza,50160,Mallén,27,29,-2
2012,Zaragoza,50159,Maluenda,5,13,-8
2012,Zaragoza,50157,Malón,2,8,-6
2012,Zaragoza,50161,Manchones,0,2,-2
2012,Zaragoza,50162,Mara,2,5,-3
2012,Zaragoza,50163,María de Huerva,96,28,68
2012,Zaragoza,50164,Mediana de Aragón,1,10,-9
2012,Zaragoza,50165,Mequinenza,21,25,-4
2012,Zaragoza,50166,Mesones de Isuela,1,5,-4
2012,Zaragoza,50167,Mezalocha,0,5,-5
2012,Zaragoza,50168,Mianos,0,2,-2
2012,Zaragoza,50169,Miedes de Aragón,1,4,-3
2012,Zaragoza,50170,Monegrillo,1,7,-6
2012,Zaragoza,50171,Moneva,0,1,-1
2012,Zaragoza,50172,Monreal de Ariza,0,2,-2
2012,Zaragoza,50173,Monterde,0,3,-3
2012,Zaragoza,50174,Montón,0,2,-2
2012,Zaragoza,50175,Morata de Jalón,7,17,-10
2012,Zaragoza,50176,Morata de Jiloca,1,5,-4
2012,Zaragoza,50178,Moros,0,11,-11
2012,Zaragoza,50177,Morés,2,11,-9
2012,Zaragoza,50179,Moyuela,0,10,-10
2012,Zaragoza,50180,Mozota,1,0,1
2012,Zaragoza,50181,Muel,12,16,-4
2012,Zaragoza,50182,Muela (La),85,17,68
2012,Zaragoza,50183,Munébrega,0,8,-8
2012,Zaragoza,50184,Murero,2,2,0
2012,Zaragoza,50185,Murillo de Gállego,0,3,-3
2012,Zaragoza,50189,Nonaspe,4,7,-3
2012,Zaragoza,50190,Novallas,8,9,-1
2012,Zaragoza,50191,Novillas,3,13,-10
2012,Zaragoza,50193,Nuez de Ebro,11,5,6
2012,Zaragoza,50192,Nuévalos,5,4,1
2012,Zaragoza,50194,Olvés,0,6,-6
2012,Zaragoza,50195,Orcajo,0,2,-2
2012,Zaragoza,50196,Orera,1,4,-3
2012,Zaragoza,50197,Orés,0,2,-2
2012,Zaragoza,50199,Osera de Ebro,1,16,-15
2012,Zaragoza,50200,Paniza,4,7,-3
2012,Zaragoza,50201,Paracuellos de Jiloca,1,4,-3
2012,Zaragoza,50202,Paracuellos de la Ribera,0,8,-8
2012,Zaragoza,50203,Pastriz,9,17,-8
2012,Zaragoza,50204,Pedrola,38,36,2
2012,Zaragoza,50205,Pedrosas (Las),0,1,-1
2012,Zaragoza,50206,Perdiguera,3,12,-9
2012,Zaragoza,50207,Piedratajada,0,1,-1
2012,Zaragoza,50208,Pina de Ebro,26,24,2
2012,Zaragoza,50209,Pinseque,60,51,9
2012,Zaragoza,50211,Plasencia de Jalón,0,6,-6
2012,Zaragoza,50212,Pleitas,0,2,-2
2012,Zaragoza,50213,Plenas,0,2,-2
2012,Zaragoza,50216,Pozuelo de Aragón,1,4,-3
2012,Zaragoza,50217,Pradilla de Ebro,4,7,-3
2012,Zaragoza,50218,Puebla de Albortón,3,2,1
2012,Zaragoza,50219,Puebla de Alfindén (La),108,18,90
2012,Zaragoza,50220,Puendeluna,2,0,2
2012,Zaragoza,50222,Quinto,19,25,-6
2012,Zaragoza,50223,Remolinos,2,15,-13
2012,Zaragoza,50225,Ricla,22,22,0
2012,Zaragoza,50227,Romanos,0,1,-1
2012,Zaragoza,50228,Rueda de Jalón,0,4,-4
2012,Zaragoza,50231,Salillas de Jalón,4,3,1
2012,Zaragoza,50232,Salvatierra de Esca,2,0,2
2012,Zaragoza,50233,Samper del Salz,0,2,-2
2012,Zaragoza,50234,San Martín de la Virgen de Moncayo,1,1,0
2012,Zaragoza,50235,San Mateo de Gállego,34,31,3
2012,Zaragoza,50236,Santa Cruz de Grío,0,4,-4
2012,Zaragoza,50237,Santa Cruz de Moncayo,3,1,2
2012,Zaragoza,50241,Saviñán,3,17,-14
2012,Zaragoza,50242,Sediles,0,1,-1
2012,Zaragoza,50243,Sestrica,0,3,-3
2012,Zaragoza,50244,Sierra de Luna,0,4,-4
2012,Zaragoza,50245,Sigüés,2,5,-3
2012,Zaragoza,50246,Sisamón,0,1,-1
2012,Zaragoza,50247,Sobradiel,13,8,5
2012,Zaragoza,50248,Sos del Rey Católico,7,8,-1
2012,Zaragoza,50230,Sádaba,6,45,-39
2012,Zaragoza,50240,Sástago,9,18,-9
2012,Zaragoza,50249,Tabuenca,0,4,-4
2012,Zaragoza,50251,Tarazona,90,128,-38
2012,Zaragoza,50252,Tauste,47,77,-30
2012,Zaragoza,50253,Terrer,0,11,-11
2012,Zaragoza,50254,Tierga,0,4,-4
2012,Zaragoza,50255,Tobed,0,6,-6
2012,Zaragoza,50257,Torralba de Ribota,0,3,-3
2012,Zaragoza,50259,Torrehermosa,0,1,-1
2012,Zaragoza,50261,Torrellas,0,11,-11
2012,Zaragoza,50262,Torres de Berrellén,9,15,-6
2012,Zaragoza,50263,Torrijo de la Cañada,0,9,-9
2012,Zaragoza,50264,Tosos,0,3,-3
2012,Zaragoza,50266,Trasobares,0,4,-4
2012,Zaragoza,50267,Uncastillo,3,18,-15
2012,Zaragoza,50268,Undués de Lerda,0,1,-1
2012,Zaragoza,50269,Urrea de Jalón,3,6,-3
2012,Zaragoza,50271,Used,0,8,-8
2012,Zaragoza,50272,Utebo,255,89,166
2012,Zaragoza,50274,Val de San Martín,0,2,-2
2012,Zaragoza,50273,Valdehorna,0,4,-4
2012,Zaragoza,50275,Valmadrid,1,2,-1
2012,Zaragoza,50276,Valpalmas,0,3,-3
2012,Zaragoza,50277,Valtorres,0,1,-1
2012,Zaragoza,50278,Velilla de Ebro,2,3,-1
2012,Zaragoza,50279,Velilla de Jiloca,0,5,-5
2012,Zaragoza,50280,Vera de Moncayo,3,13,-10
2012,Zaragoza,50281,Vierlas,0,4,-4
2012,Zaragoza,50284,Villafeliche,0,4,-4
2012,Zaragoza,50285,Villafranca de Ebro,3,13,-10
2012,Zaragoza,50286,Villalba de Perejil,0,5,-5
2012,Zaragoza,50287,Villalengua,4,4,0
2012,Zaragoza,50903,Villamayor de Gállego,7,23,-16
2012,Zaragoza,50288,Villanueva de Gállego,34,30,4
2012,Zaragoza,50290,Villanueva de Huerva,1,11,-10
2012,Zaragoza,50289,Villanueva de Jiloca,0,2,-2
2012,Zaragoza,50291,Villar de los Navarros,0,3,-3
2012,Zaragoza,50292,Villarreal de Huerva,1,2,-1
2012,Zaragoza,50293,Villarroya de la Sierra,4,14,-10
2012,Zaragoza,50294,Villarroya del Campo,0,2,-2
2012,Zaragoza,50282,Vilueña (La),0,1,-1
2012,Zaragoza,50295,Vistabella,0,1,-1
2012,Zaragoza,50296,Zaida (La),1,6,-5
2012,Zaragoza,50297,Zaragoza,6314,6159,155
2012,Zaragoza,50298,Zuera,68,56,12
2012,Zaragoza,50099,Épila,52,44,8
2011,Huesca,22001,Abiego,2,2,0
2011,Huesca,22002,Abizanda,0,1,-1
2011,Huesca,22003,Adahuesca,0,0,0
2011,Huesca,22004,Agüero,0,4,-4
2011,Huesca,22007,Albalate de Cinca,6,19,-13
2011,Huesca,22008,Albalatillo,1,4,-3
2011,Huesca,22009,Albelda,2,11,-9
2011,Huesca,22012,Albero Bajo,0,3,-3
2011,Huesca,22013,Alberuela de Tubo,0,5,-5
2011,Huesca,22014,Alcalá de Gurrea,0,6,-6
2011,Huesca,22015,Alcalá del Obispo,2,3,-1
2011,Huesca,22016,Alcampell,4,10,-6
2011,Huesca,22017,Alcolea de Cinca,6,17,-11
2011,Huesca,22018,Alcubierre,1,13,-12
2011,Huesca,22019,Alerre,1,6,-5
2011,Huesca,22020,Alfántega,1,1,0
2011,Huesca,22021,Almudévar,24,31,-7
2011,Huesca,22022,Almunia de San Juan,2,8,-6
2011,Huesca,22023,Almuniente,4,4,0
2011,Huesca,22024,Alquézar,1,1,0
2011,Huesca,22025,Altorricón,6,16,-10
2011,Huesca,22027,Angüés,1,15,-14
2011,Huesca,22028,Ansó,0,8,-8
2011,Huesca,22029,Antillón,0,1,-1
2011,Huesca,22032,Aragüés del Puerto,0,2,-2
2011,Huesca,22036,Argavieso,1,2,-1
2011,Huesca,22037,Arguis,0,0,0
2011,Huesca,22035,Arén,2,5,-3
2011,Huesca,22039,Ayerbe,5,14,-9
2011,Huesca,22040,Azanuy-Alins,1,3,-2
2011,Huesca,22042,Azlor,1,3,-2
2011,Huesca,22907,Aínsa-Sobrarbe,24,18,6
2011,Huesca,22006,Aísa,2,3,-1
2011,Huesca,22043,Baells,0,4,-4
2011,Huesca,22044,Bailo,3,5,-2
2011,Huesca,22045,Baldellou,0,2,-2
2011,Huesca,22046,Ballobar,5,12,-7
2011,Huesca,22047,Banastás,2,0,2
2011,Huesca,22048,Barbastro,161,185,-24
2011,Huesca,22049,Barbués,0,1,-1
2011,Huesca,22050,Barbuñales,0,3,-3
2011,Huesca,22052,Belver de Cinca,12,35,-23
2011,Huesca,22053,Benabarre,14,21,-7
2011,Huesca,22054,Benasque,16,6,10
2011,Huesca,22246,Beranuy,0,1,-1
2011,Huesca,22055,Berbegal,2,8,-6
2011,Huesca,22057,Bielsa,2,5,-3
2011,Huesca,22058,Bierge,1,4,-3
2011,Huesca,22059,Biescas,18,25,-7
2011,Huesca,22060,Binaced,14,23,-9
2011,Huesca,22061,Binéfar,88,85,3
2011,Huesca,22062,Bisaurri,2,4,-2
2011,Huesca,22063,Biscarrués,1,2,-1
2011,Huesca,22064,Blecua y Torres,1,1,0
2011,Huesca,22066,Boltaña,9,13,-4
2011,Huesca,22067,Bonansa,1,2,-1
2011,Huesca,22068,Borau,1,0,1
2011,Huesca,22069,Broto,5,2,3
2011,Huesca,22051,Bárcabo,0,2,-2
2011,Huesca,22072,Caldearenas,1,0,1
2011,Huesca,22074,Campo,1,1,0
2011,Huesca,22075,Camporrells,0,3,-3
2011,Huesca,22076,Canal de Berdún,0,4,-4
2011,Huesca,22077,Candasnos,0,4,-4
2011,Huesca,22078,Canfranc,3,3,0
2011,Huesca,22079,Capdesaso,0,3,-3
2011,Huesca,22080,Capella,1,3,-2
2011,Huesca,22081,Casbas de Huesca,0,4,-4
2011,Huesca,22083,Castejón de Monegros,1,16,-15
2011,Huesca,22084,Castejón de Sos,9,7,2
2011,Huesca,22082,Castejón del Puente,1,4,-3
2011,Huesca,22085,Castelflorite,1,4,-3
2011,Huesca,22086,Castiello de Jaca,1,4,-3
2011,Huesca,22088,Castillazuelo,1,4,-3
2011,Huesca,22089,Castillonroy,2,8,-6
2011,Huesca,22094,Chalamera,0,1,-1
2011,Huesca,22096,Chimillas,4,10,-6
2011,Huesca,22095,Chía,0,3,-3
2011,Huesca,22090,Colungo,1,2,-1
2011,Huesca,22099,Esplús,9,8,1
2011,Huesca,22102,Estada,1,1,0
2011,Huesca,22103,Estadilla,5,13,-8
2011,Huesca,22105,Estopiñán del Castillo,0,1,-1
2011,Huesca,22107,Fanlo,0,0,0
2011,Huesca,22109,Fiscal,2,3,-1
2011,Huesca,22110,Fonz,3,18,-15
2011,Huesca,22111,Foradada del Toscar,1,2,-1
2011,Huesca,22112,Fraga,174,118,56
2011,Huesca,22113,Fueva (La),6,7,-1
2011,Huesca,22114,Gistaín,0,4,-4
2011,Huesca,22115,Grado (El),3,6,-3
2011,Huesca,22117,Graus,27,48,-21
2011,Huesca,22116,Grañén,21,32,-11
2011,Huesca,22119,Gurrea de Gállego,6,23,-17
2011,Huesca,22908,Hoz y Costeán,0,1,-1
2011,Huesca,22124,Huerto,0,2,-2
2011,Huesca,22125,Huesca,573,529,44
2011,Huesca,22126,Ibieca,0,2,-2
2011,Huesca,22127,Igriés,9,15,-6
2011,Huesca,22128,Ilche,0,2,-2
2011,Huesca,22129,Isábena,0,3,-3
2011,Huesca,22130,Jaca,112,128,-16
2011,Huesca,22131,Jasa,3,0,3
2011,Huesca,22133,Labuerda,0,2,-2
2011,Huesca,22135,Laluenga,0,1,-1
2011,Huesca,22136,Lalueza,5,19,-14
2011,Huesca,22137,Lanaja,3,19,-16
2011,Huesca,22141,Lascellas-Ponzano,0,4,-4
2011,Huesca,22142,Lascuarre,1,1,0
2011,Huesca,22143,Laspaúles,2,1,1
2011,Huesca,22144,Laspuña,0,1,-1
2011,Huesca,22149,Loarre,0,5,-5
2011,Huesca,22150,Loporzano,1,5,-4
2011,Huesca,22151,Loscorrales,0,1,-1
2011,Huesca,22905,Lupiñén-Ortilla,1,4,-3
2011,Huesca,22155,Monesma y Cajigar,0,2,-2
2011,Huesca,22156,Monflorite-Lascasas,2,3,-1
2011,Huesca,22157,Montanuy,0,2,-2
2011,Huesca,22158,Monzón,186,162,24
2011,Huesca,22160,Naval,2,5,-3
2011,Huesca,22162,Novales,1,4,-3
2011,Huesca,22163,Nueno,2,3,-1
2011,Huesca,22164,Olvena,1,0,1
2011,Huesca,22165,Ontiñena,3,7,-4
2011,Huesca,22167,Osso de Cinca,4,5,-1
2011,Huesca,22170,Panticosa,4,7,-3
2011,Huesca,22174,Peralta de Alcofea,0,8,-8
2011,Huesca,22175,Peralta de Calasanz,2,5,-3
2011,Huesca,22176,Peraltilla,2,2,0
2011,Huesca,22178,Pertusa,0,1,-1
2011,Huesca,22172,Peñalba,1,5,-4
2011,Huesca,22173,Peñas de Riglos (Las),1,7,-6
2011,Huesca,22181,Piracés,1,2,-1
2011,Huesca,22182,Plan,2,5,-3
2011,Huesca,22184,Poleñino,0,4,-4
2011,Huesca,22186,Pozán de Vero,3,6,-3
2011,Huesca,22187,Puebla de Castro (La),1,2,-1
2011,Huesca,22188,Puente de Montañana,0,1,-1
2011,Huesca,22902,Puente la Reina de Jaca,0,4,-4
2011,Huesca,22190,Pueyo de Araguás (El),1,2,-1
2011,Huesca,22193,Pueyo de Santa Cruz,4,10,-6
2011,Huesca,22189,Puértolas,2,5,-3
2011,Huesca,22195,Quicena,0,4,-4
2011,Huesca,22197,Robres,3,10,-7
2011,Huesca,22199,Sabiñánigo,88,114,-26
2011,Huesca,22200,Sahún,5,3,2
2011,Huesca,22201,Salas Altas,0,2,-2
2011,Huesca,22202,Salas Bajas,0,1,-1
2011,Huesca,22203,Salillas,0,4,-4
2011,Huesca,22204,Sallent de Gállego,19,9,10
2011,Huesca,22205,San Esteban de Litera,1,9,-8
2011,Huesca,22207,San Juan de Plan,0,1,-1
2011,Huesca,22903,San Miguel del Cinca,7,12,-5
2011,Huesca,22206,Sangarrén,0,2,-2
2011,Huesca,22208,Santa Cilia,0,2,-2
2011,Huesca,22209,Santa Cruz de la Serós,1,2,-1
2011,Huesca,22906,Santa María de Dulcis,0,2,-2
2011,Huesca,22212,Santaliestra y San Quílez,0,2,-2
2011,Huesca,22213,Sariñena,29,48,-19
2011,Huesca,22214,Secastilla,0,2,-2
2011,Huesca,22215,Seira,0,4,-4
2011,Huesca,22217,Sena,5,7,-2
2011,Huesca,22218,Senés de Alcubierre,0,1,-1
2011,Huesca,22220,Sesa,0,5,-5
2011,Huesca,22221,Sesué,1,0,1
2011,Huesca,22222,Siétamo,3,8,-5
2011,Huesca,22223,Sopeira,1,1,0
2011,Huesca,22904,Sotonera (La),2,14,-12
2011,Huesca,22225,Tamarite de Litera,31,46,-15
2011,Huesca,22226,Tardienta,6,11,-5
2011,Huesca,22227,Tella-Sin,2,1,1
2011,Huesca,22228,Tierz,12,6,6
2011,Huesca,22229,Tolva,2,0,2
2011,Huesca,22230,Torla-Ordesa,4,4,0
2011,Huesca,22232,Torralba de Aragón,0,1,-1
2011,Huesca,22233,Torre la Ribera,0,1,-1
2011,Huesca,22234,Torrente de Cinca,0,6,-6
2011,Huesca,22235,Torres de Alcanadre,0,2,-2
2011,Huesca,22236,Torres de Barbués,1,3,-2
2011,Huesca,22239,Tramaced,0,1,-1
2011,Huesca,22242,Valfarta,0,1,-1
2011,Huesca,22243,Valle de Bardají,0,1,-1
2011,Huesca,22901,Valle de Hecho,5,11,-6
2011,Huesca,22245,Velilla de Cinca,4,6,-2
2011,Huesca,22909,Vencillón,1,5,-4
2011,Huesca,22248,Vicién,0,2,-2
2011,Huesca,22249,Villanova,1,1,0
2011,Huesca,22251,Villanueva de Sigena,0,5,-5
2011,Huesca,22250,Villanúa,4,0,4
2011,Huesca,22252,Yebra de Basa,0,2,-2
2011,Huesca,22254,Zaidín,13,16,-3
2011,Teruel,44001,Ababuj,0,1,-1
2011,Teruel,44002,Abejuela,0,1,-1
2011,Teruel,44004,Aguaviva,7,9,-2
2011,Teruel,44005,Aguilar del Alfambra,0,2,-2
2011,Teruel,44006,Alacón,1,9,-8
2011,Teruel,44007,Alba,1,3,-2
2011,Teruel,44008,Albalate del Arzobispo,14,29,-15
2011,Teruel,44009,Albarracín,11,18,-7
2011,Teruel,44010,Albentosa,2,2,0
2011,Teruel,44011,Alcaine,0,0,0
2011,Teruel,44012,Alcalá de la Selva,2,2,0
2011,Teruel,44013,Alcañiz,187,158,29
2011,Teruel,44014,Alcorisa,33,32,1
2011,Teruel,44016,Alfambra,0,8,-8
2011,Teruel,44017,Aliaga,2,14,-12
2011,Teruel,44021,Allepuz,0,1,-1
2011,Teruel,44022,Alloza,5,11,-6
2011,Teruel,44018,Almohaja,0,1,-1
2011,Teruel,44019,Alobras,0,2,-2
2011,Teruel,44020,Alpeñés,0,1,-1
2011,Teruel,44025,Andorra,54,77,-23
2011,Teruel,44028,Argente,1,6,-5
2011,Teruel,44029,Ariño,5,14,-9
2011,Teruel,44031,Azaila,0,11,-11
2011,Teruel,44035,Barrachina,1,3,-2
2011,Teruel,44037,Beceite,4,9,-5
2011,Teruel,44039,Bello,1,4,-3
2011,Teruel,44038,Belmonte de San José,0,3,-3
2011,Teruel,44040,Berge,0,3,-3
2011,Teruel,44041,Bezas,0,1,-1
2011,Teruel,44042,Blancas,2,1,1
2011,Teruel,44043,Blesa,0,1,-1
2011,Teruel,44044,Bordón,0,1,-1
2011,Teruel,44045,Bronchales,1,2,-1
2011,Teruel,44046,Bueña,0,3,-3
2011,Teruel,44047,Burbáguena,0,14,-14
2011,Teruel,44032,Bádenas,1,0,1
2011,Teruel,44033,Báguena,1,6,-5
2011,Teruel,44048,Cabra de Mora,0,1,-1
2011,Teruel,44049,Calaceite,8,25,-17
2011,Teruel,44050,Calamocha,42,49,-7
2011,Teruel,44051,Calanda,37,50,-13
2011,Teruel,44054,Camarena de la Sierra,0,0,0
2011,Teruel,44055,Camarillas,0,4,-4
2011,Teruel,44053,Camañas,2,1,1
2011,Teruel,44056,Caminreal,5,5,0
2011,Teruel,44059,Cantavieja,5,5,0
2011,Teruel,44064,Cascante del Río,0,1,-1
2011,Teruel,44065,Castejón de Tornos,0,1,-1
2011,Teruel,44066,Castel de Cabra,1,1,0
2011,Teruel,44070,Castellar (El),0,3,-3
2011,Teruel,44071,Castellote,6,17,-11
2011,Teruel,44067,Castelnou,3,2,1
2011,Teruel,44068,Castelserás,9,9,0
2011,Teruel,44060,Cañada de Benatanduz,0,2,-2
2011,Teruel,44063,Cañizar del Olivar,1,0,1
2011,Teruel,44074,Cedrillas,7,6,1
2011,Teruel,44075,Celadas,0,9,-9
2011,Teruel,44076,Cella,29,34,-5
2011,Teruel,44077,Cerollera (La),0,2,-2
2011,Teruel,44080,Codoñera (La),2,9,-7
2011,Teruel,44082,Corbalán,1,1,0
2011,Teruel,44084,Cortes de Aragón,1,0,1
2011,Teruel,44086,Cretas,5,8,-3
2011,Teruel,44087,Crivillén,0,1,-1
2011,Teruel,44090,Cucalón,1,1,0
2011,Teruel,44092,Cuervo (El),1,2,-1
2011,Teruel,44093,Cuevas de Almudén,1,1,0
2011,Teruel,44094,Cuevas Labradas,0,5,-5
2011,Teruel,44096,Ejulve,2,0,2
2011,Teruel,44097,Escorihuela,0,1,-1
2011,Teruel,44099,Escucha,10,9,1
2011,Teruel,44100,Estercuel,0,5,-5
2011,Teruel,44101,Ferreruela de Huerva,1,0,1
2011,Teruel,44103,Formiche Alto,0,2,-2
2011,Teruel,44106,Fortanete,2,2,0
2011,Teruel,44107,Foz-Calanda,1,4,-3
2011,Teruel,44108,Fresneda (La),4,14,-10
2011,Teruel,44109,Frías de Albarracín,1,3,-2
2011,Teruel,44110,Fuenferrada,0,1,-1
2011,Teruel,44111,Fuentes Calientes,1,3,-2
2011,Teruel,44112,Fuentes Claras,0,4,-4
2011,Teruel,44113,Fuentes de Rubielos,4,0,4
2011,Teruel,44114,Fuentespalda,1,3,-2
2011,Teruel,44105,Fórnoles,0,2,-2
2011,Teruel,44115,Galve,3,1,2
2011,Teruel,44116,Gargallo,2,1,1
2011,Teruel,44117,Gea de Albarracín,0,8,-8
2011,Teruel,44118,Ginebrosa (La),2,5,-3
2011,Teruel,44119,Griegos,1,1,0
2011,Teruel,44120,Guadalaviar,1,2,-1
2011,Teruel,44121,Gúdar,0,0,0
2011,Teruel,44123,Hinojosa de Jarque,0,3,-3
2011,Teruel,44124,Hoz de la Vieja (La),0,3,-3
2011,Teruel,44125,Huesa del Común,0,2,-2
2011,Teruel,44122,Híjar,11,31,-20
2011,Teruel,44126,Iglesuela del Cid (La),3,5,-2
2011,Teruel,44127,Jabaloyas,0,2,-2
2011,Teruel,44128,Jarque de la Val,1,1,0
2011,Teruel,44130,Jorcas,0,1,-1
2011,Teruel,44135,Libros,0,4,-4
2011,Teruel,44137,Linares de Mora,2,3,-1
2011,Teruel,44141,Lledó,1,1,0
2011,Teruel,44138,Loscos,1,2,-1
2011,Teruel,44143,Manzanera,4,8,-4
2011,Teruel,44144,Martín del Río,2,4,-2
2011,Teruel,44145,Mas de las Matas,6,41,-35
2011,Teruel,44146,Mata de los Olmos (La),3,4,-1
2011,Teruel,44147,Mazaleón,2,5,-3
2011,Teruel,44148,Mezquita de Jarque,0,2,-2
2011,Teruel,44149,Mirambel,1,6,-5
2011,Teruel,44151,Molinos,0,1,-1
2011,Teruel,44153,Monreal del Campo,33,26,7
2011,Teruel,44154,Monroyo,1,3,-2
2011,Teruel,44155,Montalbán,9,17,-8
2011,Teruel,44156,Monteagudo del Castillo,0,1,-1
2011,Teruel,44157,Monterde de Albarracín,0,1,-1
2011,Teruel,44158,Mora de Rubielos,20,15,5
2011,Teruel,44160,Mosqueruela,3,6,-3
2011,Teruel,44161,Muniesa,6,14,-8
2011,Teruel,44163,Noguera de Albarracín,0,1,-1
2011,Teruel,44164,Nogueras,0,2,-2
2011,Teruel,44165,Nogueruelas,3,2,1
2011,Teruel,44167,Obón,0,1,-1
2011,Teruel,44168,Odón,0,2,-2
2011,Teruel,44169,Ojos Negros,3,10,-7
2011,Teruel,44171,Olba,2,4,-2
2011,Teruel,44172,Oliete,0,9,-9
2011,Teruel,44173,Olmos (Los),1,2,-1
2011,Teruel,44174,Orihuela del Tremedal,4,3,1
2011,Teruel,44175,Orrios,0,3,-3
2011,Teruel,44176,Palomar de Arroyos,1,1,0
2011,Teruel,44177,Pancrudo,0,1,-1
2011,Teruel,44178,Parras de Castellote (Las),0,1,-1
2011,Teruel,44180,Peracense,0,2,-2
2011,Teruel,44182,Perales del Alfambra,3,2,1
2011,Teruel,44179,Peñarroya de Tastavins,3,5,-2
2011,Teruel,44183,Pitarque,0,2,-2
2011,Teruel,44187,Portellada (La),4,4,0
2011,Teruel,44189,Pozondón,0,2,-2
2011,Teruel,44190,Pozuel del Campo,0,1,-1
2011,Teruel,44191,Puebla de Híjar (La),5,10,-5
2011,Teruel,44192,Puebla de Valverde (La),5,6,-1
2011,Teruel,44193,Puertomingalvo,1,1,0
2011,Teruel,44195,Rillo,0,1,-1
2011,Teruel,44196,Riodeva,0,2,-2
2011,Teruel,44198,Royuela,2,8,-6
2011,Teruel,44199,Rubiales,0,2,-2
2011,Teruel,44201,Rubielos de Mora,6,4,2
2011,Teruel,44194,Ráfales,1,4,-3
2011,Teruel,44197,Ródenas,0,1,-1
2011,Teruel,44204,Saldón,0,1,-1
2011,Teruel,44205,Samper de Calanda,5,20,-15
2011,Teruel,44206,San Agustín,1,2,-1
2011,Teruel,44207,San Martín del Río,0,5,-5
2011,Teruel,44209,Santa Eulalia,9,29,-20
2011,Teruel,44210,Sarrión,11,15,-4
2011,Teruel,44212,Seno,2,1,1
2011,Teruel,44213,Singra,0,3,-3
2011,Teruel,44215,Terriente,0,4,-4
2011,Teruel,44216,Teruel,374,334,40
2011,Teruel,44217,Toril y Masegoso,0,1,-1
2011,Teruel,44218,Tormón,0,1,-1
2011,Teruel,44219,Tornos,0,4,-4
2011,Teruel,44220,Torralba de los Sisones,0,2,-2
2011,Teruel,44223,Torre de Arcas,1,2,-1
2011,Teruel,44224,Torre de las Arcas,0,1,-1
2011,Teruel,44225,Torre del Compte,1,3,-2
2011,Teruel,44227,Torre los Negros,0,2,-2
2011,Teruel,44221,Torrecilla de Alcañiz,0,5,-5
2011,Teruel,44222,Torrecilla del Rebollar,0,2,-2
2011,Teruel,44226,Torrelacárcel,0,5,-5
2011,Teruel,44228,Torremocha de Jiloca,0,1,-1
2011,Teruel,44229,Torres de Albarracín,0,3,-3
2011,Teruel,44230,Torrevelilla,1,5,-4
2011,Teruel,44231,Torrijas,0,1,-1
2011,Teruel,44232,Torrijo del Campo,1,9,-8
2011,Teruel,44234,Tramacastiel,0,3,-3
2011,Teruel,44235,Tramacastilla,2,0,2
2011,Teruel,44236,Tronchón,0,1,-1
2011,Teruel,44237,Urrea de Gaén,4,6,-2
2011,Teruel,44238,Utrillas,31,31,0
2011,Teruel,44239,Valacloche,0,1,-1
2011,Teruel,44240,Valbona,0,0,0
2011,Teruel,44241,Valdealgorfa,5,14,-9
2011,Teruel,44243,Valdecuenca,0,1,-1
2011,Teruel,44244,Valdelinares,1,0,1
2011,Teruel,44245,Valdeltormo,2,8,-6
2011,Teruel,44246,Valderrobres,28,45,-17
2011,Teruel,44247,Valjunquera,0,6,-6
2011,Teruel,44251,Villafranca del Campo,2,4,-2
2011,Teruel,44252,Villahermosa del Campo,1,0,1
2011,Teruel,44256,Villanueva del Rebollar de la Sierra,0,1,-1
2011,Teruel,44257,Villar del Cobo,0,1,-1
2011,Teruel,44258,Villar del Salz,0,1,-1
2011,Teruel,44260,Villarluengo,2,4,-2
2011,Teruel,44261,Villarquemado,6,10,-4
2011,Teruel,44262,Villarroya de los Pinares,1,3,-2
2011,Teruel,44263,Villastar,7,6,1
2011,Teruel,44264,Villel,5,1,4
2011,Teruel,44265,Vinaceite,1,3,-2
2011,Teruel,44266,Visiedo,0,2,-2
2011,Teruel,44267,Vivel del Río Martín,1,1,0
2011,Teruel,44268,Zoma (La),0,2,-2
2011,Zaragoza,50001,Abanto,0,3,-3
2011,Zaragoza,50002,Acered,0,6,-6
2011,Zaragoza,50004,Aguarón,2,17,-15
2011,Zaragoza,50005,Aguilón,0,5,-5
2011,Zaragoza,50003,Agón,1,0,1
2011,Zaragoza,50006,Ainzón,6,12,-6
2011,Zaragoza,50008,Alagón,62,77,-15
2011,Zaragoza,50009,Alarba,0,1,-1
2011,Zaragoza,50011,Albeta,2,3,-1
2011,Zaragoza,50012,Alborge,0,2,-2
2011,Zaragoza,50013,Alcalá de Ebro,3,4,-1
2011,Zaragoza,50014,Alcalá de Moncayo,2,1,1
2011,Zaragoza,50015,Alconchel de Ariza,0,1,-1
2011,Zaragoza,50016,Aldehuela de Liestos,0,1,-1
2011,Zaragoza,50017,Alfajarín,22,18,4
2011,Zaragoza,50018,Alfamén,17,6,11
2011,Zaragoza,50019,Alforque,0,3,-3
2011,Zaragoza,50020,Alhama de Aragón,12,12,0
2011,Zaragoza,50022,Almolda (La),0,11,-11
2011,Zaragoza,50023,Almonacid de la Cuba,1,6,-5
2011,Zaragoza,50024,Almonacid de la Sierra,3,18,-15
2011,Zaragoza,50025,Almunia de Doña Godina (La),87,80,7
2011,Zaragoza,50026,Alpartir,3,9,-6
2011,Zaragoza,50027,Ambel,2,4,-2
2011,Zaragoza,50029,Aniñón,5,11,-6
2011,Zaragoza,50031,Aranda de Moncayo,1,1,0
2011,Zaragoza,50033,Ardisa,0,1,-1
2011,Zaragoza,50034,Ariza,6,17,-11
2011,Zaragoza,50035,Artieda,1,0,1
2011,Zaragoza,50032,Arándiga,1,15,-14
2011,Zaragoza,50037,Atea,0,4,-4
2011,Zaragoza,50038,Ateca,11,23,-12
2011,Zaragoza,50039,Azuara,0,10,-10
2011,Zaragoza,50030,Añón de Moncayo,2,5,-3
2011,Zaragoza,50042,Balconchán,0,1,-1
2011,Zaragoza,50044,Bardallur,1,3,-2
2011,Zaragoza,50045,Belchite,11,32,-21
2011,Zaragoza,50046,Belmonte de Gracián,0,3,-3
2011,Zaragoza,50047,Berdejo,0,2,-2
2011,Zaragoza,50048,Berrueco,0,2,-2
2011,Zaragoza,50901,Biel,0,1,-1
2011,Zaragoza,50050,Bijuesca,0,1,-1
2011,Zaragoza,50051,Biota,5,11,-6
2011,Zaragoza,50052,Bisimbre,1,3,-2
2011,Zaragoza,50053,Boquiñeni,7,13,-6
2011,Zaragoza,50054,Bordalba,0,1,-1
2011,Zaragoza,50055,Borja,56,64,-8
2011,Zaragoza,50056,Botorrita,7,6,1
2011,Zaragoza,50057,Brea de Aragón,17,24,-7
2011,Zaragoza,50058,Bubierca,0,1,-1
2011,Zaragoza,50059,Bujaraloz,11,11,0
2011,Zaragoza,50060,Bulbuente,1,2,-1
2011,Zaragoza,50061,Bureta,1,0,1
2011,Zaragoza,50062,Burgo de Ebro (El),29,22,7
2011,Zaragoza,50063,Buste (El),0,4,-4
2011,Zaragoza,50043,Bárboles,1,3,-2
2011,Zaragoza,50064,Cabañas de Ebro,1,6,-5
2011,Zaragoza,50065,Cabolafuente,0,2,-2
2011,Zaragoza,50066,Cadrete,53,23,30
2011,Zaragoza,50067,Calatayud,198,231,-33
2011,Zaragoza,50068,Calatorao,31,32,-1
2011,Zaragoza,50069,Calcena,0,5,-5
2011,Zaragoza,50070,Calmarza,0,2,-2
2011,Zaragoza,50071,Campillo de Aragón,0,4,-4
2011,Zaragoza,50072,Carenas,0,4,-4
2011,Zaragoza,50073,Cariñena,37,47,-10
2011,Zaragoza,50074,Caspe,111,128,-17
2011,Zaragoza,50075,Castejón de Alarba,0,2,-2
2011,Zaragoza,50076,Castejón de las Armas,0,3,-3
2011,Zaragoza,50077,Castejón de Valdejasa,0,6,-6
2011,Zaragoza,50078,Castiliscar,1,10,-9
2011,Zaragoza,50079,Cervera de la Cañada,3,6,-3
2011,Zaragoza,50081,Cetina,4,6,-2
2011,Zaragoza,50092,Chiprana,5,6,-1
2011,Zaragoza,50093,Chodes,0,1,-1
2011,Zaragoza,50082,Cimballa,0,1,-1
2011,Zaragoza,50083,Cinco Olivas,2,3,-1
2011,Zaragoza,50084,Clarés de Ribota,0,2,-2
2011,Zaragoza,50085,Codo,1,9,-8
2011,Zaragoza,50086,Codos,0,3,-3
2011,Zaragoza,50087,Contamina,0,1,-1
2011,Zaragoza,50088,Cosuenda,3,6,-3
2011,Zaragoza,50089,Cuarte de Huerva,247,23,224
2011,Zaragoza,50090,Cubel,0,2,-2
2011,Zaragoza,50091,Cuerlas (Las),0,6,-6
2011,Zaragoza,50094,Daroca,11,34,-23
2011,Zaragoza,50095,Ejea de los Caballeros,138,178,-40
2011,Zaragoza,50096,Embid de Ariza,0,1,-1
2011,Zaragoza,50098,Encinacorba,0,5,-5
2011,Zaragoza,50100,Erla,1,5,-4
2011,Zaragoza,50101,Escatrón,4,13,-9
2011,Zaragoza,50102,Fabara,8,24,-16
2011,Zaragoza,50104,Farlete,2,6,-4
2011,Zaragoza,50106,Fayos (Los),1,1,0
2011,Zaragoza,50105,Fayón,0,5,-5
2011,Zaragoza,50107,Figueruelas,10,11,-1
2011,Zaragoza,50110,Frasno (El),1,8,-7
2011,Zaragoza,50111,Fréscano,1,6,-5
2011,Zaragoza,50113,Fuendejalón,7,15,-8
2011,Zaragoza,50114,Fuendetodos,0,2,-2
2011,Zaragoza,50115,Fuentes de Ebro,40,41,-1
2011,Zaragoza,50116,Fuentes de Jiloca,0,6,-6
2011,Zaragoza,50117,Gallocanta,0,2,-2
2011,Zaragoza,50118,Gallur,24,20,4
2011,Zaragoza,50119,Gelsa,4,11,-7
2011,Zaragoza,50121,Gotor,0,4,-4
2011,Zaragoza,50122,Grisel,1,1,0
2011,Zaragoza,50123,Grisén,5,7,-2
2011,Zaragoza,50124,Herrera de los Navarros,3,9,-6
2011,Zaragoza,50125,Ibdes,2,11,-9
2011,Zaragoza,50126,Illueca,21,29,-8
2011,Zaragoza,50129,Jaraba,4,7,-3
2011,Zaragoza,50130,Jarque de Moncayo,2,7,-5
2011,Zaragoza,50131,Jaulín,0,10,-10
2011,Zaragoza,50132,Joyosa (La),12,8,4
2011,Zaragoza,50133,Lagata,0,2,-2
2011,Zaragoza,50134,Langa del Castillo,0,3,-3
2011,Zaragoza,50137,Leciñena,11,23,-12
2011,Zaragoza,50139,Letux,0,8,-8
2011,Zaragoza,50140,Litago,0,6,-6
2011,Zaragoza,50141,Lituénigo,0,2,-2
2011,Zaragoza,50142,Lobera de Onsella,0,1,-1
2011,Zaragoza,50143,Longares,8,15,-7
2011,Zaragoza,50144,Longás,0,1,-1
2011,Zaragoza,50146,Lucena de Jalón,4,4,0
2011,Zaragoza,50147,Luceni,4,17,-13
2011,Zaragoza,50148,Luesia,0,6,-6
2011,Zaragoza,50150,Lumpiaque,5,15,-10
2011,Zaragoza,50151,Luna,3,13,-10
2011,Zaragoza,50136,Lécera,4,13,-9
2011,Zaragoza,50152,Maella,2,33,-31
2011,Zaragoza,50153,Magallón,8,20,-12
2011,Zaragoza,50154,Mainar,0,5,-5
2011,Zaragoza,50155,Malanquilla,0,1,-1
2011,Zaragoza,50156,Maleján,5,4,1
2011,Zaragoza,50160,Mallén,32,29,3
2011,Zaragoza,50159,Maluenda,8,21,-13
2011,Zaragoza,50157,Malón,2,3,-1
2011,Zaragoza,50161,Manchones,0,3,-3
2011,Zaragoza,50162,Mara,0,2,-2
2011,Zaragoza,50163,María de Huerva,93,18,75
2011,Zaragoza,50164,Mediana de Aragón,5,6,-1
2011,Zaragoza,50165,Mequinenza,18,44,-26
2011,Zaragoza,50166,Mesones de Isuela,0,4,-4
2011,Zaragoza,50167,Mezalocha,1,3,-2
2011,Zaragoza,50169,Miedes de Aragón,1,11,-10
2011,Zaragoza,50170,Monegrillo,2,3,-1
2011,Zaragoza,50171,Moneva,0,1,-1
2011,Zaragoza,50172,Monreal de Ariza,0,1,-1
2011,Zaragoza,50173,Monterde,0,3,-3
2011,Zaragoza,50174,Montón,0,1,-1
2011,Zaragoza,50175,Morata de Jalón,4,27,-23
2011,Zaragoza,50176,Morata de Jiloca,2,3,-1
2011,Zaragoza,50178,Moros,1,11,-10
2011,Zaragoza,50177,Morés,2,8,-6
2011,Zaragoza,50179,Moyuela,0,6,-6
2011,Zaragoza,50180,Mozota,0,1,-1
2011,Zaragoza,50181,Muel,9,22,-13
2011,Zaragoza,50182,Muela (La),100,19,81
2011,Zaragoza,50183,Munébrega,1,9,-8
2011,Zaragoza,50184,Murero,0,2,-2
2011,Zaragoza,50185,Murillo de Gállego,2,1,1
2011,Zaragoza,50186,Navardún,0,1,-1
2011,Zaragoza,50187,Nigüella,0,2,-2
2011,Zaragoza,50189,Nonaspe,6,20,-14
2011,Zaragoza,50190,Novallas,10,11,-1
2011,Zaragoza,50191,Novillas,2,5,-3
2011,Zaragoza,50193,Nuez de Ebro,10,7,3
2011,Zaragoza,50192,Nuévalos,1,3,-2
2011,Zaragoza,50194,Olvés,0,2,-2
2011,Zaragoza,50196,Orera,0,1,-1
2011,Zaragoza,50197,Orés,0,4,-4
2011,Zaragoza,50199,Osera de Ebro,1,15,-14
2011,Zaragoza,50200,Paniza,5,10,-5
2011,Zaragoza,50201,Paracuellos de Jiloca,7,6,1
2011,Zaragoza,50202,Paracuellos de la Ribera,0,8,-8
2011,Zaragoza,50203,Pastriz,18,10,8
2011,Zaragoza,50204,Pedrola,29,28,1
2011,Zaragoza,50205,Pedrosas (Las),0,3,-3
2011,Zaragoza,50206,Perdiguera,6,7,-1
2011,Zaragoza,50207,Piedratajada,1,0,1
2011,Zaragoza,50208,Pina de Ebro,30,20,10
2011,Zaragoza,50209,Pinseque,59,69,-10
2011,Zaragoza,50211,Plasencia de Jalón,3,6,-3
2011,Zaragoza,50212,Pleitas,0,1,-1
2011,Zaragoza,50213,Plenas,0,6,-6
2011,Zaragoza,50216,Pozuelo de Aragón,0,6,-6
2011,Zaragoza,50217,Pradilla de Ebro,6,13,-7
2011,Zaragoza,50218,Puebla de Albortón,1,1,0
2011,Zaragoza,50219,Puebla de Alfindén (La),99,16,83
2011,Zaragoza,50220,Puendeluna,0,1,-1
2011,Zaragoza,50222,Quinto,12,23,-11
2011,Zaragoza,50223,Remolinos,9,29,-20
2011,Zaragoza,50224,Retascón,0,3,-3
2011,Zaragoza,50225,Ricla,24,27,-3
2011,Zaragoza,50227,Romanos,1,3,-2
2011,Zaragoza,50228,Rueda de Jalón,2,5,-3
2011,Zaragoza,50229,Ruesca,0,1,-1
2011,Zaragoza,50231,Salillas de Jalón,1,3,-2
2011,Zaragoza,50232,Salvatierra de Esca,1,0,1
2011,Zaragoza,50233,Samper del Salz,0,3,-3
2011,Zaragoza,50234,San Martín de la Virgen de Moncayo,2,2,0
2011,Zaragoza,50235,San Mateo de Gállego,27,34,-7
2011,Zaragoza,50236,Santa Cruz de Grío,0,3,-3
2011,Zaragoza,50238,Santa Eulalia de Gállego,1,4,-3
2011,Zaragoza,50239,Santed,0,1,-1
2011,Zaragoza,50241,Saviñán,6,19,-13
2011,Zaragoza,50242,Sediles,0,2,-2
2011,Zaragoza,50243,Sestrica,1,6,-5
2011,Zaragoza,50244,Sierra de Luna,1,3,-2
2011,Zaragoza,50245,Sigüés,1,2,-1
2011,Zaragoza,50246,Sisamón,0,1,-1
2011,Zaragoza,50247,Sobradiel,16,13,3
2011,Zaragoza,50248,Sos del Rey Católico,1,8,-7
2011,Zaragoza,50230,Sádaba,12,52,-40
2011,Zaragoza,50240,Sástago,2,11,-9
2011,Zaragoza,50249,Tabuenca,0,8,-8
2011,Zaragoza,50250,Talamantes,0,1,-1
2011,Zaragoza,50251,Tarazona,97,106,-9
2011,Zaragoza,50252,Tauste,50,87,-37
2011,Zaragoza,50253,Terrer,2,9,-7
2011,Zaragoza,50254,Tierga,1,4,-3
2011,Zaragoza,50255,Tobed,1,6,-5
2011,Zaragoza,50256,Torralba de los Frailes,0,1,-1
2011,Zaragoza,50257,Torralba de Ribota,0,4,-4
2011,Zaragoza,50261,Torrellas,2,6,-4
2011,Zaragoza,50262,Torres de Berrellén,14,13,1
2011,Zaragoza,50263,Torrijo de la Cañada,0,6,-6
2011,Zaragoza,50264,Tosos,1,3,-2
2011,Zaragoza,50266,Trasobares,0,4,-4
2011,Zaragoza,50267,Uncastillo,1,19,-18
2011,Zaragoza,50268,Undués de Lerda,4,1,3
2011,Zaragoza,50269,Urrea de Jalón,5,14,-9
2011,Zaragoza,50271,Used,0,3,-3
2011,Zaragoza,50272,Utebo,233,77,156
2011,Zaragoza,50274,Val de San Martín,0,2,-2
2011,Zaragoza,50275,Valmadrid,0,1,-1
2011,Zaragoza,50276,Valpalmas,0,5,-5
2011,Zaragoza,50278,Velilla de Ebro,1,1,0
2011,Zaragoza,50279,Velilla de Jiloca,0,2,-2
2011,Zaragoza,50280,Vera de Moncayo,0,10,-10
2011,Zaragoza,50281,Vierlas,0,2,-2
2011,Zaragoza,50284,Villafeliche,0,2,-2
2011,Zaragoza,50285,Villafranca de Ebro,6,8,-2
2011,Zaragoza,50286,Villalba de Perejil,1,2,-1
2011,Zaragoza,50287,Villalengua,5,7,-2
2011,Zaragoza,50903,Villamayor de Gállego,11,24,-13
2011,Zaragoza,50288,Villanueva de Gállego,48,31,17
2011,Zaragoza,50290,Villanueva de Huerva,2,8,-6
2011,Zaragoza,50291,Villar de los Navarros,0,4,-4
2011,Zaragoza,50292,Villarreal de Huerva,1,2,-1
2011,Zaragoza,50293,Villarroya de la Sierra,2,11,-9
2011,Zaragoza,50294,Villarroya del Campo,0,2,-2
2011,Zaragoza,50282,Vilueña (La),0,4,-4
2011,Zaragoza,50296,Zaida (La),3,9,-6
2011,Zaragoza,50297,Zaragoza,6707,6081,626
2011,Zaragoza,50298,Zuera,86,67,19
2011,Zaragoza,50099,Épila,50,45,5
2010,Huesca,22001,Abiego,1,2,-1
2010,Huesca,22002,Abizanda,0,2,-2
2010,Huesca,22003,Adahuesca,1,1,0
2010,Huesca,22004,Agüero,1,6,-5
2010,Huesca,22007,Albalate de Cinca,5,14,-9
2010,Huesca,22008,Albalatillo,0,2,-2
2010,Huesca,22009,Albelda,3,15,-12
2010,Huesca,22011,Albero Alto,1,1,0
2010,Huesca,22012,Albero Bajo,0,1,-1
2010,Huesca,22013,Alberuela de Tubo,0,2,-2
2010,Huesca,22014,Alcalá de Gurrea,0,2,-2
2010,Huesca,22015,Alcalá del Obispo,1,5,-4
2010,Huesca,22016,Alcampell,2,13,-11
2010,Huesca,22017,Alcolea de Cinca,16,18,-2
2010,Huesca,22018,Alcubierre,2,3,-1
2010,Huesca,22019,Alerre,0,2,-2
2010,Huesca,22020,Alfántega,1,4,-3
2010,Huesca,22021,Almudévar,24,32,-8
2010,Huesca,22022,Almunia de San Juan,6,15,-9
2010,Huesca,22023,Almuniente,2,6,-4
2010,Huesca,22024,Alquézar,2,8,-6
2010,Huesca,22025,Altorricón,14,18,-4
2010,Huesca,22027,Angüés,1,14,-13
2010,Huesca,22028,Ansó,1,5,-4
2010,Huesca,22029,Antillón,0,1,-1
2010,Huesca,22032,Aragüés del Puerto,0,2,-2
2010,Huesca,22036,Argavieso,1,3,-2
2010,Huesca,22037,Arguis,1,3,-2
2010,Huesca,22035,Arén,0,2,-2
2010,Huesca,22039,Ayerbe,12,6,6
2010,Huesca,22040,Azanuy-Alins,3,2,1
2010,Huesca,22041,Azara,0,3,-3
2010,Huesca,22042,Azlor,1,2,-1
2010,Huesca,22907,Aínsa-Sobrarbe,22,20,2
2010,Huesca,22006,Aísa,0,5,-5
2010,Huesca,22043,Baells,0,1,-1
2010,Huesca,22044,Bailo,0,2,-2
2010,Huesca,22045,Baldellou,0,3,-3
2010,Huesca,22046,Ballobar,3,18,-15
2010,Huesca,22047,Banastás,3,0,3
2010,Huesca,22048,Barbastro,198,172,26
2010,Huesca,22049,Barbués,0,2,-2
2010,Huesca,22052,Belver de Cinca,11,20,-9
2010,Huesca,22053,Benabarre,13,20,-7
2010,Huesca,22054,Benasque,19,7,12
2010,Huesca,22246,Beranuy,0,2,-2
2010,Huesca,22055,Berbegal,1,11,-10
2010,Huesca,22057,Bielsa,4,10,-6
2010,Huesca,22058,Bierge,1,5,-4
2010,Huesca,22059,Biescas,11,24,-13
2010,Huesca,22060,Binaced,12,24,-12
2010,Huesca,22061,Binéfar,108,87,21
2010,Huesca,22062,Bisaurri,1,1,0
2010,Huesca,22063,Biscarrués,1,3,-2
2010,Huesca,22064,Blecua y Torres,0,1,-1
2010,Huesca,22066,Boltaña,10,7,3
2010,Huesca,22067,Bonansa,3,3,0
2010,Huesca,22068,Borau,1,1,0
2010,Huesca,22069,Broto,1,6,-5
2010,Huesca,22072,Caldearenas,4,2,2
2010,Huesca,22074,Campo,1,4,-3
2010,Huesca,22076,Canal de Berdún,1,5,-4
2010,Huesca,22077,Candasnos,0,4,-4
2010,Huesca,22078,Canfranc,2,6,-4
2010,Huesca,22079,Capdesaso,0,3,-3
2010,Huesca,22080,Capella,2,6,-4
2010,Huesca,22081,Casbas de Huesca,1,0,1
2010,Huesca,22083,Castejón de Monegros,3,13,-10
2010,Huesca,22084,Castejón de Sos,8,6,2
2010,Huesca,22082,Castejón del Puente,1,6,-5
2010,Huesca,22085,Castelflorite,1,1,0
2010,Huesca,22086,Castiello de Jaca,2,4,-2
2010,Huesca,22087,Castigaleu,1,2,-1
2010,Huesca,22088,Castillazuelo,1,4,-3
2010,Huesca,22089,Castillonroy,1,7,-6
2010,Huesca,22096,Chimillas,10,14,-4
2010,Huesca,22095,Chía,0,3,-3
2010,Huesca,22090,Colungo,0,3,-3
2010,Huesca,22099,Esplús,3,15,-12
2010,Huesca,22102,Estada,2,1,1
2010,Huesca,22103,Estadilla,7,21,-14
2010,Huesca,22105,Estopiñán del Castillo,0,2,-2
2010,Huesca,22107,Fanlo,0,1,-1
2010,Huesca,22109,Fiscal,4,2,2
2010,Huesca,22110,Fonz,5,10,-5
2010,Huesca,22111,Foradada del Toscar,1,0,1
2010,Huesca,22112,Fraga,154,119,35
2010,Huesca,22113,Fueva (La),6,3,3
2010,Huesca,22114,Gistaín,1,2,-1
2010,Huesca,22115,Grado (El),0,6,-6
2010,Huesca,22117,Graus,9,57,-48
2010,Huesca,22116,Grañén,11,37,-26
2010,Huesca,22119,Gurrea de Gállego,10,23,-13
2010,Huesca,22122,Hoz de Jaca,0,2,-2
2010,Huesca,22908,Hoz y Costeán,0,2,-2
2010,Huesca,22124,Huerto,2,3,-1
2010,Huesca,22125,Huesca,576,526,50
2010,Huesca,22126,Ibieca,0,2,-2
2010,Huesca,22127,Igriés,7,10,-3
2010,Huesca,22128,Ilche,1,4,-3
2010,Huesca,22129,Isábena,0,4,-4
2010,Huesca,22130,Jaca,125,140,-15
2010,Huesca,22131,Jasa,0,1,-1
2010,Huesca,22133,Labuerda,0,2,-2
2010,Huesca,22135,Laluenga,0,4,-4
2010,Huesca,22136,Lalueza,5,21,-16
2010,Huesca,22137,Lanaja,7,23,-16
2010,Huesca,22139,Laperdiguera,1,2,-1
2010,Huesca,22141,Lascellas-Ponzano,0,1,-1
2010,Huesca,22142,Lascuarre,1,2,-1
2010,Huesca,22143,Laspaúles,2,2,0
2010,Huesca,22144,Laspuña,4,3,1
2010,Huesca,22149,Loarre,1,7,-6
2010,Huesca,22150,Loporzano,7,5,2
2010,Huesca,22151,Loscorrales,1,1,0
2010,Huesca,22905,Lupiñén-Ortilla,5,3,2
2010,Huesca,22155,Monesma y Cajigar,0,3,-3
2010,Huesca,22156,Monflorite-Lascasas,4,1,3
2010,Huesca,22157,Montanuy,0,3,-3
2010,Huesca,22158,Monzón,179,159,20
2010,Huesca,22160,Naval,1,1,0
2010,Huesca,22162,Novales,2,3,-1
2010,Huesca,22163,Nueno,4,5,-1
2010,Huesca,22164,Olvena,1,0,1
2010,Huesca,22165,Ontiñena,3,9,-6
2010,Huesca,22167,Osso de Cinca,5,13,-8
2010,Huesca,22168,Palo,1,0,1
2010,Huesca,22170,Panticosa,2,6,-4
2010,Huesca,22174,Peralta de Alcofea,2,10,-8
2010,Huesca,22175,Peralta de Calasanz,1,4,-3
2010,Huesca,22176,Peraltilla,2,0,2
2010,Huesca,22177,Perarrúa,0,1,-1
2010,Huesca,22178,Pertusa,1,0,1
2010,Huesca,22172,Peñalba,0,1,-1
2010,Huesca,22173,Peñas de Riglos (Las),1,9,-8
2010,Huesca,22181,Piracés,1,0,1
2010,Huesca,22182,Plan,0,3,-3
2010,Huesca,22184,Poleñino,1,2,-1
2010,Huesca,22186,Pozán de Vero,1,5,-4
2010,Huesca,22187,Puebla de Castro (La),4,3,1
2010,Huesca,22188,Puente de Montañana,0,1,-1
2010,Huesca,22902,Puente la Reina de Jaca,0,3,-3
2010,Huesca,22190,Pueyo de Araguás (El),0,3,-3
2010,Huesca,22193,Pueyo de Santa Cruz,2,5,-3
2010,Huesca,22189,Puértolas,1,3,-2
2010,Huesca,22195,Quicena,3,1,2
2010,Huesca,22197,Robres,1,6,-5
2010,Huesca,22199,Sabiñánigo,74,110,-36
2010,Huesca,22200,Sahún,1,4,-3
2010,Huesca,22201,Salas Altas,0,6,-6
2010,Huesca,22202,Salas Bajas,2,2,0
2010,Huesca,22203,Salillas,0,2,-2
2010,Huesca,22204,Sallent de Gállego,12,5,7
2010,Huesca,22205,San Esteban de Litera,1,15,-14
2010,Huesca,22207,San Juan de Plan,3,1,2
2010,Huesca,22903,San Miguel del Cinca,9,17,-8
2010,Huesca,22206,Sangarrén,0,3,-3
2010,Huesca,22208,Santa Cilia,2,1,1
2010,Huesca,22209,Santa Cruz de la Serós,0,1,-1
2010,Huesca,22906,Santa María de Dulcis,0,3,-3
2010,Huesca,22212,Santaliestra y San Quílez,0,1,-1
2010,Huesca,22213,Sariñena,42,44,-2
2010,Huesca,22214,Secastilla,1,0,1
2010,Huesca,22215,Seira,0,1,-1
2010,Huesca,22217,Sena,6,8,-2
2010,Huesca,22218,Senés de Alcubierre,0,1,-1
2010,Huesca,22220,Sesa,1,7,-6
2010,Huesca,22221,Sesué,2,0,2
2010,Huesca,22222,Siétamo,3,7,-4
2010,Huesca,22223,Sopeira,0,1,-1
2010,Huesca,22904,Sotonera (La),3,14,-11
2010,Huesca,22225,Tamarite de Litera,37,56,-19
2010,Huesca,22226,Tardienta,9,11,-2
2010,Huesca,22227,Tella-Sin,0,2,-2
2010,Huesca,22228,Tierz,9,2,7
2010,Huesca,22229,Tolva,0,4,-4
2010,Huesca,22230,Torla-Ordesa,2,3,-1
2010,Huesca,22232,Torralba de Aragón,0,2,-2
2010,Huesca,22233,Torre la Ribera,2,1,1
2010,Huesca,22234,Torrente de Cinca,0,10,-10
2010,Huesca,22235,Torres de Alcanadre,2,1,1
2010,Huesca,22236,Torres de Barbués,2,2,0
2010,Huesca,22239,Tramaced,1,4,-3
2010,Huesca,22242,Valfarta,0,1,-1
2010,Huesca,22901,Valle de Hecho,2,8,-6
2010,Huesca,22245,Velilla de Cinca,1,5,-4
2010,Huesca,22909,Vencillón,6,5,1
2010,Huesca,22248,Vicién,0,2,-2
2010,Huesca,22249,Villanova,1,0,1
2010,Huesca,22251,Villanueva de Sigena,1,5,-4
2010,Huesca,22250,Villanúa,5,2,3
2010,Huesca,22252,Yebra de Basa,0,2,-2
2010,Huesca,22254,Zaidín,8,18,-10
2010,Teruel,44001,Ababuj,1,2,-1
2010,Teruel,44002,Abejuela,0,1,-1
2010,Teruel,44004,Aguaviva,1,5,-4
2010,Teruel,44005,Aguilar del Alfambra,0,1,-1
2010,Teruel,44006,Alacón,1,5,-4
2010,Teruel,44007,Alba,1,2,-1
2010,Teruel,44008,Albalate del Arzobispo,17,25,-8
2010,Teruel,44009,Albarracín,11,12,-1
2010,Teruel,44010,Albentosa,5,3,2
2010,Teruel,44011,Alcaine,1,1,0
2010,Teruel,44012,Alcalá de la Selva,6,9,-3
2010,Teruel,44013,Alcañiz,230,163,67
2010,Teruel,44014,Alcorisa,37,49,-12
2010,Teruel,44016,Alfambra,2,12,-10
2010,Teruel,44017,Aliaga,3,4,-1
2010,Teruel,44021,Allepuz,0,5,-5
2010,Teruel,44022,Alloza,5,9,-4
2010,Teruel,44025,Andorra,62,75,-13
2010,Teruel,44026,Arcos de las Salinas,0,2,-2
2010,Teruel,44027,Arens de Lledó,1,5,-4
2010,Teruel,44028,Argente,1,7,-6
2010,Teruel,44029,Ariño,6,14,-8
2010,Teruel,44031,Azaila,0,2,-2
2010,Teruel,44035,Barrachina,2,2,0
2010,Teruel,44034,Bañón,0,1,-1
2010,Teruel,44037,Beceite,5,8,-3
2010,Teruel,44039,Bello,0,2,-2
2010,Teruel,44038,Belmonte de San José,0,5,-5
2010,Teruel,44040,Berge,1,6,-5
2010,Teruel,44041,Bezas,0,1,-1
2010,Teruel,44042,Blancas,0,1,-1
2010,Teruel,44044,Bordón,0,2,-2
2010,Teruel,44045,Bronchales,1,3,-2
2010,Teruel,44046,Bueña,0,1,-1
2010,Teruel,44047,Burbáguena,0,15,-15
2010,Teruel,44033,Báguena,0,6,-6
2010,Teruel,44048,Cabra de Mora,0,1,-1
2010,Teruel,44049,Calaceite,6,23,-17
2010,Teruel,44050,Calamocha,47,45,2
2010,Teruel,44051,Calanda,23,45,-22
2010,Teruel,44052,Calomarde,0,2,-2
2010,Teruel,44054,Camarena de la Sierra,1,4,-3
2010,Teruel,44055,Camarillas,0,1,-1
2010,Teruel,44053,Camañas,0,3,-3
2010,Teruel,44056,Caminreal,4,13,-9
2010,Teruel,44059,Cantavieja,8,8,0
2010,Teruel,44065,Castejón de Tornos,0,1,-1
2010,Teruel,44066,Castel de Cabra,0,2,-2
2010,Teruel,44070,Castellar (El),0,1,-1
2010,Teruel,44071,Castellote,1,5,-4
2010,Teruel,44067,Castelnou,0,3,-3
2010,Teruel,44068,Castelserás,2,15,-13
2010,Teruel,44060,Cañada de Benatanduz,0,1,-1
2010,Teruel,44061,Cañada de Verich (La),0,1,-1
2010,Teruel,44062,Cañada Vellida,0,1,-1
2010,Teruel,44063,Cañizar del Olivar,2,1,1
2010,Teruel,44074,Cedrillas,2,11,-9
2010,Teruel,44075,Celadas,0,5,-5
2010,Teruel,44076,Cella,16,26,-10
2010,Teruel,44077,Cerollera (La),0,1,-1
2010,Teruel,44080,Codoñera (La),2,4,-2
2010,Teruel,44082,Corbalán,0,2,-2
2010,Teruel,44084,Cortes de Aragón,0,2,-2
2010,Teruel,44085,Cosa,0,2,-2
2010,Teruel,44086,Cretas,2,12,-10
2010,Teruel,44089,Cubla,0,2,-2
2010,Teruel,44090,Cucalón,1,2,-1
2010,Teruel,44092,Cuervo (El),0,4,-4
2010,Teruel,44093,Cuevas de Almudén,5,0,5
2010,Teruel,44094,Cuevas Labradas,0,1,-1
2010,Teruel,44096,Ejulve,0,1,-1
2010,Teruel,44097,Escorihuela,0,1,-1
2010,Teruel,44099,Escucha,7,10,-3
2010,Teruel,44100,Estercuel,4,6,-2
2010,Teruel,44101,Ferreruela de Huerva,0,2,-2
2010,Teruel,44103,Formiche Alto,0,7,-7
2010,Teruel,44106,Fortanete,3,3,0
2010,Teruel,44107,Foz-Calanda,2,3,-1
2010,Teruel,44108,Fresneda (La),4,8,-4
2010,Teruel,44109,Frías de Albarracín,0,2,-2
2010,Teruel,44111,Fuentes Calientes,1,0,1
2010,Teruel,44112,Fuentes Claras,3,10,-7
2010,Teruel,44113,Fuentes de Rubielos,1,1,0
2010,Teruel,44114,Fuentespalda,2,14,-12
2010,Teruel,44105,Fórnoles,1,1,0
2010,Teruel,44115,Galve,1,0,1
2010,Teruel,44116,Gargallo,1,0,1
2010,Teruel,44117,Gea de Albarracín,2,7,-5
2010,Teruel,44118,Ginebrosa (La),0,1,-1
2010,Teruel,44119,Griegos,1,1,0
2010,Teruel,44120,Guadalaviar,2,1,1
2010,Teruel,44121,Gúdar,2,0,2
2010,Teruel,44123,Hinojosa de Jarque,3,4,-1
2010,Teruel,44125,Huesa del Común,0,1,-1
2010,Teruel,44122,Híjar,10,33,-23
2010,Teruel,44126,Iglesuela del Cid (La),4,4,0
2010,Teruel,44128,Jarque de la Val,1,0,1
2010,Teruel,44129,Jatiel,0,0,0
2010,Teruel,44130,Jorcas,0,1,-1
2010,Teruel,44133,Lanzuela,1,0,1
2010,Teruel,44135,Libros,0,4,-4
2010,Teruel,44137,Linares de Mora,0,2,-2
2010,Teruel,44141,Lledó,0,2,-2
2010,Teruel,44138,Loscos,0,3,-3
2010,Teruel,44143,Manzanera,5,7,-2
2010,Teruel,44144,Martín del Río,2,8,-6
2010,Teruel,44145,Mas de las Matas,9,27,-18
2010,Teruel,44146,Mata de los Olmos (La),2,2,0
2010,Teruel,44147,Mazaleón,2,9,-7
2010,Teruel,44148,Mezquita de Jarque,0,1,-1
2010,Teruel,44149,Mirambel,2,3,-1
2010,Teruel,44150,Miravete de la Sierra,0,1,-1
2010,Teruel,44151,Molinos,2,6,-4
2010,Teruel,44153,Monreal del Campo,25,23,2
2010,Teruel,44154,Monroyo,4,6,-2
2010,Teruel,44155,Montalbán,9,13,-4
2010,Teruel,44156,Monteagudo del Castillo,0,1,-1
2010,Teruel,44157,Monterde de Albarracín,0,1,-1
2010,Teruel,44158,Mora de Rubielos,15,13,2
2010,Teruel,44159,Moscardón,1,2,-1
2010,Teruel,44160,Mosqueruela,5,10,-5
2010,Teruel,44161,Muniesa,6,8,-2
2010,Teruel,44163,Noguera de Albarracín,2,2,0
2010,Teruel,44164,Nogueras,0,1,-1
2010,Teruel,44165,Nogueruelas,1,3,-2
2010,Teruel,44167,Obón,0,1,-1
2010,Teruel,44168,Odón,1,2,-1
2010,Teruel,44169,Ojos Negros,3,9,-6
2010,Teruel,44171,Olba,2,2,0
2010,Teruel,44172,Oliete,1,6,-5
2010,Teruel,44173,Olmos (Los),0,1,-1
2010,Teruel,44174,Orihuela del Tremedal,3,10,-7
2010,Teruel,44175,Orrios,0,1,-1
2010,Teruel,44176,Palomar de Arroyos,0,3,-3
2010,Teruel,44177,Pancrudo,0,1,-1
2010,Teruel,44178,Parras de Castellote (Las),0,1,-1
2010,Teruel,44180,Peracense,1,2,-1
2010,Teruel,44182,Perales del Alfambra,1,3,-2
2010,Teruel,44179,Peñarroya de Tastavins,3,8,-5
2010,Teruel,44183,Pitarque,2,2,0
2010,Teruel,44185,Pobo (El),0,2,-2
2010,Teruel,44187,Portellada (La),0,4,-4
2010,Teruel,44190,Pozuel del Campo,0,3,-3
2010,Teruel,44191,Puebla de Híjar (La),6,14,-8
2010,Teruel,44192,Puebla de Valverde (La),3,9,-6
2010,Teruel,44193,Puertomingalvo,1,0,1
2010,Teruel,44195,Rillo,0,3,-3
2010,Teruel,44196,Riodeva,1,3,-2
2010,Teruel,44198,Royuela,2,1,1
2010,Teruel,44199,Rubiales,0,1,-1
2010,Teruel,44201,Rubielos de Mora,5,4,1
2010,Teruel,44194,Ráfales,3,5,-2
2010,Teruel,44197,Ródenas,0,1,-1
2010,Teruel,44204,Saldón,1,1,0
2010,Teruel,44205,Samper de Calanda,2,15,-13
2010,Teruel,44206,San Agustín,1,2,-1
2010,Teruel,44207,San Martín del Río,0,6,-6
2010,Teruel,44209,Santa Eulalia,10,13,-3
2010,Teruel,44210,Sarrión,9,15,-6
2010,Teruel,44211,Segura de los Baños,0,1,-1
2010,Teruel,44212,Seno,0,1,-1
2010,Teruel,44213,Singra,0,2,-2
2010,Teruel,44215,Terriente,1,2,-1
2010,Teruel,44216,Teruel,360,316,44
2010,Teruel,44218,Tormón,0,3,-3
2010,Teruel,44219,Tornos,0,4,-4
2010,Teruel,44220,Torralba de los Sisones,0,1,-1
2010,Teruel,44223,Torre de Arcas,1,1,0
2010,Teruel,44224,Torre de las Arcas,0,3,-3
2010,Teruel,44225,Torre del Compte,1,2,-1
2010,Teruel,44222,Torrecilla del Rebollar,0,3,-3
2010,Teruel,44226,Torrelacárcel,0,5,-5
2010,Teruel,44229,Torres de Albarracín,0,1,-1
2010,Teruel,44230,Torrevelilla,1,3,-2
2010,Teruel,44231,Torrijas,0,2,-2
2010,Teruel,44232,Torrijo del Campo,3,11,-8
2010,Teruel,44234,Tramacastiel,1,4,-3
2010,Teruel,44235,Tramacastilla,0,2,-2
2010,Teruel,44236,Tronchón,0,1,-1
2010,Teruel,44237,Urrea de Gaén,3,9,-6
2010,Teruel,44238,Utrillas,25,27,-2
2010,Teruel,44239,Valacloche,0,1,-1
2010,Teruel,44240,Valbona,0,3,-3
2010,Teruel,44241,Valdealgorfa,5,11,-6
2010,Teruel,44244,Valdelinares,0,1,-1
2010,Teruel,44245,Valdeltormo,1,3,-2
2010,Teruel,44246,Valderrobres,23,37,-14
2010,Teruel,44247,Valjunquera,1,12,-11
2010,Teruel,44250,Veguillas de la Sierra,0,2,-2
2010,Teruel,44251,Villafranca del Campo,3,6,-3
2010,Teruel,44252,Villahermosa del Campo,0,1,-1
2010,Teruel,44256,Villanueva del Rebollar de la Sierra,0,1,-1
2010,Teruel,44257,Villar del Cobo,3,1,2
2010,Teruel,44258,Villar del Salz,0,3,-3
2010,Teruel,44260,Villarluengo,1,2,-1
2010,Teruel,44261,Villarquemado,4,19,-15
2010,Teruel,44262,Villarroya de los Pinares,1,3,-2
2010,Teruel,44263,Villastar,9,3,6
2010,Teruel,44264,Villel,2,8,-6
2010,Teruel,44265,Vinaceite,1,6,-5
2010,Teruel,44266,Visiedo,1,1,0
2010,Teruel,44267,Vivel del Río Martín,0,2,-2
2010,Zaragoza,50001,Abanto,0,3,-3
2010,Zaragoza,50002,Acered,0,6,-6
2010,Zaragoza,50004,Aguarón,3,13,-10
2010,Zaragoza,50005,Aguilón,1,3,-2
2010,Zaragoza,50003,Agón,1,3,-2
2010,Zaragoza,50006,Ainzón,7,17,-10
2010,Zaragoza,50008,Alagón,75,82,-7
2010,Zaragoza,50009,Alarba,0,2,-2
2010,Zaragoza,50010,Alberite de San Juan,0,1,-1
2010,Zaragoza,50011,Albeta,1,2,-1
2010,Zaragoza,50012,Alborge,1,0,1
2010,Zaragoza,50013,Alcalá de Ebro,0,4,-4
2010,Zaragoza,50014,Alcalá de Moncayo,2,1,1
2010,Zaragoza,50015,Alconchel de Ariza,0,5,-5
2010,Zaragoza,50017,Alfajarín,29,21,8
2010,Zaragoza,50018,Alfamén,17,11,6
2010,Zaragoza,50019,Alforque,0,1,-1
2010,Zaragoza,50020,Alhama de Aragón,15,15,0
2010,Zaragoza,50022,Almolda (La),1,8,-7
2010,Zaragoza,50023,Almonacid de la Cuba,0,6,-6
2010,Zaragoza,50024,Almonacid de la Sierra,4,17,-13
2010,Zaragoza,50025,Almunia de Doña Godina (La),98,75,23
2010,Zaragoza,50026,Alpartir,4,7,-3
2010,Zaragoza,50027,Ambel,2,11,-9
2010,Zaragoza,50028,Anento,1,0,1
2010,Zaragoza,50029,Aniñón,3,10,-7
2010,Zaragoza,50031,Aranda de Moncayo,0,3,-3
2010,Zaragoza,50033,Ardisa,0,1,-1
2010,Zaragoza,50034,Ariza,14,11,3
2010,Zaragoza,50035,Artieda,0,1,-1
2010,Zaragoza,50032,Arándiga,0,11,-11
2010,Zaragoza,50036,Asín,0,5,-5
2010,Zaragoza,50037,Atea,0,2,-2
2010,Zaragoza,50038,Ateca,7,23,-16
2010,Zaragoza,50039,Azuara,1,7,-6
2010,Zaragoza,50030,Añón de Moncayo,1,7,-6
2010,Zaragoza,50040,Badules,0,2,-2
2010,Zaragoza,50041,Bagüés,0,1,-1
2010,Zaragoza,50042,Balconchán,0,1,-1
2010,Zaragoza,50044,Bardallur,0,6,-6
2010,Zaragoza,50045,Belchite,9,24,-15
2010,Zaragoza,50046,Belmonte de Gracián,0,6,-6
2010,Zaragoza,50901,Biel,0,2,-2
2010,Zaragoza,50050,Bijuesca,0,1,-1
2010,Zaragoza,50051,Biota,8,15,-7
2010,Zaragoza,50052,Bisimbre,1,1,0
2010,Zaragoza,50053,Boquiñeni,9,16,-7
2010,Zaragoza,50054,Bordalba,0,1,-1
2010,Zaragoza,50055,Borja,61,53,8
2010,Zaragoza,50056,Botorrita,2,0,2
2010,Zaragoza,50057,Brea de Aragón,16,21,-5
2010,Zaragoza,50058,Bubierca,0,1,-1
2010,Zaragoza,50059,Bujaraloz,6,17,-11
2010,Zaragoza,50060,Bulbuente,2,5,-3
2010,Zaragoza,50061,Bureta,1,6,-5
2010,Zaragoza,50062,Burgo de Ebro (El),30,16,14
2010,Zaragoza,50063,Buste (El),0,3,-3
2010,Zaragoza,50043,Bárboles,3,4,-1
2010,Zaragoza,50064,Cabañas de Ebro,3,7,-4
2010,Zaragoza,50066,Cadrete,49,24,25
2010,Zaragoza,50067,Calatayud,206,216,-10
2010,Zaragoza,50068,Calatorao,27,30,-3
2010,Zaragoza,50069,Calcena,0,4,-4
2010,Zaragoza,50070,Calmarza,3,2,1
2010,Zaragoza,50072,Carenas,0,3,-3
2010,Zaragoza,50073,Cariñena,46,44,2
2010,Zaragoza,50074,Caspe,88,101,-13
2010,Zaragoza,50075,Castejón de Alarba,0,2,-2
2010,Zaragoza,50076,Castejón de las Armas,0,1,-1
2010,Zaragoza,50077,Castejón de Valdejasa,0,4,-4
2010,Zaragoza,50078,Castiliscar,5,8,-3
2010,Zaragoza,50079,Cervera de la Cañada,0,4,-4
2010,Zaragoza,50081,Cetina,5,12,-7
2010,Zaragoza,50092,Chiprana,6,5,1
2010,Zaragoza,50093,Chodes,0,3,-3
2010,Zaragoza,50082,Cimballa,0,1,-1
2010,Zaragoza,50083,Cinco Olivas,0,3,-3
2010,Zaragoza,50084,Clarés de Ribota,0,1,-1
2010,Zaragoza,50085,Codo,0,4,-4
2010,Zaragoza,50086,Codos,0,1,-1
2010,Zaragoza,50087,Contamina,0,2,-2
2010,Zaragoza,50088,Cosuenda,0,3,-3
2010,Zaragoza,50089,Cuarte de Huerva,236,29,207
2010,Zaragoza,50090,Cubel,1,2,-1
2010,Zaragoza,50094,Daroca,16,39,-23
2010,Zaragoza,50095,Ejea de los Caballeros,152,178,-26
2010,Zaragoza,50096,Embid de Ariza,0,1,-1
2010,Zaragoza,50098,Encinacorba,1,2,-1
2010,Zaragoza,50100,Erla,2,6,-4
2010,Zaragoza,50101,Escatrón,10,16,-6
2010,Zaragoza,50102,Fabara,11,15,-4
2010,Zaragoza,50104,Farlete,0,3,-3
2010,Zaragoza,50106,Fayos (Los),0,2,-2
2010,Zaragoza,50105,Fayón,3,8,-5
2010,Zaragoza,50107,Figueruelas,11,24,-13
2010,Zaragoza,50110,Frasno (El),0,8,-8
2010,Zaragoza,50111,Fréscano,0,5,-5
2010,Zaragoza,50113,Fuendejalón,7,9,-2
2010,Zaragoza,50114,Fuendetodos,2,3,-1
2010,Zaragoza,50115,Fuentes de Ebro,48,44,4
2010,Zaragoza,50116,Fuentes de Jiloca,1,7,-6
2010,Zaragoza,50117,Gallocanta,3,1,2
2010,Zaragoza,50118,Gallur,22,29,-7
2010,Zaragoza,50119,Gelsa,4,12,-8
2010,Zaragoza,50120,Godojos,0,2,-2
2010,Zaragoza,50121,Gotor,1,3,-2
2010,Zaragoza,50122,Grisel,0,2,-2
2010,Zaragoza,50123,Grisén,7,9,-2
2010,Zaragoza,50124,Herrera de los Navarros,2,9,-7
2010,Zaragoza,50125,Ibdes,2,13,-11
2010,Zaragoza,50126,Illueca,16,36,-20
2010,Zaragoza,50128,Isuerre,0,1,-1
2010,Zaragoza,50129,Jaraba,6,6,0
2010,Zaragoza,50130,Jarque de Moncayo,1,5,-4
2010,Zaragoza,50131,Jaulín,2,8,-6
2010,Zaragoza,50132,Joyosa (La),14,10,4
2010,Zaragoza,50133,Lagata,0,3,-3
2010,Zaragoza,50134,Langa del Castillo,0,2,-2
2010,Zaragoza,50135,Layana,0,1,-1
2010,Zaragoza,50138,Lechón,0,2,-2
2010,Zaragoza,50137,Leciñena,9,15,-6
2010,Zaragoza,50139,Letux,0,6,-6
2010,Zaragoza,50140,Litago,0,1,-1
2010,Zaragoza,50141,Lituénigo,1,1,0
2010,Zaragoza,50143,Longares,4,15,-11
2010,Zaragoza,50144,Longás,0,0,0
2010,Zaragoza,50146,Lucena de Jalón,3,6,-3
2010,Zaragoza,50147,Luceni,14,21,-7
2010,Zaragoza,50148,Luesia,2,8,-6
2010,Zaragoza,50150,Lumpiaque,13,15,-2
2010,Zaragoza,50151,Luna,1,15,-14
2010,Zaragoza,50136,Lécera,2,12,-10
2010,Zaragoza,50152,Maella,12,19,-7
2010,Zaragoza,50153,Magallón,7,15,-8
2010,Zaragoza,50154,Mainar,1,0,1
2010,Zaragoza,50156,Maleján,4,6,-2
2010,Zaragoza,50160,Mallén,35,34,1
2010,Zaragoza,50159,Maluenda,5,12,-7
2010,Zaragoza,50157,Malón,3,7,-4
2010,Zaragoza,50161,Manchones,0,5,-5
2010,Zaragoza,50162,Mara,0,6,-6
2010,Zaragoza,50163,María de Huerva,107,16,91
2010,Zaragoza,50164,Mediana de Aragón,2,9,-7
2010,Zaragoza,50165,Mequinenza,12,27,-15
2010,Zaragoza,50166,Mesones de Isuela,3,5,-2
2010,Zaragoza,50167,Mezalocha,0,5,-5
2010,Zaragoza,50169,Miedes de Aragón,1,6,-5
2010,Zaragoza,50170,Monegrillo,2,6,-4
2010,Zaragoza,50172,Monreal de Ariza,0,4,-4
2010,Zaragoza,50173,Monterde,1,1,0
2010,Zaragoza,50174,Montón,2,3,-1
2010,Zaragoza,50175,Morata de Jalón,4,18,-14
2010,Zaragoza,50176,Morata de Jiloca,0,6,-6
2010,Zaragoza,50178,Moros,0,6,-6
2010,Zaragoza,50177,Morés,3,14,-11
2010,Zaragoza,50179,Moyuela,1,6,-5
2010,Zaragoza,50180,Mozota,0,1,-1
2010,Zaragoza,50181,Muel,11,10,1
2010,Zaragoza,50182,Muela (La),101,26,75
2010,Zaragoza,50183,Munébrega,0,8,-8
2010,Zaragoza,50184,Murero,1,4,-3
2010,Zaragoza,50185,Murillo de Gállego,1,3,-2
2010,Zaragoza,50187,Nigüella,0,1,-1
2010,Zaragoza,50189,Nonaspe,2,23,-21
2010,Zaragoza,50190,Novallas,7,9,-2
2010,Zaragoza,50191,Novillas,1,13,-12
2010,Zaragoza,50193,Nuez de Ebro,8,7,1
2010,Zaragoza,50192,Nuévalos,6,1,5
2010,Zaragoza,50196,Orera,0,2,-2
2010,Zaragoza,50197,Orés,0,5,-5
2010,Zaragoza,50199,Osera de Ebro,1,18,-17
2010,Zaragoza,50200,Paniza,4,9,-5
2010,Zaragoza,50201,Paracuellos de Jiloca,5,9,-4
2010,Zaragoza,50202,Paracuellos de la Ribera,0,2,-2
2010,Zaragoza,50203,Pastriz,10,13,-3
2010,Zaragoza,50204,Pedrola,38,31,7
2010,Zaragoza,50205,Pedrosas (Las),2,3,-1
2010,Zaragoza,50206,Perdiguera,2,5,-3
2010,Zaragoza,50207,Piedratajada,0,1,-1
2010,Zaragoza,50208,Pina de Ebro,18,26,-8
2010,Zaragoza,50209,Pinseque,51,50,1
2010,Zaragoza,50210,Pintanos (Los),0,2,-2
2010,Zaragoza,50211,Plasencia de Jalón,1,6,-5
2010,Zaragoza,50213,Plenas,1,1,0
2010,Zaragoza,50216,Pozuelo de Aragón,1,3,-2
2010,Zaragoza,50217,Pradilla de Ebro,4,11,-7
2010,Zaragoza,50218,Puebla de Albortón,1,1,0
2010,Zaragoza,50219,Puebla de Alfindén (La),105,30,75
2010,Zaragoza,50222,Quinto,17,22,-5
2010,Zaragoza,50223,Remolinos,7,19,-12
2010,Zaragoza,50225,Ricla,23,30,-7
2010,Zaragoza,50228,Rueda de Jalón,4,6,-2
2010,Zaragoza,50229,Ruesca,0,1,-1
2010,Zaragoza,50231,Salillas de Jalón,2,5,-3
2010,Zaragoza,50232,Salvatierra de Esca,0,3,-3
2010,Zaragoza,50234,San Martín de la Virgen de Moncayo,2,2,0
2010,Zaragoza,50235,San Mateo de Gállego,24,26,-2
2010,Zaragoza,50236,Santa Cruz de Grío,2,3,-1
2010,Zaragoza,50237,Santa Cruz de Moncayo,0,2,-2
2010,Zaragoza,50238,Santa Eulalia de Gállego,1,1,0
2010,Zaragoza,50239,Santed,0,0,0
2010,Zaragoza,50241,Saviñán,2,8,-6
2010,Zaragoza,50242,Sediles,0,1,-1
2010,Zaragoza,50243,Sestrica,2,4,-2
2010,Zaragoza,50244,Sierra de Luna,0,3,-3
2010,Zaragoza,50245,Sigüés,0,1,-1
2010,Zaragoza,50246,Sisamón,0,3,-3
2010,Zaragoza,50247,Sobradiel,12,13,-1
2010,Zaragoza,50248,Sos del Rey Católico,4,10,-6
2010,Zaragoza,50230,Sádaba,9,27,-18
2010,Zaragoza,50240,Sástago,0,12,-12
2010,Zaragoza,50249,Tabuenca,0,5,-5
2010,Zaragoza,50250,Talamantes,0,4,-4
2010,Zaragoza,50251,Tarazona,112,117,-5
2010,Zaragoza,50252,Tauste,59,79,-20
2010,Zaragoza,50253,Terrer,2,10,-8
2010,Zaragoza,50254,Tierga,0,3,-3
2010,Zaragoza,50255,Tobed,0,7,-7
2010,Zaragoza,50256,Torralba de los Frailes,0,2,-2
2010,Zaragoza,50257,Torralba de Ribota,0,3,-3
2010,Zaragoza,50258,Torralbilla,0,1,-1
2010,Zaragoza,50259,Torrehermosa,0,1,-1
2010,Zaragoza,50260,Torrelapaja,0,2,-2
2010,Zaragoza,50261,Torrellas,3,2,1
2010,Zaragoza,50262,Torres de Berrellén,30,16,14
2010,Zaragoza,50263,Torrijo de la Cañada,0,3,-3
2010,Zaragoza,50264,Tosos,1,3,-2
2010,Zaragoza,50265,Trasmoz,0,1,-1
2010,Zaragoza,50266,Trasobares,0,1,-1
2010,Zaragoza,50267,Uncastillo,1,16,-15
2010,Zaragoza,50268,Undués de Lerda,1,0,1
2010,Zaragoza,50269,Urrea de Jalón,5,12,-7
2010,Zaragoza,50271,Used,0,10,-10
2010,Zaragoza,50272,Utebo,272,91,181
2010,Zaragoza,50274,Val de San Martín,0,1,-1
2010,Zaragoza,50273,Valdehorna,0,1,-1
2010,Zaragoza,50275,Valmadrid,2,0,2
2010,Zaragoza,50276,Valpalmas,0,3,-3
2010,Zaragoza,50277,Valtorres,0,2,-2
2010,Zaragoza,50278,Velilla de Ebro,1,5,-4
2010,Zaragoza,50279,Velilla de Jiloca,0,1,-1
2010,Zaragoza,50280,Vera de Moncayo,0,11,-11
2010,Zaragoza,50281,Vierlas,0,3,-3
2010,Zaragoza,50283,Villadoz,0,2,-2
2010,Zaragoza,50284,Villafeliche,0,3,-3
2010,Zaragoza,50285,Villafranca de Ebro,8,9,-1
2010,Zaragoza,50286,Villalba de Perejil,1,3,-2
2010,Zaragoza,50287,Villalengua,2,9,-7
2010,Zaragoza,50903,Villamayor de Gállego,14,21,-7
2010,Zaragoza,50288,Villanueva de Gállego,49,36,13
2010,Zaragoza,50290,Villanueva de Huerva,1,10,-9
2010,Zaragoza,50289,Villanueva de Jiloca,0,2,-2
2010,Zaragoza,50291,Villar de los Navarros,2,1,1
2010,Zaragoza,50292,Villarreal de Huerva,3,3,0
2010,Zaragoza,50293,Villarroya de la Sierra,1,10,-9
2010,Zaragoza,50294,Villarroya del Campo,0,0,0
2010,Zaragoza,50296,Zaida (La),2,6,-4
2010,Zaragoza,50297,Zaragoza,6862,5859,1003
2010,Zaragoza,50298,Zuera,74,57,17
2010,Zaragoza,50099,Épila,53,48,5
2009,Huesca,22001,Abiego,0,7,-7
2009,Huesca,22003,Adahuesca,0,1,-1
2009,Huesca,22004,Agüero,0,5,-5
2009,Huesca,22007,Albalate de Cinca,10,19,-9
2009,Huesca,22008,Albalatillo,0,4,-4
2009,Huesca,22009,Albelda,6,22,-16
2009,Huesca,22011,Albero Alto,0,2,-2
2009,Huesca,22012,Albero Bajo,0,1,-1
2009,Huesca,22013,Alberuela de Tubo,0,7,-7
2009,Huesca,22014,Alcalá de Gurrea,0,9,-9
2009,Huesca,22015,Alcalá del Obispo,1,7,-6
2009,Huesca,22016,Alcampell,4,16,-12
2009,Huesca,22017,Alcolea de Cinca,11,20,-9
2009,Huesca,22018,Alcubierre,4,6,-2
2009,Huesca,22019,Alerre,0,1,-1
2009,Huesca,22020,Alfántega,1,0,1
2009,Huesca,22021,Almudévar,21,31,-10
2009,Huesca,22022,Almunia de San Juan,4,4,0
2009,Huesca,22023,Almuniente,2,5,-3
2009,Huesca,22024,Alquézar,2,6,-4
2009,Huesca,22025,Altorricón,7,15,-8
2009,Huesca,22027,Angüés,1,17,-16
2009,Huesca,22028,Ansó,6,11,-5
2009,Huesca,22029,Antillón,0,3,-3
2009,Huesca,22032,Aragüés del Puerto,0,1,-1
2009,Huesca,22036,Argavieso,1,5,-4
2009,Huesca,22035,Arén,1,2,-1
2009,Huesca,22039,Ayerbe,10,13,-3
2009,Huesca,22040,Azanuy-Alins,1,3,-2
2009,Huesca,22041,Azara,0,4,-4
2009,Huesca,22042,Azlor,0,4,-4
2009,Huesca,22907,Aínsa-Sobrarbe,22,23,-1
2009,Huesca,22006,Aísa,2,3,-1
2009,Huesca,22044,Bailo,0,1,-1
2009,Huesca,22045,Baldellou,1,0,1
2009,Huesca,22046,Ballobar,4,15,-11
2009,Huesca,22047,Banastás,3,2,1
2009,Huesca,22048,Barbastro,180,167,13
2009,Huesca,22049,Barbués,1,2,-1
2009,Huesca,22050,Barbuñales,0,1,-1
2009,Huesca,22052,Belver de Cinca,10,26,-16
2009,Huesca,22053,Benabarre,3,20,-17
2009,Huesca,22054,Benasque,22,6,16
2009,Huesca,22055,Berbegal,1,2,-1
2009,Huesca,22057,Bielsa,2,3,-1
2009,Huesca,22058,Bierge,1,2,-1
2009,Huesca,22059,Biescas,13,19,-6
2009,Huesca,22060,Binaced,9,13,-4
2009,Huesca,22061,Binéfar,91,79,12
2009,Huesca,22062,Bisaurri,1,6,-5
2009,Huesca,22063,Biscarrués,2,3,-1
2009,Huesca,22064,Blecua y Torres,3,2,1
2009,Huesca,22066,Boltaña,13,7,6
2009,Huesca,22067,Bonansa,0,1,-1
2009,Huesca,22068,Borau,1,0,1
2009,Huesca,22069,Broto,3,4,-1
2009,Huesca,22051,Bárcabo,1,0,1
2009,Huesca,22072,Caldearenas,0,2,-2
2009,Huesca,22074,Campo,0,3,-3
2009,Huesca,22075,Camporrells,0,1,-1
2009,Huesca,22076,Canal de Berdún,1,5,-4
2009,Huesca,22077,Candasnos,0,5,-5
2009,Huesca,22078,Canfranc,4,0,4
2009,Huesca,22079,Capdesaso,0,1,-1
2009,Huesca,22080,Capella,3,9,-6
2009,Huesca,22081,Casbas de Huesca,0,5,-5
2009,Huesca,22083,Castejón de Monegros,0,13,-13
2009,Huesca,22084,Castejón de Sos,11,11,0
2009,Huesca,22082,Castejón del Puente,2,7,-5
2009,Huesca,22086,Castiello de Jaca,2,1,1
2009,Huesca,22087,Castigaleu,1,1,0
2009,Huesca,22088,Castillazuelo,1,5,-4
2009,Huesca,22089,Castillonroy,1,6,-5
2009,Huesca,22094,Chalamera,0,5,-5
2009,Huesca,22096,Chimillas,2,19,-17
2009,Huesca,22095,Chía,0,2,-2
2009,Huesca,22090,Colungo,0,3,-3
2009,Huesca,22099,Esplús,3,9,-6
2009,Huesca,22102,Estada,1,4,-3
2009,Huesca,22103,Estadilla,5,18,-13
2009,Huesca,22105,Estopiñán del Castillo,1,4,-3
2009,Huesca,22106,Fago,1,1,0
2009,Huesca,22107,Fanlo,1,0,1
2009,Huesca,22109,Fiscal,5,4,1
2009,Huesca,22110,Fonz,7,12,-5
2009,Huesca,22111,Foradada del Toscar,1,4,-3
2009,Huesca,22112,Fraga,158,120,38
2009,Huesca,22113,Fueva (La),5,5,0
2009,Huesca,22114,Gistaín,0,5,-5
2009,Huesca,22115,Grado (El),1,2,-1
2009,Huesca,22117,Graus,24,54,-30
2009,Huesca,22116,Grañén,19,34,-15
2009,Huesca,22119,Gurrea de Gállego,13,32,-19
2009,Huesca,22908,Hoz y Costeán,0,3,-3
2009,Huesca,22124,Huerto,2,3,-1
2009,Huesca,22125,Huesca,594,505,89
2009,Huesca,22126,Ibieca,1,2,-1
2009,Huesca,22127,Igriés,4,9,-5
2009,Huesca,22128,Ilche,0,6,-6
2009,Huesca,22129,Isábena,2,3,-1
2009,Huesca,22130,Jaca,135,136,-1
2009,Huesca,22131,Jasa,1,1,0
2009,Huesca,22133,Labuerda,2,2,0
2009,Huesca,22135,Laluenga,1,6,-5
2009,Huesca,22136,Lalueza,4,14,-10
2009,Huesca,22137,Lanaja,7,25,-18
2009,Huesca,22139,Laperdiguera,0,1,-1
2009,Huesca,22141,Lascellas-Ponzano,2,1,1
2009,Huesca,22142,Lascuarre,2,1,1
2009,Huesca,22143,Laspaúles,0,2,-2
2009,Huesca,22144,Laspuña,0,5,-5
2009,Huesca,22149,Loarre,1,4,-3
2009,Huesca,22150,Loporzano,1,3,-2
2009,Huesca,22151,Loscorrales,2,2,0
2009,Huesca,22905,Lupiñén-Ortilla,4,3,1
2009,Huesca,22155,Monesma y Cajigar,0,2,-2
2009,Huesca,22156,Monflorite-Lascasas,6,0,6
2009,Huesca,22157,Montanuy,0,5,-5
2009,Huesca,22158,Monzón,207,170,37
2009,Huesca,22160,Naval,3,3,0
2009,Huesca,22162,Novales,0,2,-2
2009,Huesca,22163,Nueno,9,2,7
2009,Huesca,22164,Olvena,0,1,-1
2009,Huesca,22165,Ontiñena,1,11,-10
2009,Huesca,22167,Osso de Cinca,5,9,-4
2009,Huesca,22170,Panticosa,2,3,-1
2009,Huesca,22174,Peralta de Alcofea,2,10,-8
2009,Huesca,22175,Peralta de Calasanz,0,7,-7
2009,Huesca,22176,Peraltilla,0,3,-3
2009,Huesca,22177,Perarrúa,0,1,-1
2009,Huesca,22178,Pertusa,0,1,-1
2009,Huesca,22172,Peñalba,1,1,0
2009,Huesca,22173,Peñas de Riglos (Las),0,3,-3
2009,Huesca,22181,Piracés,0,2,-2
2009,Huesca,22182,Plan,2,4,-2
2009,Huesca,22184,Poleñino,2,4,-2
2009,Huesca,22186,Pozán de Vero,1,3,-2
2009,Huesca,22187,Puebla de Castro (La),4,5,-1
2009,Huesca,22188,Puente de Montañana,0,2,-2
2009,Huesca,22902,Puente la Reina de Jaca,0,2,-2
2009,Huesca,22190,Pueyo de Araguás (El),1,1,0
2009,Huesca,22193,Pueyo de Santa Cruz,4,5,-1
2009,Huesca,22189,Puértolas,5,3,2
2009,Huesca,22195,Quicena,2,3,-1
2009,Huesca,22197,Robres,6,9,-3
2009,Huesca,22199,Sabiñánigo,100,101,-1
2009,Huesca,22200,Sahún,2,2,0
2009,Huesca,22201,Salas Altas,0,2,-2
2009,Huesca,22202,Salas Bajas,0,4,-4
2009,Huesca,22203,Salillas,0,1,-1
2009,Huesca,22204,Sallent de Gállego,20,7,13
2009,Huesca,22205,San Esteban de Litera,3,15,-12
2009,Huesca,22207,San Juan de Plan,1,1,0
2009,Huesca,22903,San Miguel del Cinca,3,10,-7
2009,Huesca,22206,Sangarrén,0,3,-3
2009,Huesca,22208,Santa Cilia,0,2,-2
2009,Huesca,22906,Santa María de Dulcis,0,1,-1
2009,Huesca,22212,Santaliestra y San Quílez,0,3,-3
2009,Huesca,22213,Sariñena,40,44,-4
2009,Huesca,22214,Secastilla,1,0,1
2009,Huesca,22215,Seira,0,2,-2
2009,Huesca,22217,Sena,6,5,1
2009,Huesca,22220,Sesa,0,3,-3
2009,Huesca,22221,Sesué,1,2,-1
2009,Huesca,22222,Siétamo,9,3,6
2009,Huesca,22223,Sopeira,1,2,-1
2009,Huesca,22904,Sotonera (La),3,18,-15
2009,Huesca,22225,Tamarite de Litera,24,61,-37
2009,Huesca,22226,Tardienta,6,17,-11
2009,Huesca,22227,Tella-Sin,1,2,-1
2009,Huesca,22228,Tierz,25,1,24
2009,Huesca,22229,Tolva,2,3,-1
2009,Huesca,22230,Torla-Ordesa,5,4,1
2009,Huesca,22232,Torralba de Aragón,1,1,0
2009,Huesca,22233,Torre la Ribera,0,1,-1
2009,Huesca,22234,Torrente de Cinca,0,4,-4
2009,Huesca,22235,Torres de Alcanadre,0,2,-2
2009,Huesca,22236,Torres de Barbués,0,4,-4
2009,Huesca,22239,Tramaced,0,0,0
2009,Huesca,22901,Valle de Hecho,6,10,-4
2009,Huesca,22244,Valle de Lierp,0,0,0
2009,Huesca,22245,Velilla de Cinca,1,8,-7
2009,Huesca,22909,Vencillón,4,10,-6
2009,Huesca,22248,Vicién,0,3,-3
2009,Huesca,22249,Villanova,2,2,0
2009,Huesca,22251,Villanueva de Sigena,1,6,-5
2009,Huesca,22250,Villanúa,6,2,4
2009,Huesca,22252,Yebra de Basa,0,1,-1
2009,Huesca,22253,Yésero,0,1,-1
2009,Huesca,22254,Zaidín,15,20,-5
2009,Teruel,44001,Ababuj,0,3,-3
2009,Teruel,44002,Abejuela,0,3,-3
2009,Teruel,44004,Aguaviva,2,6,-4
2009,Teruel,44006,Alacón,1,6,-5
2009,Teruel,44007,Alba,1,6,-5
2009,Teruel,44008,Albalate del Arzobispo,13,30,-17
2009,Teruel,44009,Albarracín,9,22,-13
2009,Teruel,44010,Albentosa,3,1,2
2009,Teruel,44011,Alcaine,0,3,-3
2009,Teruel,44012,Alcalá de la Selva,3,7,-4
2009,Teruel,44013,Alcañiz,190,171,19
2009,Teruel,44014,Alcorisa,38,43,-5
2009,Teruel,44016,Alfambra,2,13,-11
2009,Teruel,44017,Aliaga,1,9,-8
2009,Teruel,44022,Alloza,4,4,0
2009,Teruel,44024,Anadón,0,1,-1
2009,Teruel,44025,Andorra,75,63,12
2009,Teruel,44026,Arcos de las Salinas,1,4,-3
2009,Teruel,44027,Arens de Lledó,0,3,-3
2009,Teruel,44028,Argente,0,2,-2
2009,Teruel,44029,Ariño,2,6,-4
2009,Teruel,44031,Azaila,0,10,-10
2009,Teruel,44035,Barrachina,0,2,-2
2009,Teruel,44034,Bañón,2,1,1
2009,Teruel,44037,Beceite,6,7,-1
2009,Teruel,44039,Bello,1,7,-6
2009,Teruel,44038,Belmonte de San José,0,2,-2
2009,Teruel,44040,Berge,1,6,-5
2009,Teruel,44041,Bezas,0,2,-2
2009,Teruel,44042,Blancas,1,0,1
2009,Teruel,44044,Bordón,1,1,0
2009,Teruel,44045,Bronchales,2,4,-2
2009,Teruel,44046,Bueña,0,4,-4
2009,Teruel,44047,Burbáguena,0,24,-24
2009,Teruel,44033,Báguena,1,7,-6
2009,Teruel,44049,Calaceite,11,13,-2
2009,Teruel,44050,Calamocha,44,48,-4
2009,Teruel,44051,Calanda,32,38,-6
2009,Teruel,44054,Camarena de la Sierra,2,3,-1
2009,Teruel,44055,Camarillas,3,0,3
2009,Teruel,44053,Camañas,0,2,-2
2009,Teruel,44056,Caminreal,4,8,-4
2009,Teruel,44059,Cantavieja,9,5,4
2009,Teruel,44064,Cascante del Río,1,2,-1
2009,Teruel,44065,Castejón de Tornos,1,1,0
2009,Teruel,44066,Castel de Cabra,1,2,-1
2009,Teruel,44070,Castellar (El),0,3,-3
2009,Teruel,44071,Castellote,4,11,-7
2009,Teruel,44067,Castelnou,1,2,-1
2009,Teruel,44068,Castelserás,8,15,-7
2009,Teruel,44060,Cañada de Benatanduz,0,2,-2
2009,Teruel,44061,Cañada de Verich (La),0,1,-1
2009,Teruel,44063,Cañizar del Olivar,1,0,1
2009,Teruel,44074,Cedrillas,3,10,-7
2009,Teruel,44075,Celadas,1,3,-2
2009,Teruel,44076,Cella,19,42,-23
2009,Teruel,44077,Cerollera (La),0,2,-2
2009,Teruel,44080,Codoñera (La),3,3,0
2009,Teruel,44084,Cortes de Aragón,0,1,-1
2009,Teruel,44086,Cretas,5,13,-8
2009,Teruel,44088,Cuba (La),0,4,-4
2009,Teruel,44089,Cubla,1,1,0
2009,Teruel,44090,Cucalón,0,3,-3
2009,Teruel,44092,Cuervo (El),1,1,0
2009,Teruel,44093,Cuevas de Almudén,2,1,1
2009,Teruel,44094,Cuevas Labradas,0,2,-2
2009,Teruel,44096,Ejulve,0,5,-5
2009,Teruel,44097,Escorihuela,1,5,-4
2009,Teruel,44099,Escucha,5,5,0
2009,Teruel,44100,Estercuel,3,5,-2
2009,Teruel,44101,Ferreruela de Huerva,0,2,-2
2009,Teruel,44103,Formiche Alto,0,0,0
2009,Teruel,44106,Fortanete,4,5,-1
2009,Teruel,44107,Foz-Calanda,3,6,-3
2009,Teruel,44108,Fresneda (La),3,5,-2
2009,Teruel,44109,Frías de Albarracín,0,4,-4
2009,Teruel,44111,Fuentes Calientes,1,3,-2
2009,Teruel,44112,Fuentes Claras,6,8,-2
2009,Teruel,44113,Fuentes de Rubielos,1,1,0
2009,Teruel,44114,Fuentespalda,0,1,-1
2009,Teruel,44105,Fórnoles,0,2,-2
2009,Teruel,44115,Galve,2,0,2
2009,Teruel,44116,Gargallo,1,3,-2
2009,Teruel,44117,Gea de Albarracín,1,4,-3
2009,Teruel,44118,Ginebrosa (La),3,2,1
2009,Teruel,44119,Griegos,0,4,-4
2009,Teruel,44120,Guadalaviar,0,6,-6
2009,Teruel,44121,Gúdar,1,0,1
2009,Teruel,44123,Hinojosa de Jarque,0,2,-2
2009,Teruel,44124,Hoz de la Vieja (La),1,1,0
2009,Teruel,44125,Huesa del Común,0,1,-1
2009,Teruel,44122,Híjar,15,28,-13
2009,Teruel,44126,Iglesuela del Cid (La),6,1,5
2009,Teruel,44127,Jabaloyas,0,1,-1
2009,Teruel,44128,Jarque de la Val,1,1,0
2009,Teruel,44129,Jatiel,1,1,0
2009,Teruel,44132,Lagueruela,0,1,-1
2009,Teruel,44133,Lanzuela,0,2,-2
2009,Teruel,44135,Libros,0,1,-1
2009,Teruel,44136,Lidón,0,2,-2
2009,Teruel,44137,Linares de Mora,2,2,0
2009,Teruel,44141,Lledó,0,5,-5
2009,Teruel,44138,Loscos,0,2,-2
2009,Teruel,44143,Manzanera,6,5,1
2009,Teruel,44144,Martín del Río,4,7,-3
2009,Teruel,44145,Mas de las Matas,8,22,-14
2009,Teruel,44146,Mata de los Olmos (La),3,4,-1
2009,Teruel,44147,Mazaleón,2,6,-4
2009,Teruel,44148,Mezquita de Jarque,1,3,-2
2009,Teruel,44149,Mirambel,0,3,-3
2009,Teruel,44150,Miravete de la Sierra,0,2,-2
2009,Teruel,44151,Molinos,1,10,-9
2009,Teruel,44152,Monforte de Moyuela,0,1,-1
2009,Teruel,44153,Monreal del Campo,39,37,2
2009,Teruel,44154,Monroyo,2,6,-4
2009,Teruel,44155,Montalbán,8,16,-8
2009,Teruel,44156,Monteagudo del Castillo,1,2,-1
2009,Teruel,44157,Monterde de Albarracín,0,1,-1
2009,Teruel,44158,Mora de Rubielos,19,22,-3
2009,Teruel,44159,Moscardón,1,0,1
2009,Teruel,44160,Mosqueruela,3,10,-7
2009,Teruel,44161,Muniesa,5,5,0
2009,Teruel,44163,Noguera de Albarracín,0,3,-3
2009,Teruel,44165,Nogueruelas,3,4,-1
2009,Teruel,44168,Odón,1,4,-3
2009,Teruel,44169,Ojos Negros,5,5,0
2009,Teruel,44171,Olba,3,3,0
2009,Teruel,44172,Oliete,2,7,-5
2009,Teruel,44173,Olmos (Los),0,2,-2
2009,Teruel,44174,Orihuela del Tremedal,3,3,0
2009,Teruel,44175,Orrios,0,3,-3
2009,Teruel,44176,Palomar de Arroyos,0,3,-3
2009,Teruel,44177,Pancrudo,0,4,-4
2009,Teruel,44178,Parras de Castellote (Las),0,4,-4
2009,Teruel,44180,Peracense,0,3,-3
2009,Teruel,44181,Peralejos,0,1,-1
2009,Teruel,44182,Perales del Alfambra,1,6,-5
2009,Teruel,44179,Peñarroya de Tastavins,4,8,-4
2009,Teruel,44183,Pitarque,0,1,-1
2009,Teruel,44185,Pobo (El),0,2,-2
2009,Teruel,44187,Portellada (La),2,7,-5
2009,Teruel,44189,Pozondón,0,1,-1
2009,Teruel,44190,Pozuel del Campo,0,2,-2
2009,Teruel,44191,Puebla de Híjar (La),8,12,-4
2009,Teruel,44192,Puebla de Valverde (La),4,3,1
2009,Teruel,44193,Puertomingalvo,0,3,-3
2009,Teruel,44195,Rillo,1,1,0
2009,Teruel,44196,Riodeva,1,4,-3
2009,Teruel,44198,Royuela,3,4,-1
2009,Teruel,44201,Rubielos de Mora,5,13,-8
2009,Teruel,44194,Ráfales,0,4,-4
2009,Teruel,44205,Samper de Calanda,6,14,-8
2009,Teruel,44206,San Agustín,0,2,-2
2009,Teruel,44207,San Martín del Río,1,7,-6
2009,Teruel,44209,Santa Eulalia,6,17,-11
2009,Teruel,44210,Sarrión,14,13,1
2009,Teruel,44211,Segura de los Baños,0,1,-1
2009,Teruel,44213,Singra,2,1,1
2009,Teruel,44215,Terriente,0,3,-3
2009,Teruel,44216,Teruel,387,310,77
2009,Teruel,44218,Tormón,0,2,-2
2009,Teruel,44219,Tornos,0,2,-2
2009,Teruel,44220,Torralba de los Sisones,0,5,-5
2009,Teruel,44223,Torre de Arcas,1,2,-1
2009,Teruel,44224,Torre de las Arcas,0,1,-1
2009,Teruel,44225,Torre del Compte,0,4,-4
2009,Teruel,44227,Torre los Negros,0,2,-2
2009,Teruel,44221,Torrecilla de Alcañiz,0,2,-2
2009,Teruel,44222,Torrecilla del Rebollar,0,1,-1
2009,Teruel,44226,Torrelacárcel,1,6,-5
2009,Teruel,44228,Torremocha de Jiloca,0,3,-3
2009,Teruel,44229,Torres de Albarracín,0,2,-2
2009,Teruel,44230,Torrevelilla,3,3,0
2009,Teruel,44231,Torrijas,1,2,-1
2009,Teruel,44232,Torrijo del Campo,4,9,-5
2009,Teruel,44234,Tramacastiel,0,6,-6
2009,Teruel,44236,Tronchón,1,1,0
2009,Teruel,44237,Urrea de Gaén,2,8,-6
2009,Teruel,44238,Utrillas,33,34,-1
2009,Teruel,44240,Valbona,0,2,-2
2009,Teruel,44241,Valdealgorfa,2,13,-11
2009,Teruel,44244,Valdelinares,0,3,-3
2009,Teruel,44245,Valdeltormo,2,9,-7
2009,Teruel,44246,Valderrobres,24,28,-4
2009,Teruel,44247,Valjunquera,3,7,-4
2009,Teruel,44249,Vallecillo (El),0,1,-1
2009,Teruel,44251,Villafranca del Campo,3,3,0
2009,Teruel,44252,Villahermosa del Campo,0,1,-1
2009,Teruel,44256,Villanueva del Rebollar de la Sierra,2,1,1
2009,Teruel,44257,Villar del Cobo,1,4,-3
2009,Teruel,44260,Villarluengo,0,3,-3
2009,Teruel,44261,Villarquemado,3,23,-20
2009,Teruel,44262,Villarroya de los Pinares,0,3,-3
2009,Teruel,44263,Villastar,11,9,2
2009,Teruel,44264,Villel,5,5,0
2009,Teruel,44265,Vinaceite,0,1,-1
2009,Teruel,44266,Visiedo,0,2,-2
2009,Zaragoza,50001,Abanto,0,1,-1
2009,Zaragoza,50002,Acered,0,5,-5
2009,Zaragoza,50004,Aguarón,2,25,-23
2009,Zaragoza,50005,Aguilón,0,3,-3
2009,Zaragoza,50003,Agón,1,2,-1
2009,Zaragoza,50006,Ainzón,14,13,1
2009,Zaragoza,50008,Alagón,77,82,-5
2009,Zaragoza,50009,Alarba,0,2,-2
2009,Zaragoza,50010,Alberite de San Juan,0,1,-1
2009,Zaragoza,50011,Albeta,1,0,1
2009,Zaragoza,50012,Alborge,1,0,1
2009,Zaragoza,50013,Alcalá de Ebro,2,4,-2
2009,Zaragoza,50014,Alcalá de Moncayo,1,3,-2
2009,Zaragoza,50017,Alfajarín,30,15,15
2009,Zaragoza,50018,Alfamén,16,11,5
2009,Zaragoza,50019,Alforque,0,2,-2
2009,Zaragoza,50020,Alhama de Aragón,6,14,-8
2009,Zaragoza,50022,Almolda (La),3,11,-8
2009,Zaragoza,50023,Almonacid de la Cuba,1,4,-3
2009,Zaragoza,50024,Almonacid de la Sierra,7,15,-8
2009,Zaragoza,50025,Almunia de Doña Godina (La),90,80,10
2009,Zaragoza,50026,Alpartir,2,7,-5
2009,Zaragoza,50027,Ambel,1,5,-4
2009,Zaragoza,50029,Aniñón,4,15,-11
2009,Zaragoza,50031,Aranda de Moncayo,0,3,-3
2009,Zaragoza,50033,Ardisa,0,1,-1
2009,Zaragoza,50034,Ariza,13,24,-11
2009,Zaragoza,50035,Artieda,1,1,0
2009,Zaragoza,50032,Arándiga,2,6,-4
2009,Zaragoza,50036,Asín,0,6,-6
2009,Zaragoza,50038,Ateca,18,26,-8
2009,Zaragoza,50039,Azuara,2,12,-10
2009,Zaragoza,50030,Añón de Moncayo,1,9,-8
2009,Zaragoza,50040,Badules,0,1,-1
2009,Zaragoza,50044,Bardallur,2,5,-3
2009,Zaragoza,50045,Belchite,5,28,-23
2009,Zaragoza,50046,Belmonte de Gracián,1,5,-4
2009,Zaragoza,50901,Biel,0,3,-3
2009,Zaragoza,50050,Bijuesca,0,6,-6
2009,Zaragoza,50051,Biota,4,16,-12
2009,Zaragoza,50052,Bisimbre,0,1,-1
2009,Zaragoza,50053,Boquiñeni,5,13,-8
2009,Zaragoza,50054,Bordalba,0,2,-2
2009,Zaragoza,50055,Borja,53,67,-14
2009,Zaragoza,50056,Botorrita,3,5,-2
2009,Zaragoza,50057,Brea de Aragón,14,24,-10
2009,Zaragoza,50058,Bubierca,0,2,-2
2009,Zaragoza,50059,Bujaraloz,15,7,8
2009,Zaragoza,50060,Bulbuente,1,8,-7
2009,Zaragoza,50061,Bureta,1,10,-9
2009,Zaragoza,50062,Burgo de Ebro (El),24,13,11
2009,Zaragoza,50063,Buste (El),0,1,-1
2009,Zaragoza,50043,Bárboles,3,3,0
2009,Zaragoza,50064,Cabañas de Ebro,5,8,-3
2009,Zaragoza,50066,Cadrete,42,14,28
2009,Zaragoza,50067,Calatayud,203,262,-59
2009,Zaragoza,50068,Calatorao,31,32,-1
2009,Zaragoza,50070,Calmarza,0,2,-2
2009,Zaragoza,50071,Campillo de Aragón,0,3,-3
2009,Zaragoza,50072,Carenas,0,6,-6
2009,Zaragoza,50073,Cariñena,30,43,-13
2009,Zaragoza,50074,Caspe,96,113,-17
2009,Zaragoza,50075,Castejón de Alarba,0,2,-2
2009,Zaragoza,50076,Castejón de las Armas,0,2,-2
2009,Zaragoza,50077,Castejón de Valdejasa,0,3,-3
2009,Zaragoza,50078,Castiliscar,1,4,-3
2009,Zaragoza,50079,Cervera de la Cañada,2,7,-5
2009,Zaragoza,50080,Cerveruela,1,0,1
2009,Zaragoza,50081,Cetina,1,16,-15
2009,Zaragoza,50092,Chiprana,2,10,-8
2009,Zaragoza,50093,Chodes,1,2,-1
2009,Zaragoza,50082,Cimballa,0,0,0
2009,Zaragoza,50083,Cinco Olivas,4,4,0
2009,Zaragoza,50084,Clarés de Ribota,0,3,-3
2009,Zaragoza,50085,Codo,0,3,-3
2009,Zaragoza,50086,Codos,0,3,-3
2009,Zaragoza,50087,Contamina,1,2,-1
2009,Zaragoza,50088,Cosuenda,3,13,-10
2009,Zaragoza,50089,Cuarte de Huerva,178,23,155
2009,Zaragoza,50090,Cubel,1,4,-3
2009,Zaragoza,50091,Cuerlas (Las),0,1,-1
2009,Zaragoza,50094,Daroca,16,50,-34
2009,Zaragoza,50095,Ejea de los Caballeros,159,190,-31
2009,Zaragoza,50096,Embid de Ariza,1,2,-1
2009,Zaragoza,50098,Encinacorba,0,2,-2
2009,Zaragoza,50100,Erla,1,3,-2
2009,Zaragoza,50101,Escatrón,7,22,-15
2009,Zaragoza,50102,Fabara,6,14,-8
2009,Zaragoza,50104,Farlete,3,5,-2
2009,Zaragoza,50106,Fayos (Los),1,4,-3
2009,Zaragoza,50105,Fayón,2,6,-4
2009,Zaragoza,50107,Figueruelas,10,22,-12
2009,Zaragoza,50109,Frago (El),0,1,-1
2009,Zaragoza,50110,Frasno (El),2,8,-6
2009,Zaragoza,50111,Fréscano,0,4,-4
2009,Zaragoza,50113,Fuendejalón,7,15,-8
2009,Zaragoza,50114,Fuendetodos,1,2,-1
2009,Zaragoza,50115,Fuentes de Ebro,53,46,7
2009,Zaragoza,50116,Fuentes de Jiloca,2,9,-7
2009,Zaragoza,50117,Gallocanta,0,1,-1
2009,Zaragoza,50118,Gallur,20,30,-10
2009,Zaragoza,50119,Gelsa,6,17,-11
2009,Zaragoza,50120,Godojos,0,2,-2
2009,Zaragoza,50121,Gotor,0,1,-1
2009,Zaragoza,50123,Grisén,9,8,1
2009,Zaragoza,50124,Herrera de los Navarros,6,7,-1
2009,Zaragoza,50125,Ibdes,3,9,-6
2009,Zaragoza,50126,Illueca,25,24,1
2009,Zaragoza,50128,Isuerre,0,1,-1
2009,Zaragoza,50129,Jaraba,1,10,-9
2009,Zaragoza,50130,Jarque de Moncayo,2,9,-7
2009,Zaragoza,50131,Jaulín,0,9,-9
2009,Zaragoza,50132,Joyosa (La),18,9,9
2009,Zaragoza,50133,Lagata,0,3,-3
2009,Zaragoza,50134,Langa del Castillo,0,3,-3
2009,Zaragoza,50135,Layana,0,4,-4
2009,Zaragoza,50137,Leciñena,5,11,-6
2009,Zaragoza,50139,Letux,0,6,-6
2009,Zaragoza,50140,Litago,0,4,-4
2009,Zaragoza,50141,Lituénigo,1,0,1
2009,Zaragoza,50143,Longares,7,11,-4
2009,Zaragoza,50146,Lucena de Jalón,0,4,-4
2009,Zaragoza,50147,Luceni,12,15,-3
2009,Zaragoza,50148,Luesia,0,1,-1
2009,Zaragoza,50150,Lumpiaque,10,14,-4
2009,Zaragoza,50151,Luna,2,15,-13
2009,Zaragoza,50136,Lécera,5,9,-4
2009,Zaragoza,50152,Maella,1,10,-9
2009,Zaragoza,50153,Magallón,8,10,-2
2009,Zaragoza,50154,Mainar,1,1,0
2009,Zaragoza,50155,Malanquilla,0,1,-1
2009,Zaragoza,50156,Maleján,4,0,4
2009,Zaragoza,50160,Mallén,32,31,1
2009,Zaragoza,50159,Maluenda,10,11,-1
2009,Zaragoza,50157,Malón,2,8,-6
2009,Zaragoza,50161,Manchones,0,4,-4
2009,Zaragoza,50162,Mara,2,6,-4
2009,Zaragoza,50163,María de Huerva,107,17,90
2009,Zaragoza,50164,Mediana de Aragón,2,2,0
2009,Zaragoza,50165,Mequinenza,23,29,-6
2009,Zaragoza,50166,Mesones de Isuela,0,4,-4
2009,Zaragoza,50167,Mezalocha,1,4,-3
2009,Zaragoza,50168,Mianos,2,2,0
2009,Zaragoza,50169,Miedes de Aragón,2,8,-6
2009,Zaragoza,50170,Monegrillo,4,7,-3
2009,Zaragoza,50171,Moneva,0,1,-1
2009,Zaragoza,50172,Monreal de Ariza,0,2,-2
2009,Zaragoza,50173,Monterde,0,2,-2
2009,Zaragoza,50174,Montón,0,3,-3
2009,Zaragoza,50175,Morata de Jalón,5,18,-13
2009,Zaragoza,50176,Morata de Jiloca,0,3,-3
2009,Zaragoza,50178,Moros,0,4,-4
2009,Zaragoza,50177,Morés,2,9,-7
2009,Zaragoza,50179,Moyuela,0,5,-5
2009,Zaragoza,50180,Mozota,0,4,-4
2009,Zaragoza,50181,Muel,21,15,6
2009,Zaragoza,50182,Muela (La),59,21,38
2009,Zaragoza,50183,Munébrega,3,4,-1
2009,Zaragoza,50184,Murero,0,2,-2
2009,Zaragoza,50185,Murillo de Gállego,1,1,0
2009,Zaragoza,50186,Navardún,0,0,0
2009,Zaragoza,50187,Nigüella,0,3,-3
2009,Zaragoza,50189,Nonaspe,8,12,-4
2009,Zaragoza,50190,Novallas,6,9,-3
2009,Zaragoza,50191,Novillas,2,5,-3
2009,Zaragoza,50193,Nuez de Ebro,10,4,6
2009,Zaragoza,50192,Nuévalos,7,4,3
2009,Zaragoza,50194,Olvés,0,4,-4
2009,Zaragoza,50195,Orcajo,0,1,-1
2009,Zaragoza,50196,Orera,0,4,-4
2009,Zaragoza,50197,Orés,1,5,-4
2009,Zaragoza,50199,Osera de Ebro,3,15,-12
2009,Zaragoza,50200,Paniza,3,8,-5
2009,Zaragoza,50201,Paracuellos de Jiloca,5,6,-1
2009,Zaragoza,50202,Paracuellos de la Ribera,0,4,-4
2009,Zaragoza,50203,Pastriz,16,16,0
2009,Zaragoza,50204,Pedrola,39,28,11
2009,Zaragoza,50205,Pedrosas (Las),1,0,1
2009,Zaragoza,50206,Perdiguera,5,5,0
2009,Zaragoza,50207,Piedratajada,0,1,-1
2009,Zaragoza,50208,Pina de Ebro,35,19,16
2009,Zaragoza,50209,Pinseque,51,60,-9
2009,Zaragoza,50211,Plasencia de Jalón,3,5,-2
2009,Zaragoza,50212,Pleitas,0,1,-1
2009,Zaragoza,50213,Plenas,0,2,-2
2009,Zaragoza,50216,Pozuelo de Aragón,4,7,-3
2009,Zaragoza,50217,Pradilla de Ebro,1,9,-8
2009,Zaragoza,50218,Puebla de Albortón,4,3,1
2009,Zaragoza,50219,Puebla de Alfindén (La),96,28,68
2009,Zaragoza,50220,Puendeluna,0,2,-2
2009,Zaragoza,50222,Quinto,19,19,0
2009,Zaragoza,50223,Remolinos,9,21,-12
2009,Zaragoza,50224,Retascón,0,4,-4
2009,Zaragoza,50225,Ricla,26,28,-2
2009,Zaragoza,50227,Romanos,1,2,-1
2009,Zaragoza,50228,Rueda de Jalón,1,1,0
2009,Zaragoza,50229,Ruesca,0,2,-2
2009,Zaragoza,50231,Salillas de Jalón,1,4,-3
2009,Zaragoza,50232,Salvatierra de Esca,2,4,-2
2009,Zaragoza,50233,Samper del Salz,0,2,-2
2009,Zaragoza,50234,San Martín de la Virgen de Moncayo,2,4,-2
2009,Zaragoza,50235,San Mateo de Gállego,35,30,5
2009,Zaragoza,50236,Santa Cruz de Grío,1,0,1
2009,Zaragoza,50237,Santa Cruz de Moncayo,0,4,-4
2009,Zaragoza,50239,Santed,0,1,-1
2009,Zaragoza,50241,Saviñán,4,12,-8
2009,Zaragoza,50242,Sediles,1,0,1
2009,Zaragoza,50243,Sestrica,0,9,-9
2009,Zaragoza,50244,Sierra de Luna,1,3,-2
2009,Zaragoza,50245,Sigüés,0,1,-1
2009,Zaragoza,50246,Sisamón,0,1,-1
2009,Zaragoza,50247,Sobradiel,12,13,-1
2009,Zaragoza,50248,Sos del Rey Católico,2,16,-14
2009,Zaragoza,50230,Sádaba,10,28,-18
2009,Zaragoza,50240,Sástago,1,13,-12
2009,Zaragoza,50249,Tabuenca,2,4,-2
2009,Zaragoza,50250,Talamantes,0,1,-1
2009,Zaragoza,50251,Tarazona,105,141,-36
2009,Zaragoza,50252,Tauste,47,86,-39
2009,Zaragoza,50253,Terrer,3,9,-6
2009,Zaragoza,50254,Tierga,0,5,-5
2009,Zaragoza,50255,Tobed,1,9,-8
2009,Zaragoza,50256,Torralba de los Frailes,0,2,-2
2009,Zaragoza,50261,Torrellas,1,3,-2
2009,Zaragoza,50262,Torres de Berrellén,13,20,-7
2009,Zaragoza,50263,Torrijo de la Cañada,0,3,-3
2009,Zaragoza,50264,Tosos,2,3,-1
2009,Zaragoza,50265,Trasmoz,1,1,0
2009,Zaragoza,50266,Trasobares,0,1,-1
2009,Zaragoza,50267,Uncastillo,2,17,-15
2009,Zaragoza,50268,Undués de Lerda,1,1,0
2009,Zaragoza,50269,Urrea de Jalón,2,11,-9
2009,Zaragoza,50270,Urriés,0,1,-1
2009,Zaragoza,50271,Used,0,4,-4
2009,Zaragoza,50272,Utebo,291,64,227
2009,Zaragoza,50274,Val de San Martín,0,2,-2
2009,Zaragoza,50273,Valdehorna,0,1,-1
2009,Zaragoza,50275,Valmadrid,1,2,-1
2009,Zaragoza,50276,Valpalmas,0,4,-4
2009,Zaragoza,50277,Valtorres,0,2,-2
2009,Zaragoza,50278,Velilla de Ebro,4,2,2
2009,Zaragoza,50279,Velilla de Jiloca,0,2,-2
2009,Zaragoza,50280,Vera de Moncayo,1,10,-9
2009,Zaragoza,50281,Vierlas,0,1,-1
2009,Zaragoza,50284,Villafeliche,1,4,-3
2009,Zaragoza,50285,Villafranca de Ebro,4,14,-10
2009,Zaragoza,50286,Villalba de Perejil,0,2,-2
2009,Zaragoza,50287,Villalengua,2,2,0
2009,Zaragoza,50903,Villamayor de Gállego,17,27,-10
2009,Zaragoza,50288,Villanueva de Gállego,43,25,18
2009,Zaragoza,50290,Villanueva de Huerva,5,7,-2
2009,Zaragoza,50291,Villar de los Navarros,0,1,-1
2009,Zaragoza,50292,Villarreal de Huerva,0,2,-2
2009,Zaragoza,50293,Villarroya de la Sierra,1,6,-5
2009,Zaragoza,50294,Villarroya del Campo,0,3,-3
2009,Zaragoza,50295,Vistabella,0,1,-1
2009,Zaragoza,50296,Zaida (La),0,11,-11
2009,Zaragoza,50297,Zaragoza,6906,5854,1052
2009,Zaragoza,50298,Zuera,74,63,11
2009,Zaragoza,50099,Épila,63,45,18
2008,Huesca,22001,Abiego,2,6,-4
2008,Huesca,22002,Abizanda,0,1,-1
2008,Huesca,22003,Adahuesca,0,3,-3
2008,Huesca,22004,Agüero,0,4,-4
2008,Huesca,22007,Albalate de Cinca,11,13,-2
2008,Huesca,22008,Albalatillo,1,6,-5
2008,Huesca,22009,Albelda,4,17,-13
2008,Huesca,22011,Albero Alto,0,1,-1
2008,Huesca,22012,Albero Bajo,1,0,1
2008,Huesca,22013,Alberuela de Tubo,0,3,-3
2008,Huesca,22014,Alcalá de Gurrea,1,3,-2
2008,Huesca,22015,Alcalá del Obispo,3,6,-3
2008,Huesca,22016,Alcampell,6,15,-9
2008,Huesca,22017,Alcolea de Cinca,7,21,-14
2008,Huesca,22018,Alcubierre,4,11,-7
2008,Huesca,22019,Alerre,0,1,-1
2008,Huesca,22020,Alfántega,1,2,-1
2008,Huesca,22021,Almudévar,27,42,-15
2008,Huesca,22022,Almunia de San Juan,4,9,-5
2008,Huesca,22023,Almuniente,2,6,-4
2008,Huesca,22024,Alquézar,1,7,-6
2008,Huesca,22025,Altorricón,10,16,-6
2008,Huesca,22027,Angüés,1,14,-13
2008,Huesca,22028,Ansó,2,4,-2
2008,Huesca,22029,Antillón,0,2,-2
2008,Huesca,22032,Aragüés del Puerto,1,1,0
2008,Huesca,22036,Argavieso,2,1,1
2008,Huesca,22035,Arén,2,3,-1
2008,Huesca,22039,Ayerbe,9,20,-11
2008,Huesca,22040,Azanuy-Alins,0,4,-4
2008,Huesca,22041,Azara,1,3,-2
2008,Huesca,22042,Azlor,1,0,1
2008,Huesca,22907,Aínsa-Sobrarbe,24,25,-1
2008,Huesca,22006,Aísa,0,2,-2
2008,Huesca,22043,Baells,0,3,-3
2008,Huesca,22044,Bailo,1,2,-1
2008,Huesca,22045,Baldellou,0,4,-4
2008,Huesca,22046,Ballobar,3,14,-11
2008,Huesca,22047,Banastás,2,0,2
2008,Huesca,22048,Barbastro,181,147,34
2008,Huesca,22049,Barbués,0,4,-4
2008,Huesca,22050,Barbuñales,0,3,-3
2008,Huesca,22052,Belver de Cinca,8,13,-5
2008,Huesca,22053,Benabarre,10,29,-19
2008,Huesca,22054,Benasque,35,10,25
2008,Huesca,22246,Beranuy,0,3,-3
2008,Huesca,22055,Berbegal,3,6,-3
2008,Huesca,22057,Bielsa,5,5,0
2008,Huesca,22058,Bierge,2,2,0
2008,Huesca,22059,Biescas,16,19,-3
2008,Huesca,22060,Binaced,15,25,-10
2008,Huesca,22061,Binéfar,81,77,4
2008,Huesca,22062,Bisaurri,0,3,-3
2008,Huesca,22063,Biscarrués,0,2,-2
2008,Huesca,22064,Blecua y Torres,0,5,-5
2008,Huesca,22066,Boltaña,8,10,-2
2008,Huesca,22067,Bonansa,0,1,-1
2008,Huesca,22068,Borau,0,1,-1
2008,Huesca,22069,Broto,3,3,0
2008,Huesca,22072,Caldearenas,1,1,0
2008,Huesca,22074,Campo,2,3,-1
2008,Huesca,22075,Camporrells,0,4,-4
2008,Huesca,22076,Canal de Berdún,2,3,-1
2008,Huesca,22077,Candasnos,0,4,-4
2008,Huesca,22078,Canfranc,4,5,-1
2008,Huesca,22079,Capdesaso,1,3,-2
2008,Huesca,22080,Capella,3,5,-2
2008,Huesca,22081,Casbas de Huesca,0,3,-3
2008,Huesca,22083,Castejón de Monegros,5,6,-1
2008,Huesca,22084,Castejón de Sos,8,13,-5
2008,Huesca,22082,Castejón del Puente,2,4,-2
2008,Huesca,22085,Castelflorite,1,2,-1
2008,Huesca,22086,Castiello de Jaca,3,5,-2
2008,Huesca,22088,Castillazuelo,1,11,-10
2008,Huesca,22089,Castillonroy,2,5,-3
2008,Huesca,22094,Chalamera,0,1,-1
2008,Huesca,22096,Chimillas,3,9,-6
2008,Huesca,22095,Chía,1,2,-1
2008,Huesca,22090,Colungo,0,5,-5
2008,Huesca,22099,Esplús,1,11,-10
2008,Huesca,22102,Estada,2,0,2
2008,Huesca,22103,Estadilla,7,12,-5
2008,Huesca,22105,Estopiñán del Castillo,2,5,-3
2008,Huesca,22109,Fiscal,1,2,-1
2008,Huesca,22110,Fonz,5,17,-12
2008,Huesca,22111,Foradada del Toscar,0,3,-3
2008,Huesca,22112,Fraga,148,126,22
2008,Huesca,22113,Fueva (La),6,10,-4
2008,Huesca,22114,Gistaín,0,1,-1
2008,Huesca,22115,Grado (El),2,5,-3
2008,Huesca,22117,Graus,30,44,-14
2008,Huesca,22116,Grañén,15,36,-21
2008,Huesca,22119,Gurrea de Gállego,12,23,-11
2008,Huesca,22122,Hoz de Jaca,0,1,-1
2008,Huesca,22908,Hoz y Costeán,1,1,0
2008,Huesca,22124,Huerto,1,5,-4
2008,Huesca,22125,Huesca,641,518,123
2008,Huesca,22126,Ibieca,2,3,-1
2008,Huesca,22127,Igriés,14,22,-8
2008,Huesca,22128,Ilche,1,2,-1
2008,Huesca,22129,Isábena,1,3,-2
2008,Huesca,22130,Jaca,156,127,29
2008,Huesca,22131,Jasa,0,1,-1
2008,Huesca,22133,Labuerda,1,7,-6
2008,Huesca,22135,Laluenga,0,2,-2
2008,Huesca,22136,Lalueza,3,17,-14
2008,Huesca,22137,Lanaja,8,13,-5
2008,Huesca,22141,Lascellas-Ponzano,0,2,-2
2008,Huesca,22142,Lascuarre,0,4,-4
2008,Huesca,22143,Laspaúles,3,3,0
2008,Huesca,22144,Laspuña,1,7,-6
2008,Huesca,22149,Loarre,1,8,-7
2008,Huesca,22150,Loporzano,3,3,0
2008,Huesca,22151,Loscorrales,0,2,-2
2008,Huesca,22905,Lupiñén-Ortilla,3,6,-3
2008,Huesca,22156,Monflorite-Lascasas,4,2,2
2008,Huesca,22157,Montanuy,2,6,-4
2008,Huesca,22158,Monzón,184,159,25
2008,Huesca,22160,Naval,3,3,0
2008,Huesca,22162,Novales,0,5,-5
2008,Huesca,22163,Nueno,2,2,0
2008,Huesca,22164,Olvena,1,2,-1
2008,Huesca,22165,Ontiñena,2,10,-8
2008,Huesca,22167,Osso de Cinca,1,9,-8
2008,Huesca,22168,Palo,0,2,-2
2008,Huesca,22170,Panticosa,4,5,-1
2008,Huesca,22174,Peralta de Alcofea,5,8,-3
2008,Huesca,22175,Peralta de Calasanz,0,7,-7
2008,Huesca,22176,Peraltilla,1,2,-1
2008,Huesca,22178,Pertusa,0,2,-2
2008,Huesca,22172,Peñalba,0,7,-7
2008,Huesca,22173,Peñas de Riglos (Las),2,2,0
2008,Huesca,22181,Piracés,0,1,-1
2008,Huesca,22182,Plan,2,4,-2
2008,Huesca,22184,Poleñino,1,4,-3
2008,Huesca,22186,Pozán de Vero,0,4,-4
2008,Huesca,22187,Puebla de Castro (La),2,7,-5
2008,Huesca,22188,Puente de Montañana,0,2,-2
2008,Huesca,22902,Puente la Reina de Jaca,1,1,0
2008,Huesca,22190,Pueyo de Araguás (El),1,1,0
2008,Huesca,22193,Pueyo de Santa Cruz,5,7,-2
2008,Huesca,22189,Puértolas,2,2,0
2008,Huesca,22195,Quicena,4,4,0
2008,Huesca,22197,Robres,3,9,-6
2008,Huesca,22199,Sabiñánigo,98,95,3
2008,Huesca,22200,Sahún,1,4,-3
2008,Huesca,22201,Salas Altas,2,4,-2
2008,Huesca,22203,Salillas,0,2,-2
2008,Huesca,22204,Sallent de Gállego,20,6,14
2008,Huesca,22205,San Esteban de Litera,2,10,-8
2008,Huesca,22207,San Juan de Plan,2,1,1
2008,Huesca,22903,San Miguel del Cinca,2,11,-9
2008,Huesca,22206,Sangarrén,0,4,-4
2008,Huesca,22208,Santa Cilia,5,2,3
2008,Huesca,22209,Santa Cruz de la Serós,1,2,-1
2008,Huesca,22906,Santa María de Dulcis,0,4,-4
2008,Huesca,22213,Sariñena,34,36,-2
2008,Huesca,22214,Secastilla,0,2,-2
2008,Huesca,22215,Seira,1,2,-1
2008,Huesca,22217,Sena,2,5,-3
2008,Huesca,22218,Senés de Alcubierre,1,1,0
2008,Huesca,22220,Sesa,1,6,-5
2008,Huesca,22221,Sesué,2,3,-1
2008,Huesca,22222,Siétamo,8,2,6
2008,Huesca,22904,Sotonera (La),7,3,4
2008,Huesca,22225,Tamarite de Litera,34,72,-38
2008,Huesca,22226,Tardienta,10,20,-10
2008,Huesca,22227,Tella-Sin,0,3,-3
2008,Huesca,22228,Tierz,17,3,14
2008,Huesca,22229,Tolva,2,4,-2
2008,Huesca,22230,Torla-Ordesa,1,3,-2
2008,Huesca,22232,Torralba de Aragón,0,1,-1
2008,Huesca,22233,Torre la Ribera,1,0,1
2008,Huesca,22234,Torrente de Cinca,0,13,-13
2008,Huesca,22236,Torres de Barbués,1,6,-5
2008,Huesca,22239,Tramaced,0,3,-3
2008,Huesca,22242,Valfarta,0,1,-1
2008,Huesca,22901,Valle de Hecho,10,11,-1
2008,Huesca,22244,Valle de Lierp,0,1,-1
2008,Huesca,22245,Velilla de Cinca,3,5,-2
2008,Huesca,22909,Vencillón,5,6,-1
2008,Huesca,22247,Viacamp y Litera,0,1,-1
2008,Huesca,22248,Vicién,1,1,0
2008,Huesca,22249,Villanova,1,2,-1
2008,Huesca,22251,Villanueva de Sigena,0,8,-8
2008,Huesca,22250,Villanúa,3,0,3
2008,Huesca,22252,Yebra de Basa,1,1,0
2008,Huesca,22253,Yésero,0,1,-1
2008,Huesca,22254,Zaidín,19,15,4
2008,Teruel,44001,Ababuj,0,1,-1
2008,Teruel,44002,Abejuela,0,3,-3
2008,Teruel,44003,Aguatón,0,0,0
2008,Teruel,44004,Aguaviva,4,6,-2
2008,Teruel,44006,Alacón,2,3,-1
2008,Teruel,44007,Alba,0,4,-4
2008,Teruel,44008,Albalate del Arzobispo,16,26,-10
2008,Teruel,44009,Albarracín,12,15,-3
2008,Teruel,44010,Albentosa,6,1,5
2008,Teruel,44011,Alcaine,1,0,1
2008,Teruel,44012,Alcalá de la Selva,3,3,0
2008,Teruel,44013,Alcañiz,192,139,53
2008,Teruel,44014,Alcorisa,55,34,21
2008,Teruel,44016,Alfambra,4,20,-16
2008,Teruel,44017,Aliaga,2,11,-9
2008,Teruel,44021,Allepuz,0,2,-2
2008,Teruel,44022,Alloza,6,10,-4
2008,Teruel,44023,Allueva,1,0,1
2008,Teruel,44019,Alobras,0,1,-1
2008,Teruel,44020,Alpeñés,0,1,-1
2008,Teruel,44024,Anadón,0,1,-1
2008,Teruel,44025,Andorra,77,76,1
2008,Teruel,44026,Arcos de las Salinas,0,1,-1
2008,Teruel,44027,Arens de Lledó,0,3,-3
2008,Teruel,44028,Argente,0,4,-4
2008,Teruel,44029,Ariño,2,10,-8
2008,Teruel,44031,Azaila,0,1,-1
2008,Teruel,44035,Barrachina,0,1,-1
2008,Teruel,44034,Bañón,0,1,-1
2008,Teruel,44037,Beceite,8,10,-2
2008,Teruel,44039,Bello,2,8,-6
2008,Teruel,44038,Belmonte de San José,2,1,1
2008,Teruel,44040,Berge,1,6,-5
2008,Teruel,44041,Bezas,0,1,-1
2008,Teruel,44042,Blancas,1,2,-1
2008,Teruel,44043,Blesa,0,4,-4
2008,Teruel,44044,Bordón,0,1,-1
2008,Teruel,44045,Bronchales,2,6,-4
2008,Teruel,44046,Bueña,0,1,-1
2008,Teruel,44047,Burbáguena,0,14,-14
2008,Teruel,44033,Báguena,1,9,-8
2008,Teruel,44048,Cabra de Mora,0,3,-3
2008,Teruel,44049,Calaceite,2,16,-14
2008,Teruel,44050,Calamocha,49,48,1
2008,Teruel,44051,Calanda,30,44,-14
2008,Teruel,44052,Calomarde,0,1,-1
2008,Teruel,44054,Camarena de la Sierra,2,2,0
2008,Teruel,44055,Camarillas,1,0,1
2008,Teruel,44053,Camañas,1,2,-1
2008,Teruel,44056,Caminreal,5,12,-7
2008,Teruel,44059,Cantavieja,7,9,-2
2008,Teruel,44064,Cascante del Río,0,1,-1
2008,Teruel,44065,Castejón de Tornos,0,1,-1
2008,Teruel,44066,Castel de Cabra,1,1,0
2008,Teruel,44070,Castellar (El),0,1,-1
2008,Teruel,44071,Castellote,6,8,-2
2008,Teruel,44067,Castelnou,0,1,-1
2008,Teruel,44068,Castelserás,5,8,-3
2008,Teruel,44061,Cañada de Verich (La),0,1,-1
2008,Teruel,44063,Cañizar del Olivar,0,1,-1
2008,Teruel,44074,Cedrillas,4,15,-11
2008,Teruel,44075,Celadas,3,6,-3
2008,Teruel,44076,Cella,18,32,-14
2008,Teruel,44080,Codoñera (La),6,3,3
2008,Teruel,44082,Corbalán,0,3,-3
2008,Teruel,44084,Cortes de Aragón,0,2,-2
2008,Teruel,44085,Cosa,0,2,-2
2008,Teruel,44086,Cretas,7,9,-2
2008,Teruel,44088,Cuba (La),2,2,0
2008,Teruel,44089,Cubla,0,2,-2
2008,Teruel,44090,Cucalón,1,0,1
2008,Teruel,44092,Cuervo (El),0,1,-1
2008,Teruel,44093,Cuevas de Almudén,1,0,1
2008,Teruel,44094,Cuevas Labradas,1,4,-3
2008,Teruel,44096,Ejulve,3,5,-2
2008,Teruel,44099,Escucha,6,10,-4
2008,Teruel,44100,Estercuel,0,2,-2
2008,Teruel,44101,Ferreruela de Huerva,1,1,0
2008,Teruel,44103,Formiche Alto,1,4,-3
2008,Teruel,44106,Fortanete,3,0,3
2008,Teruel,44107,Foz-Calanda,1,5,-4
2008,Teruel,44108,Fresneda (La),4,8,-4
2008,Teruel,44109,Frías de Albarracín,1,2,-1
2008,Teruel,44111,Fuentes Calientes,1,1,0
2008,Teruel,44112,Fuentes Claras,3,7,-4
2008,Teruel,44113,Fuentes de Rubielos,1,1,0
2008,Teruel,44114,Fuentespalda,0,8,-8
2008,Teruel,44105,Fórnoles,0,2,-2
2008,Teruel,44115,Galve,4,0,4
2008,Teruel,44116,Gargallo,0,1,-1
2008,Teruel,44117,Gea de Albarracín,3,5,-2
2008,Teruel,44118,Ginebrosa (La),1,1,0
2008,Teruel,44119,Griegos,0,2,-2
2008,Teruel,44120,Guadalaviar,2,6,-4
2008,Teruel,44121,Gúdar,0,2,-2
2008,Teruel,44123,Hinojosa de Jarque,0,4,-4
2008,Teruel,44124,Hoz de la Vieja (La),0,1,-1
2008,Teruel,44125,Huesa del Común,0,1,-1
2008,Teruel,44122,Híjar,18,35,-17
2008,Teruel,44126,Iglesuela del Cid (La),5,7,-2
2008,Teruel,44128,Jarque de la Val,0,0,0
2008,Teruel,44129,Jatiel,1,2,-1
2008,Teruel,44130,Jorcas,0,1,-1
2008,Teruel,44131,Josa,0,1,-1
2008,Teruel,44132,Lagueruela,0,1,-1
2008,Teruel,44133,Lanzuela,0,1,-1
2008,Teruel,44135,Libros,0,2,-2
2008,Teruel,44136,Lidón,0,1,-1
2008,Teruel,44137,Linares de Mora,1,5,-4
2008,Teruel,44141,Lledó,1,1,0
2008,Teruel,44138,Loscos,1,7,-6
2008,Teruel,44142,Maicas,0,1,-1
2008,Teruel,44143,Manzanera,2,4,-2
2008,Teruel,44144,Martín del Río,2,6,-4
2008,Teruel,44145,Mas de las Matas,8,16,-8
2008,Teruel,44146,Mata de los Olmos (La),2,3,-1
2008,Teruel,44147,Mazaleón,8,9,-1
2008,Teruel,44148,Mezquita de Jarque,0,1,-1
2008,Teruel,44149,Mirambel,3,2,1
2008,Teruel,44150,Miravete de la Sierra,0,1,-1
2008,Teruel,44151,Molinos,0,4,-4
2008,Teruel,44152,Monforte de Moyuela,0,2,-2
2008,Teruel,44153,Monreal del Campo,26,39,-13
2008,Teruel,44154,Monroyo,6,8,-2
2008,Teruel,44155,Montalbán,13,18,-5
2008,Teruel,44156,Monteagudo del Castillo,1,2,-1
2008,Teruel,44158,Mora de Rubielos,23,15,8
2008,Teruel,44159,Moscardón,5,0,5
2008,Teruel,44160,Mosqueruela,1,9,-8
2008,Teruel,44161,Muniesa,6,12,-6
2008,Teruel,44163,Noguera de Albarracín,0,1,-1
2008,Teruel,44164,Nogueras,0,0,0
2008,Teruel,44165,Nogueruelas,0,3,-3
2008,Teruel,44167,Obón,0,1,-1
2008,Teruel,44168,Odón,1,5,-4
2008,Teruel,44169,Ojos Negros,2,9,-7
2008,Teruel,44171,Olba,4,1,3
2008,Teruel,44172,Oliete,1,12,-11
2008,Teruel,44173,Olmos (Los),0,1,-1
2008,Teruel,44174,Orihuela del Tremedal,3,9,-6
2008,Teruel,44175,Orrios,0,4,-4
2008,Teruel,44176,Palomar de Arroyos,1,2,-1
2008,Teruel,44177,Pancrudo,1,3,-2
2008,Teruel,44178,Parras de Castellote (Las),0,2,-2
2008,Teruel,44180,Peracense,0,2,-2
2008,Teruel,44181,Peralejos,0,2,-2
2008,Teruel,44182,Perales del Alfambra,0,6,-6
2008,Teruel,44179,Peñarroya de Tastavins,6,7,-1
2008,Teruel,44183,Pitarque,0,1,-1
2008,Teruel,44184,Plou,0,1,-1
2008,Teruel,44185,Pobo (El),1,5,-4
2008,Teruel,44187,Portellada (La),1,3,-2
2008,Teruel,44190,Pozuel del Campo,0,1,-1
2008,Teruel,44191,Puebla de Híjar (La),13,8,5
2008,Teruel,44192,Puebla de Valverde (La),5,4,1
2008,Teruel,44193,Puertomingalvo,3,1,2
2008,Teruel,44195,Rillo,0,2,-2
2008,Teruel,44196,Riodeva,0,3,-3
2008,Teruel,44198,Royuela,2,1,1
2008,Teruel,44200,Rubielos de la Cérida,0,3,-3
2008,Teruel,44201,Rubielos de Mora,4,7,-3
2008,Teruel,44194,Ráfales,2,4,-2
2008,Teruel,44204,Saldón,0,2,-2
2008,Teruel,44205,Samper de Calanda,3,13,-10
2008,Teruel,44206,San Agustín,0,3,-3
2008,Teruel,44207,San Martín del Río,0,5,-5
2008,Teruel,44208,Santa Cruz de Nogueras,0,1,-1
2008,Teruel,44209,Santa Eulalia,4,15,-11
2008,Teruel,44210,Sarrión,8,7,1
2008,Teruel,44212,Seno,1,0,1
2008,Teruel,44215,Terriente,3,3,0
2008,Teruel,44216,Teruel,362,327,35
2008,Teruel,44218,Tormón,0,1,-1
2008,Teruel,44219,Tornos,1,3,-2
2008,Teruel,44220,Torralba de los Sisones,1,0,1
2008,Teruel,44223,Torre de Arcas,1,0,1
2008,Teruel,44224,Torre de las Arcas,1,1,0
2008,Teruel,44225,Torre del Compte,0,3,-3
2008,Teruel,44227,Torre los Negros,0,1,-1
2008,Teruel,44221,Torrecilla de Alcañiz,0,1,-1
2008,Teruel,44222,Torrecilla del Rebollar,0,3,-3
2008,Teruel,44226,Torrelacárcel,1,4,-3
2008,Teruel,44228,Torremocha de Jiloca,1,2,-1
2008,Teruel,44229,Torres de Albarracín,0,2,-2
2008,Teruel,44230,Torrevelilla,0,3,-3
2008,Teruel,44231,Torrijas,0,1,-1
2008,Teruel,44232,Torrijo del Campo,3,16,-13
2008,Teruel,44234,Tramacastiel,0,1,-1
2008,Teruel,44235,Tramacastilla,0,4,-4
2008,Teruel,44236,Tronchón,2,0,2
2008,Teruel,44237,Urrea de Gaén,2,8,-6
2008,Teruel,44238,Utrillas,36,22,14
2008,Teruel,44239,Valacloche,0,1,-1
2008,Teruel,44240,Valbona,0,4,-4
2008,Teruel,44241,Valdealgorfa,3,7,-4
2008,Teruel,44244,Valdelinares,1,2,-1
2008,Teruel,44245,Valdeltormo,1,8,-7
2008,Teruel,44246,Valderrobres,15,34,-19
2008,Teruel,44247,Valjunquera,1,1,0
2008,Teruel,44249,Vallecillo (El),0,1,-1
2008,Teruel,44250,Veguillas de la Sierra,0,1,-1
2008,Teruel,44251,Villafranca del Campo,2,10,-8
2008,Teruel,44256,Villanueva del Rebollar de la Sierra,0,1,-1
2008,Teruel,44257,Villar del Cobo,0,3,-3
2008,Teruel,44258,Villar del Salz,0,2,-2
2008,Teruel,44260,Villarluengo,0,2,-2
2008,Teruel,44261,Villarquemado,8,12,-4
2008,Teruel,44262,Villarroya de los Pinares,2,2,0
2008,Teruel,44263,Villastar,4,7,-3
2008,Teruel,44264,Villel,5,4,1
2008,Teruel,44265,Vinaceite,0,2,-2
2008,Teruel,44266,Visiedo,0,6,-6
2008,Zaragoza,50001,Abanto,0,3,-3
2008,Zaragoza,50002,Acered,1,8,-7
2008,Zaragoza,50004,Aguarón,4,25,-21
2008,Zaragoza,50005,Aguilón,0,1,-1
2008,Zaragoza,50003,Agón,1,1,0
2008,Zaragoza,50006,Ainzón,8,23,-15
2008,Zaragoza,50007,Aladrén,0,1,-1
2008,Zaragoza,50008,Alagón,67,91,-24
2008,Zaragoza,50009,Alarba,0,3,-3
2008,Zaragoza,50010,Alberite de San Juan,0,3,-3
2008,Zaragoza,50011,Albeta,1,4,-3
2008,Zaragoza,50012,Alborge,0,1,-1
2008,Zaragoza,50013,Alcalá de Ebro,0,3,-3
2008,Zaragoza,50014,Alcalá de Moncayo,0,1,-1
2008,Zaragoza,50015,Alconchel de Ariza,0,2,-2
2008,Zaragoza,50017,Alfajarín,26,20,6
2008,Zaragoza,50018,Alfamén,22,11,11
2008,Zaragoza,50020,Alhama de Aragón,9,11,-2
2008,Zaragoza,50021,Almochuel,0,1,-1
2008,Zaragoza,50022,Almolda (La),2,7,-5
2008,Zaragoza,50023,Almonacid de la Cuba,0,3,-3
2008,Zaragoza,50024,Almonacid de la Sierra,4,8,-4
2008,Zaragoza,50025,Almunia de Doña Godina (La),91,79,12
2008,Zaragoza,50026,Alpartir,2,3,-1
2008,Zaragoza,50027,Ambel,1,2,-1
2008,Zaragoza,50028,Anento,1,0,1
2008,Zaragoza,50029,Aniñón,2,14,-12
2008,Zaragoza,50031,Aranda de Moncayo,1,4,-3
2008,Zaragoza,50033,Ardisa,0,1,-1
2008,Zaragoza,50034,Ariza,12,22,-10
2008,Zaragoza,50032,Arándiga,0,11,-11
2008,Zaragoza,50036,Asín,0,4,-4
2008,Zaragoza,50037,Atea,0,5,-5
2008,Zaragoza,50038,Ateca,9,24,-15
2008,Zaragoza,50039,Azuara,4,6,-2
2008,Zaragoza,50030,Añón de Moncayo,0,6,-6
2008,Zaragoza,50040,Badules,0,5,-5
2008,Zaragoza,50041,Bagüés,0,0,0
2008,Zaragoza,50042,Balconchán,0,1,-1
2008,Zaragoza,50044,Bardallur,2,2,0
2008,Zaragoza,50045,Belchite,10,26,-16
2008,Zaragoza,50046,Belmonte de Gracián,1,7,-6
2008,Zaragoza,50047,Berdejo,2,2,0
2008,Zaragoza,50048,Berrueco,0,1,-1
2008,Zaragoza,50901,Biel,0,1,-1
2008,Zaragoza,50050,Bijuesca,0,3,-3
2008,Zaragoza,50051,Biota,4,14,-10
2008,Zaragoza,50052,Bisimbre,1,0,1
2008,Zaragoza,50053,Boquiñeni,3,11,-8
2008,Zaragoza,50055,Borja,70,61,9
2008,Zaragoza,50056,Botorrita,3,3,0
2008,Zaragoza,50057,Brea de Aragón,9,27,-18
2008,Zaragoza,50058,Bubierca,1,2,-1
2008,Zaragoza,50059,Bujaraloz,10,16,-6
2008,Zaragoza,50060,Bulbuente,1,5,-4
2008,Zaragoza,50061,Bureta,2,3,-1
2008,Zaragoza,50062,Burgo de Ebro (El),30,20,10
2008,Zaragoza,50043,Bárboles,1,1,0
2008,Zaragoza,50064,Cabañas de Ebro,4,18,-14
2008,Zaragoza,50066,Cadrete,40,20,20
2008,Zaragoza,50067,Calatayud,225,253,-28
2008,Zaragoza,50068,Calatorao,29,29,0
2008,Zaragoza,50069,Calcena,0,1,-1
2008,Zaragoza,50070,Calmarza,0,3,-3
2008,Zaragoza,50071,Campillo de Aragón,0,2,-2
2008,Zaragoza,50072,Carenas,0,5,-5
2008,Zaragoza,50073,Cariñena,41,52,-11
2008,Zaragoza,50074,Caspe,103,89,14
2008,Zaragoza,50075,Castejón de Alarba,0,2,-2
2008,Zaragoza,50076,Castejón de las Armas,0,2,-2
2008,Zaragoza,50077,Castejón de Valdejasa,0,7,-7
2008,Zaragoza,50078,Castiliscar,0,5,-5
2008,Zaragoza,50079,Cervera de la Cañada,2,7,-5
2008,Zaragoza,50081,Cetina,5,22,-17
2008,Zaragoza,50092,Chiprana,3,4,-1
2008,Zaragoza,50093,Chodes,1,1,0
2008,Zaragoza,50082,Cimballa,0,2,-2
2008,Zaragoza,50083,Cinco Olivas,0,4,-4
2008,Zaragoza,50084,Clarés de Ribota,0,1,-1
2008,Zaragoza,50085,Codo,0,5,-5
2008,Zaragoza,50086,Codos,0,7,-7
2008,Zaragoza,50087,Contamina,1,3,-2
2008,Zaragoza,50088,Cosuenda,3,5,-2
2008,Zaragoza,50089,Cuarte de Huerva,188,26,162
2008,Zaragoza,50090,Cubel,5,4,1
2008,Zaragoza,50094,Daroca,19,37,-18
2008,Zaragoza,50095,Ejea de los Caballeros,185,176,9
2008,Zaragoza,50098,Encinacorba,0,3,-3
2008,Zaragoza,50100,Erla,0,4,-4
2008,Zaragoza,50101,Escatrón,3,16,-13
2008,Zaragoza,50102,Fabara,12,12,0
2008,Zaragoza,50104,Farlete,2,9,-7
2008,Zaragoza,50106,Fayos (Los),0,6,-6
2008,Zaragoza,50105,Fayón,0,10,-10
2008,Zaragoza,50107,Figueruelas,16,19,-3
2008,Zaragoza,50108,Fombuena,0,1,-1
2008,Zaragoza,50109,Frago (El),0,1,-1
2008,Zaragoza,50110,Frasno (El),1,9,-8
2008,Zaragoza,50111,Fréscano,0,3,-3
2008,Zaragoza,50113,Fuendejalón,5,14,-9
2008,Zaragoza,50114,Fuendetodos,0,2,-2
2008,Zaragoza,50115,Fuentes de Ebro,53,36,17
2008,Zaragoza,50116,Fuentes de Jiloca,1,6,-5
2008,Zaragoza,50117,Gallocanta,1,0,1
2008,Zaragoza,50118,Gallur,23,37,-14
2008,Zaragoza,50119,Gelsa,5,13,-8
2008,Zaragoza,50120,Godojos,0,1,-1
2008,Zaragoza,50121,Gotor,4,2,2
2008,Zaragoza,50122,Grisel,0,1,-1
2008,Zaragoza,50123,Grisén,4,5,-1
2008,Zaragoza,50124,Herrera de los Navarros,4,6,-2
2008,Zaragoza,50125,Ibdes,0,6,-6
2008,Zaragoza,50126,Illueca,30,23,7
2008,Zaragoza,50128,Isuerre,1,1,0
2008,Zaragoza,50129,Jaraba,5,4,1
2008,Zaragoza,50130,Jarque de Moncayo,2,6,-4
2008,Zaragoza,50131,Jaulín,1,7,-6
2008,Zaragoza,50132,Joyosa (La),15,8,7
2008,Zaragoza,50133,Lagata,0,2,-2
2008,Zaragoza,50134,Langa del Castillo,0,0,0
2008,Zaragoza,50138,Lechón,0,1,-1
2008,Zaragoza,50137,Leciñena,5,14,-9
2008,Zaragoza,50139,Letux,0,9,-9
2008,Zaragoza,50140,Litago,0,4,-4
2008,Zaragoza,50141,Lituénigo,0,1,-1
2008,Zaragoza,50142,Lobera de Onsella,0,2,-2
2008,Zaragoza,50143,Longares,7,9,-2
2008,Zaragoza,50144,Longás,0,1,-1
2008,Zaragoza,50146,Lucena de Jalón,3,3,0
2008,Zaragoza,50147,Luceni,11,17,-6
2008,Zaragoza,50148,Luesia,1,9,-8
2008,Zaragoza,50150,Lumpiaque,6,19,-13
2008,Zaragoza,50151,Luna,1,11,-10
2008,Zaragoza,50136,Lécera,2,12,-10
2008,Zaragoza,50152,Maella,1,15,-14
2008,Zaragoza,50153,Magallón,15,11,4
2008,Zaragoza,50154,Mainar,0,4,-4
2008,Zaragoza,50156,Maleján,2,4,-2
2008,Zaragoza,50160,Mallén,42,32,10
2008,Zaragoza,50159,Maluenda,10,15,-5
2008,Zaragoza,50157,Malón,0,4,-4
2008,Zaragoza,50161,Manchones,0,2,-2
2008,Zaragoza,50902,Marracos,0,0,0
2008,Zaragoza,50163,María de Huerva,117,19,98
2008,Zaragoza,50164,Mediana de Aragón,2,4,-2
2008,Zaragoza,50165,Mequinenza,11,38,-27
2008,Zaragoza,50166,Mesones de Isuela,1,5,-4
2008,Zaragoza,50167,Mezalocha,0,2,-2
2008,Zaragoza,50169,Miedes de Aragón,0,7,-7
2008,Zaragoza,50170,Monegrillo,2,12,-10
2008,Zaragoza,50171,Moneva,0,1,-1
2008,Zaragoza,50172,Monreal de Ariza,0,6,-6
2008,Zaragoza,50173,Monterde,0,5,-5
2008,Zaragoza,50174,Montón,0,2,-2
2008,Zaragoza,50175,Morata de Jalón,6,16,-10
2008,Zaragoza,50176,Morata de Jiloca,0,5,-5
2008,Zaragoza,50178,Moros,0,3,-3
2008,Zaragoza,50177,Morés,2,8,-6
2008,Zaragoza,50179,Moyuela,0,3,-3
2008,Zaragoza,50180,Mozota,0,2,-2
2008,Zaragoza,50181,Muel,14,11,3
2008,Zaragoza,50182,Muela (La),74,18,56
2008,Zaragoza,50183,Munébrega,0,12,-12
2008,Zaragoza,50185,Murillo de Gállego,2,1,1
2008,Zaragoza,50186,Navardún,0,1,-1
2008,Zaragoza,50187,Nigüella,0,1,-1
2008,Zaragoza,50189,Nonaspe,10,15,-5
2008,Zaragoza,50190,Novallas,6,12,-6
2008,Zaragoza,50191,Novillas,5,9,-4
2008,Zaragoza,50193,Nuez de Ebro,14,3,11
2008,Zaragoza,50192,Nuévalos,1,1,0
2008,Zaragoza,50194,Olvés,1,2,-1
2008,Zaragoza,50195,Orcajo,0,1,-1
2008,Zaragoza,50196,Orera,0,1,-1
2008,Zaragoza,50197,Orés,0,2,-2
2008,Zaragoza,50199,Osera de Ebro,5,23,-18
2008,Zaragoza,50200,Paniza,3,7,-4
2008,Zaragoza,50201,Paracuellos de Jiloca,3,11,-8
2008,Zaragoza,50202,Paracuellos de la Ribera,0,4,-4
2008,Zaragoza,50203,Pastriz,14,15,-1
2008,Zaragoza,50204,Pedrola,41,37,4
2008,Zaragoza,50205,Pedrosas (Las),0,0,0
2008,Zaragoza,50206,Perdiguera,3,10,-7
2008,Zaragoza,50207,Piedratajada,0,3,-3
2008,Zaragoza,50208,Pina de Ebro,20,21,-1
2008,Zaragoza,50209,Pinseque,48,68,-20
2008,Zaragoza,50211,Plasencia de Jalón,1,2,-1
2008,Zaragoza,50212,Pleitas,0,4,-4
2008,Zaragoza,50213,Plenas,0,3,-3
2008,Zaragoza,50216,Pozuelo de Aragón,2,7,-5
2008,Zaragoza,50217,Pradilla de Ebro,0,9,-9
2008,Zaragoza,50218,Puebla de Albortón,0,3,-3
2008,Zaragoza,50219,Puebla de Alfindén (La),119,32,87
2008,Zaragoza,50220,Puendeluna,0,1,-1
2008,Zaragoza,50221,Purujosa,1,0,1
2008,Zaragoza,50222,Quinto,20,21,-1
2008,Zaragoza,50223,Remolinos,9,23,-14
2008,Zaragoza,50224,Retascón,0,2,-2
2008,Zaragoza,50225,Ricla,30,26,4
2008,Zaragoza,50227,Romanos,0,1,-1
2008,Zaragoza,50228,Rueda de Jalón,2,3,-1
2008,Zaragoza,50229,Ruesca,0,1,-1
2008,Zaragoza,50231,Salillas de Jalón,2,5,-3
2008,Zaragoza,50232,Salvatierra de Esca,2,7,-5
2008,Zaragoza,50234,San Martín de la Virgen de Moncayo,1,2,-1
2008,Zaragoza,50235,San Mateo de Gállego,28,32,-4
2008,Zaragoza,50236,Santa Cruz de Grío,0,2,-2
2008,Zaragoza,50237,Santa Cruz de Moncayo,1,4,-3
2008,Zaragoza,50238,Santa Eulalia de Gállego,0,2,-2
2008,Zaragoza,50241,Saviñán,7,8,-1
2008,Zaragoza,50242,Sediles,0,1,-1
2008,Zaragoza,50243,Sestrica,0,5,-5
2008,Zaragoza,50244,Sierra de Luna,0,3,-3
2008,Zaragoza,50245,Sigüés,2,0,2
2008,Zaragoza,50247,Sobradiel,14,8,6
2008,Zaragoza,50248,Sos del Rey Católico,7,16,-9
2008,Zaragoza,50230,Sádaba,15,35,-20
2008,Zaragoza,50240,Sástago,2,3,-1
2008,Zaragoza,50249,Tabuenca,0,6,-6
2008,Zaragoza,50250,Talamantes,0,5,-5
2008,Zaragoza,50251,Tarazona,119,161,-42
2008,Zaragoza,50252,Tauste,70,75,-5
2008,Zaragoza,50253,Terrer,2,12,-10
2008,Zaragoza,50254,Tierga,0,6,-6
2008,Zaragoza,50255,Tobed,0,7,-7
2008,Zaragoza,50256,Torralba de los Frailes,0,2,-2
2008,Zaragoza,50257,Torralba de Ribota,1,4,-3
2008,Zaragoza,50261,Torrellas,0,6,-6
2008,Zaragoza,50262,Torres de Berrellén,16,12,4
2008,Zaragoza,50263,Torrijo de la Cañada,0,10,-10
2008,Zaragoza,50264,Tosos,2,4,-2
2008,Zaragoza,50265,Trasmoz,0,2,-2
2008,Zaragoza,50266,Trasobares,0,5,-5
2008,Zaragoza,50267,Uncastillo,4,10,-6
2008,Zaragoza,50268,Undués de Lerda,1,0,1
2008,Zaragoza,50269,Urrea de Jalón,1,10,-9
2008,Zaragoza,50270,Urriés,0,1,-1
2008,Zaragoza,50271,Used,0,3,-3
2008,Zaragoza,50272,Utebo,271,85,186
2008,Zaragoza,50274,Val de San Martín,0,1,-1
2008,Zaragoza,50273,Valdehorna,0,3,-3
2008,Zaragoza,50275,Valmadrid,0,4,-4
2008,Zaragoza,50276,Valpalmas,0,4,-4
2008,Zaragoza,50277,Valtorres,1,0,1
2008,Zaragoza,50278,Velilla de Ebro,2,6,-4
2008,Zaragoza,50279,Velilla de Jiloca,0,3,-3
2008,Zaragoza,50280,Vera de Moncayo,0,5,-5
2008,Zaragoza,50281,Vierlas,1,6,-5
2008,Zaragoza,50283,Villadoz,1,3,-2
2008,Zaragoza,50285,Villafranca de Ebro,4,8,-4
2008,Zaragoza,50286,Villalba de Perejil,0,2,-2
2008,Zaragoza,50287,Villalengua,1,4,-3
2008,Zaragoza,50903,Villamayor de Gállego,23,32,-9
2008,Zaragoza,50288,Villanueva de Gállego,49,32,17
2008,Zaragoza,50290,Villanueva de Huerva,3,8,-5
2008,Zaragoza,50289,Villanueva de Jiloca,0,2,-2
2008,Zaragoza,50292,Villarreal de Huerva,1,2,-1
2008,Zaragoza,50293,Villarroya de la Sierra,1,9,-8
2008,Zaragoza,50294,Villarroya del Campo,0,4,-4
2008,Zaragoza,50282,Vilueña (La),0,1,-1
2008,Zaragoza,50296,Zaida (La),6,7,-1
2008,Zaragoza,50297,Zaragoza,7339,5989,1350
2008,Zaragoza,50298,Zuera,80,73,7
2008,Zaragoza,50099,Épila,57,52,5
2007,Huesca,22001,Abiego,0,2,-2
2007,Huesca,22004,Agüero,0,5,-5
2007,Huesca,22007,Albalate de Cinca,12,13,-1
2007,Huesca,22008,Albalatillo,0,3,-3
2007,Huesca,22009,Albelda,9,28,-19
2007,Huesca,22011,Albero Alto,0,3,-3
2007,Huesca,22012,Albero Bajo,1,2,-1
2007,Huesca,22013,Alberuela de Tubo,0,1,-1
2007,Huesca,22014,Alcalá de Gurrea,0,5,-5
2007,Huesca,22015,Alcalá del Obispo,4,5,-1
2007,Huesca,22016,Alcampell,6,18,-12
2007,Huesca,22017,Alcolea de Cinca,10,16,-6
2007,Huesca,22018,Alcubierre,2,4,-2
2007,Huesca,22019,Alerre,0,1,-1
2007,Huesca,22020,Alfántega,0,1,-1
2007,Huesca,22021,Almudévar,9,42,-33
2007,Huesca,22022,Almunia de San Juan,3,9,-6
2007,Huesca,22023,Almuniente,6,13,-7
2007,Huesca,22024,Alquézar,2,6,-4
2007,Huesca,22025,Altorricón,5,18,-13
2007,Huesca,22027,Angüés,1,8,-7
2007,Huesca,22028,Ansó,2,6,-4
2007,Huesca,22029,Antillón,0,1,-1
2007,Huesca,22032,Aragüés del Puerto,0,1,-1
2007,Huesca,22036,Argavieso,2,2,0
2007,Huesca,22035,Arén,2,5,-3
2007,Huesca,22039,Ayerbe,11,19,-8
2007,Huesca,22040,Azanuy-Alins,0,4,-4
2007,Huesca,22041,Azara,3,2,1
2007,Huesca,22042,Azlor,0,2,-2
2007,Huesca,22907,Aínsa-Sobrarbe,17,30,-13
2007,Huesca,22006,Aísa,1,2,-1
2007,Huesca,22043,Baells,0,2,-2
2007,Huesca,22044,Bailo,0,2,-2
2007,Huesca,22045,Baldellou,0,2,-2
2007,Huesca,22046,Ballobar,3,16,-13
2007,Huesca,22047,Banastás,1,2,-1
2007,Huesca,22048,Barbastro,144,173,-29
2007,Huesca,22049,Barbués,0,2,-2
2007,Huesca,22052,Belver de Cinca,8,17,-9
2007,Huesca,22053,Benabarre,9,24,-15
2007,Huesca,22054,Benasque,16,10,6
2007,Huesca,22246,Beranuy,1,5,-4
2007,Huesca,22055,Berbegal,2,11,-9
2007,Huesca,22057,Bielsa,4,4,0
2007,Huesca,22058,Bierge,0,6,-6
2007,Huesca,22059,Biescas,15,17,-2
2007,Huesca,22060,Binaced,19,14,5
2007,Huesca,22061,Binéfar,102,86,16
2007,Huesca,22062,Bisaurri,1,1,0
2007,Huesca,22063,Biscarrués,0,4,-4
2007,Huesca,22064,Blecua y Torres,0,5,-5
2007,Huesca,22066,Boltaña,8,11,-3
2007,Huesca,22067,Bonansa,1,0,1
2007,Huesca,22069,Broto,2,4,-2
2007,Huesca,22051,Bárcabo,1,0,1
2007,Huesca,22072,Caldearenas,1,3,-2
2007,Huesca,22074,Campo,0,1,-1
2007,Huesca,22075,Camporrells,1,3,-2
2007,Huesca,22076,Canal de Berdún,1,4,-3
2007,Huesca,22077,Candasnos,0,4,-4
2007,Huesca,22078,Canfranc,3,2,1
2007,Huesca,22079,Capdesaso,0,6,-6
2007,Huesca,22080,Capella,1,8,-7
2007,Huesca,22081,Casbas de Huesca,1,5,-4
2007,Huesca,22083,Castejón de Monegros,2,7,-5
2007,Huesca,22084,Castejón de Sos,5,11,-6
2007,Huesca,22082,Castejón del Puente,2,5,-3
2007,Huesca,22086,Castiello de Jaca,1,1,0
2007,Huesca,22087,Castigaleu,4,2,2
2007,Huesca,22088,Castillazuelo,1,1,0
2007,Huesca,22089,Castillonroy,2,8,-6
2007,Huesca,22094,Chalamera,0,2,-2
2007,Huesca,22096,Chimillas,3,14,-11
2007,Huesca,22095,Chía,0,0,0
2007,Huesca,22090,Colungo,0,2,-2
2007,Huesca,22099,Esplús,0,9,-9
2007,Huesca,22102,Estada,0,3,-3
2007,Huesca,22103,Estadilla,9,12,-3
2007,Huesca,22105,Estopiñán del Castillo,0,2,-2
2007,Huesca,22106,Fago,0,2,-2
2007,Huesca,22107,Fanlo,0,2,-2
2007,Huesca,22109,Fiscal,6,3,3
2007,Huesca,22110,Fonz,7,14,-7
2007,Huesca,22111,Foradada del Toscar,2,1,1
2007,Huesca,22112,Fraga,175,127,48
2007,Huesca,22113,Fueva (La),6,5,1
2007,Huesca,22114,Gistaín,2,3,-1
2007,Huesca,22115,Grado (El),7,5,2
2007,Huesca,22117,Graus,31,59,-28
2007,Huesca,22116,Grañén,13,36,-23
2007,Huesca,22119,Gurrea de Gállego,3,18,-15
2007,Huesca,22908,Hoz y Costeán,0,2,-2
2007,Huesca,22124,Huerto,1,3,-2
2007,Huesca,22125,Huesca,543,457,86
2007,Huesca,22126,Ibieca,0,1,-1
2007,Huesca,22127,Igriés,8,12,-4
2007,Huesca,22128,Ilche,1,0,1
2007,Huesca,22129,Isábena,0,2,-2
2007,Huesca,22130,Jaca,128,151,-23
2007,Huesca,22131,Jasa,0,1,-1
2007,Huesca,22133,Labuerda,1,2,-1
2007,Huesca,22135,Laluenga,0,4,-4
2007,Huesca,22136,Lalueza,6,6,0
2007,Huesca,22137,Lanaja,4,18,-14
2007,Huesca,22139,Laperdiguera,1,2,-1
2007,Huesca,22141,Lascellas-Ponzano,1,3,-2
2007,Huesca,22143,Laspaúles,0,5,-5
2007,Huesca,22144,Laspuña,0,0,0
2007,Huesca,22149,Loarre,1,4,-3
2007,Huesca,22150,Loporzano,2,3,-1
2007,Huesca,22151,Loscorrales,1,3,-2
2007,Huesca,22905,Lupiñén-Ortilla,3,4,-1
2007,Huesca,22155,Monesma y Cajigar,0,1,-1
2007,Huesca,22156,Monflorite-Lascasas,2,2,0
2007,Huesca,22157,Montanuy,0,6,-6
2007,Huesca,22158,Monzón,197,154,43
2007,Huesca,22160,Naval,3,6,-3
2007,Huesca,22162,Novales,1,0,1
2007,Huesca,22163,Nueno,6,0,6
2007,Huesca,22165,Ontiñena,2,12,-10
2007,Huesca,22167,Osso de Cinca,4,6,-2
2007,Huesca,22170,Panticosa,3,4,-1
2007,Huesca,22174,Peralta de Alcofea,2,4,-2
2007,Huesca,22175,Peralta de Calasanz,0,6,-6
2007,Huesca,22176,Peraltilla,1,2,-1
2007,Huesca,22177,Perarrúa,1,1,0
2007,Huesca,22178,Pertusa,0,0,0
2007,Huesca,22172,Peñalba,0,4,-4
2007,Huesca,22173,Peñas de Riglos (Las),0,3,-3
2007,Huesca,22181,Piracés,0,1,-1
2007,Huesca,22182,Plan,6,3,3
2007,Huesca,22184,Poleñino,0,5,-5
2007,Huesca,22186,Pozán de Vero,0,2,-2
2007,Huesca,22187,Puebla de Castro (La),3,3,0
2007,Huesca,22902,Puente la Reina de Jaca,0,1,-1
2007,Huesca,22190,Pueyo de Araguás (El),1,0,1
2007,Huesca,22193,Pueyo de Santa Cruz,1,6,-5
2007,Huesca,22189,Puértolas,2,1,1
2007,Huesca,22195,Quicena,3,6,-3
2007,Huesca,22197,Robres,4,10,-6
2007,Huesca,22199,Sabiñánigo,84,73,11
2007,Huesca,22200,Sahún,2,5,-3
2007,Huesca,22201,Salas Altas,0,6,-6
2007,Huesca,22202,Salas Bajas,1,3,-2
2007,Huesca,22204,Sallent de Gállego,19,9,10
2007,Huesca,22205,San Esteban de Litera,2,7,-5
2007,Huesca,22207,San Juan de Plan,2,0,2
2007,Huesca,22903,San Miguel del Cinca,5,13,-8
2007,Huesca,22206,Sangarrén,1,4,-3
2007,Huesca,22208,Santa Cilia,0,3,-3
2007,Huesca,22209,Santa Cruz de la Serós,0,2,-2
2007,Huesca,22906,Santa María de Dulcis,0,2,-2
2007,Huesca,22213,Sariñena,34,60,-26
2007,Huesca,22214,Secastilla,1,1,0
2007,Huesca,22215,Seira,0,2,-2
2007,Huesca,22217,Sena,5,7,-2
2007,Huesca,22218,Senés de Alcubierre,0,2,-2
2007,Huesca,22220,Sesa,0,4,-4
2007,Huesca,22222,Siétamo,5,7,-2
2007,Huesca,22223,Sopeira,2,1,1
2007,Huesca,22904,Sotonera (La),7,13,-6
2007,Huesca,22225,Tamarite de Litera,40,51,-11
2007,Huesca,22226,Tardienta,6,14,-8
2007,Huesca,22227,Tella-Sin,1,4,-3
2007,Huesca,22228,Tierz,15,5,10
2007,Huesca,22229,Tolva,1,1,0
2007,Huesca,22230,Torla-Ordesa,2,2,0
2007,Huesca,22232,Torralba de Aragón,1,2,-1
2007,Huesca,22233,Torre la Ribera,0,2,-2
2007,Huesca,22234,Torrente de Cinca,0,5,-5
2007,Huesca,22235,Torres de Alcanadre,0,1,-1
2007,Huesca,22236,Torres de Barbués,1,5,-4
2007,Huesca,22239,Tramaced,0,2,-2
2007,Huesca,22242,Valfarta,0,1,-1
2007,Huesca,22901,Valle de Hecho,5,17,-12
2007,Huesca,22244,Valle de Lierp,0,1,-1
2007,Huesca,22245,Velilla de Cinca,0,5,-5
2007,Huesca,22909,Vencillón,5,4,1
2007,Huesca,22247,Viacamp y Litera,0,1,-1
2007,Huesca,22249,Villanova,4,1,3
2007,Huesca,22251,Villanueva de Sigena,3,4,-1
2007,Huesca,22250,Villanúa,0,5,-5
2007,Huesca,22252,Yebra de Basa,1,1,0
2007,Huesca,22254,Zaidín,12,15,-3
2007,Teruel,44004,Aguaviva,7,7,0
2007,Teruel,44006,Alacón,2,2,0
2007,Teruel,44007,Alba,3,5,-2
2007,Teruel,44008,Albalate del Arzobispo,18,32,-14
2007,Teruel,44009,Albarracín,7,15,-8
2007,Teruel,44010,Albentosa,2,3,-1
2007,Teruel,44011,Alcaine,1,0,1
2007,Teruel,44012,Alcalá de la Selva,0,5,-5
2007,Teruel,44013,Alcañiz,224,142,82
2007,Teruel,44014,Alcorisa,35,38,-3
2007,Teruel,44016,Alfambra,2,13,-11
2007,Teruel,44017,Aliaga,3,6,-3
2007,Teruel,44021,Allepuz,2,2,0
2007,Teruel,44022,Alloza,4,14,-10
2007,Teruel,44018,Almohaja,0,1,-1
2007,Teruel,44019,Alobras,0,2,-2
2007,Teruel,44024,Anadón,0,1,-1
2007,Teruel,44025,Andorra,61,66,-5
2007,Teruel,44026,Arcos de las Salinas,0,3,-3
2007,Teruel,44027,Arens de Lledó,0,4,-4
2007,Teruel,44028,Argente,0,4,-4
2007,Teruel,44029,Ariño,6,12,-6
2007,Teruel,44031,Azaila,0,7,-7
2007,Teruel,44035,Barrachina,3,2,1
2007,Teruel,44037,Beceite,4,10,-6
2007,Teruel,44039,Bello,0,8,-8
2007,Teruel,44038,Belmonte de San José,0,0,0
2007,Teruel,44040,Berge,4,3,1
2007,Teruel,44041,Bezas,1,1,0
2007,Teruel,44042,Blancas,0,3,-3
2007,Teruel,44043,Blesa,0,2,-2
2007,Teruel,44044,Bordón,0,2,-2
2007,Teruel,44045,Bronchales,2,7,-5
2007,Teruel,44046,Bueña,0,2,-2
2007,Teruel,44047,Burbáguena,0,19,-19
2007,Teruel,44033,Báguena,0,7,-7
2007,Teruel,44048,Cabra de Mora,0,2,-2
2007,Teruel,44049,Calaceite,6,16,-10
2007,Teruel,44050,Calamocha,45,49,-4
2007,Teruel,44051,Calanda,32,35,-3
2007,Teruel,44054,Camarena de la Sierra,1,0,1
2007,Teruel,44053,Camañas,1,2,-1
2007,Teruel,44056,Caminreal,3,12,-9
2007,Teruel,44059,Cantavieja,5,8,-3
2007,Teruel,44064,Cascante del Río,0,2,-2
2007,Teruel,44065,Castejón de Tornos,0,1,-1
2007,Teruel,44066,Castel de Cabra,1,2,-1
2007,Teruel,44070,Castellar (El),0,2,-2
2007,Teruel,44071,Castellote,9,19,-10
2007,Teruel,44067,Castelnou,1,1,0
2007,Teruel,44068,Castelserás,5,13,-8
2007,Teruel,44061,Cañada de Verich (La),0,2,-2
2007,Teruel,44062,Cañada Vellida,0,1,-1
2007,Teruel,44063,Cañizar del Olivar,0,1,-1
2007,Teruel,44074,Cedrillas,8,9,-1
2007,Teruel,44075,Celadas,1,3,-2
2007,Teruel,44076,Cella,28,32,-4
2007,Teruel,44077,Cerollera (La),0,3,-3
2007,Teruel,44080,Codoñera (La),4,3,1
2007,Teruel,44082,Corbalán,0,3,-3
2007,Teruel,44084,Cortes de Aragón,2,0,2
2007,Teruel,44085,Cosa,0,3,-3
2007,Teruel,44086,Cretas,8,9,-1
2007,Teruel,44087,Crivillén,0,6,-6
2007,Teruel,44088,Cuba (La),1,0,1
2007,Teruel,44089,Cubla,0,1,-1
2007,Teruel,44090,Cucalón,0,2,-2
2007,Teruel,44093,Cuevas de Almudén,0,1,-1
2007,Teruel,44094,Cuevas Labradas,0,3,-3
2007,Teruel,44096,Ejulve,1,2,-1
2007,Teruel,44097,Escorihuela,1,4,-3
2007,Teruel,44099,Escucha,9,9,0
2007,Teruel,44100,Estercuel,1,2,-1
2007,Teruel,44101,Ferreruela de Huerva,0,1,-1
2007,Teruel,44103,Formiche Alto,0,1,-1
2007,Teruel,44106,Fortanete,7,0,7
2007,Teruel,44107,Foz-Calanda,2,3,-1
2007,Teruel,44108,Fresneda (La),4,5,-1
2007,Teruel,44109,Frías de Albarracín,1,0,1
2007,Teruel,44112,Fuentes Claras,1,13,-12
2007,Teruel,44113,Fuentes de Rubielos,1,1,0
2007,Teruel,44114,Fuentespalda,3,3,0
2007,Teruel,44105,Fórnoles,0,3,-3
2007,Teruel,44115,Galve,0,0,0
2007,Teruel,44116,Gargallo,1,0,1
2007,Teruel,44117,Gea de Albarracín,4,10,-6
2007,Teruel,44118,Ginebrosa (La),1,1,0
2007,Teruel,44119,Griegos,1,1,0
2007,Teruel,44120,Guadalaviar,2,3,-1
2007,Teruel,44121,Gúdar,2,1,1
2007,Teruel,44123,Hinojosa de Jarque,1,1,0
2007,Teruel,44124,Hoz de la Vieja (La),0,2,-2
2007,Teruel,44125,Huesa del Común,1,2,-1
2007,Teruel,44122,Híjar,11,30,-19
2007,Teruel,44126,Iglesuela del Cid (La),3,4,-1
2007,Teruel,44127,Jabaloyas,1,2,-1
2007,Teruel,44128,Jarque de la Val,1,1,0
2007,Teruel,44129,Jatiel,1,3,-2
2007,Teruel,44130,Jorcas,0,2,-2
2007,Teruel,44135,Libros,0,2,-2
2007,Teruel,44136,Lidón,0,2,-2
2007,Teruel,44137,Linares de Mora,0,3,-3
2007,Teruel,44141,Lledó,0,2,-2
2007,Teruel,44138,Loscos,0,2,-2
2007,Teruel,44143,Manzanera,5,11,-6
2007,Teruel,44144,Martín del Río,4,6,-2
2007,Teruel,44145,Mas de las Matas,5,27,-22
2007,Teruel,44146,Mata de los Olmos (La),4,3,1
2007,Teruel,44147,Mazaleón,2,10,-8
2007,Teruel,44148,Mezquita de Jarque,0,2,-2
2007,Teruel,44149,Mirambel,2,3,-1
2007,Teruel,44150,Miravete de la Sierra,0,2,-2
2007,Teruel,44151,Molinos,1,9,-8
2007,Teruel,44153,Monreal del Campo,29,39,-10
2007,Teruel,44154,Monroyo,2,4,-2
2007,Teruel,44155,Montalbán,5,12,-7
2007,Teruel,44157,Monterde de Albarracín,0,3,-3
2007,Teruel,44158,Mora de Rubielos,12,18,-6
2007,Teruel,44160,Mosqueruela,2,11,-9
2007,Teruel,44161,Muniesa,5,18,-13
2007,Teruel,44163,Noguera de Albarracín,1,2,-1
2007,Teruel,44165,Nogueruelas,3,6,-3
2007,Teruel,44168,Odón,0,4,-4
2007,Teruel,44169,Ojos Negros,2,7,-5
2007,Teruel,44171,Olba,1,1,0
2007,Teruel,44172,Oliete,3,6,-3
2007,Teruel,44173,Olmos (Los),0,1,-1
2007,Teruel,44174,Orihuela del Tremedal,2,7,-5
2007,Teruel,44175,Orrios,1,2,-1
2007,Teruel,44176,Palomar de Arroyos,1,1,0
2007,Teruel,44177,Pancrudo,1,4,-3
2007,Teruel,44178,Parras de Castellote (Las),0,2,-2
2007,Teruel,44180,Peracense,0,2,-2
2007,Teruel,44181,Peralejos,0,1,-1
2007,Teruel,44182,Perales del Alfambra,2,4,-2
2007,Teruel,44179,Peñarroya de Tastavins,5,9,-4
2007,Teruel,44183,Pitarque,0,2,-2
2007,Teruel,44184,Plou,0,2,-2
2007,Teruel,44185,Pobo (El),0,2,-2
2007,Teruel,44187,Portellada (La),1,5,-4
2007,Teruel,44189,Pozondón,0,3,-3
2007,Teruel,44190,Pozuel del Campo,0,1,-1
2007,Teruel,44191,Puebla de Híjar (La),5,9,-4
2007,Teruel,44192,Puebla de Valverde (La),3,10,-7
2007,Teruel,44193,Puertomingalvo,3,3,0
2007,Teruel,44196,Riodeva,0,3,-3
2007,Teruel,44198,Royuela,1,4,-3
2007,Teruel,44199,Rubiales,0,3,-3
2007,Teruel,44200,Rubielos de la Cérida,0,3,-3
2007,Teruel,44201,Rubielos de Mora,3,6,-3
2007,Teruel,44194,Ráfales,2,2,0
2007,Teruel,44197,Ródenas,0,1,-1
2007,Teruel,44204,Saldón,1,0,1
2007,Teruel,44205,Samper de Calanda,2,17,-15
2007,Teruel,44206,San Agustín,1,3,-2
2007,Teruel,44207,San Martín del Río,0,6,-6
2007,Teruel,44209,Santa Eulalia,13,19,-6
2007,Teruel,44210,Sarrión,5,15,-10
2007,Teruel,44211,Segura de los Baños,0,1,-1
2007,Teruel,44213,Singra,0,1,-1
2007,Teruel,44215,Terriente,2,7,-5
2007,Teruel,44216,Teruel,381,284,97
2007,Teruel,44217,Toril y Masegoso,0,1,-1
2007,Teruel,44218,Tormón,0,1,-1
2007,Teruel,44219,Tornos,0,7,-7
2007,Teruel,44220,Torralba de los Sisones,0,1,-1
2007,Teruel,44223,Torre de Arcas,1,2,-1
2007,Teruel,44224,Torre de las Arcas,0,1,-1
2007,Teruel,44225,Torre del Compte,0,3,-3
2007,Teruel,44227,Torre los Negros,0,2,-2
2007,Teruel,44221,Torrecilla de Alcañiz,0,8,-8
2007,Teruel,44222,Torrecilla del Rebollar,1,2,-1
2007,Teruel,44226,Torrelacárcel,0,3,-3
2007,Teruel,44228,Torremocha de Jiloca,0,4,-4
2007,Teruel,44229,Torres de Albarracín,1,1,0
2007,Teruel,44230,Torrevelilla,2,8,-6
2007,Teruel,44231,Torrijas,0,1,-1
2007,Teruel,44232,Torrijo del Campo,5,9,-4
2007,Teruel,44235,Tramacastilla,1,3,-2
2007,Teruel,44236,Tronchón,2,0,2
2007,Teruel,44237,Urrea de Gaén,3,5,-2
2007,Teruel,44238,Utrillas,23,32,-9
2007,Teruel,44239,Valacloche,0,1,-1
2007,Teruel,44240,Valbona,1,5,-4
2007,Teruel,44241,Valdealgorfa,1,9,-8
2007,Teruel,44244,Valdelinares,0,2,-2
2007,Teruel,44245,Valdeltormo,2,5,-3
2007,Teruel,44246,Valderrobres,26,30,-4
2007,Teruel,44247,Valjunquera,3,7,-4
2007,Teruel,44249,Vallecillo (El),0,1,-1
2007,Teruel,44251,Villafranca del Campo,6,6,0
2007,Teruel,44252,Villahermosa del Campo,2,2,0
2007,Teruel,44257,Villar del Cobo,2,2,0
2007,Teruel,44258,Villar del Salz,0,1,-1
2007,Teruel,44260,Villarluengo,0,7,-7
2007,Teruel,44261,Villarquemado,4,17,-13
2007,Teruel,44262,Villarroya de los Pinares,1,3,-2
2007,Teruel,44263,Villastar,5,11,-6
2007,Teruel,44264,Villel,3,9,-6
2007,Teruel,44265,Vinaceite,0,5,-5
2007,Teruel,44266,Visiedo,0,5,-5
2007,Teruel,44267,Vivel del Río Martín,1,2,-1
2007,Zaragoza,50001,Abanto,0,8,-8
2007,Zaragoza,50002,Acered,0,9,-9
2007,Zaragoza,50004,Aguarón,3,25,-22
2007,Zaragoza,50005,Aguilón,0,7,-7
2007,Zaragoza,50006,Ainzón,9,17,-8
2007,Zaragoza,50008,Alagón,94,72,22
2007,Zaragoza,50009,Alarba,3,1,2
2007,Zaragoza,50010,Alberite de San Juan,0,4,-4
2007,Zaragoza,50011,Albeta,0,1,-1
2007,Zaragoza,50012,Alborge,2,2,0
2007,Zaragoza,50013,Alcalá de Ebro,2,2,0
2007,Zaragoza,50014,Alcalá de Moncayo,0,0,0
2007,Zaragoza,50015,Alconchel de Ariza,1,3,-2
2007,Zaragoza,50016,Aldehuela de Liestos,0,1,-1
2007,Zaragoza,50017,Alfajarín,22,16,6
2007,Zaragoza,50018,Alfamén,9,11,-2
2007,Zaragoza,50019,Alforque,1,4,-3
2007,Zaragoza,50020,Alhama de Aragón,6,17,-11
2007,Zaragoza,50021,Almochuel,0,2,-2
2007,Zaragoza,50022,Almolda (La),2,14,-12
2007,Zaragoza,50023,Almonacid de la Cuba,1,3,-2
2007,Zaragoza,50024,Almonacid de la Sierra,7,16,-9
2007,Zaragoza,50025,Almunia de Doña Godina (La),93,71,22
2007,Zaragoza,50026,Alpartir,1,14,-13
2007,Zaragoza,50027,Ambel,0,11,-11
2007,Zaragoza,50029,Aniñón,5,12,-7
2007,Zaragoza,50031,Aranda de Moncayo,1,3,-2
2007,Zaragoza,50033,Ardisa,0,1,-1
2007,Zaragoza,50034,Ariza,22,27,-5
2007,Zaragoza,50035,Artieda,0,1,-1
2007,Zaragoza,50032,Arándiga,1,8,-7
2007,Zaragoza,50036,Asín,0,4,-4
2007,Zaragoza,50037,Atea,1,4,-3
2007,Zaragoza,50038,Ateca,12,30,-18
2007,Zaragoza,50039,Azuara,3,3,0
2007,Zaragoza,50030,Añón de Moncayo,0,6,-6
2007,Zaragoza,50040,Badules,0,3,-3
2007,Zaragoza,50042,Balconchán,0,1,-1
2007,Zaragoza,50044,Bardallur,2,2,0
2007,Zaragoza,50045,Belchite,13,16,-3
2007,Zaragoza,50046,Belmonte de Gracián,1,7,-6
2007,Zaragoza,50048,Berrueco,0,1,-1
2007,Zaragoza,50901,Biel,0,4,-4
2007,Zaragoza,50050,Bijuesca,0,1,-1
2007,Zaragoza,50051,Biota,3,13,-10
2007,Zaragoza,50052,Bisimbre,1,4,-3
2007,Zaragoza,50053,Boquiñeni,9,19,-10
2007,Zaragoza,50055,Borja,43,69,-26
2007,Zaragoza,50056,Botorrita,6,9,-3
2007,Zaragoza,50057,Brea de Aragón,18,20,-2
2007,Zaragoza,50058,Bubierca,0,3,-3
2007,Zaragoza,50059,Bujaraloz,4,12,-8
2007,Zaragoza,50060,Bulbuente,0,9,-9
2007,Zaragoza,50061,Bureta,1,9,-8
2007,Zaragoza,50062,Burgo de Ebro (El),30,24,6
2007,Zaragoza,50063,Buste (El),0,2,-2
2007,Zaragoza,50043,Bárboles,3,3,0
2007,Zaragoza,50064,Cabañas de Ebro,2,13,-11
2007,Zaragoza,50065,Cabolafuente,0,2,-2
2007,Zaragoza,50066,Cadrete,32,12,20
2007,Zaragoza,50067,Calatayud,200,217,-17
2007,Zaragoza,50068,Calatorao,28,30,-2
2007,Zaragoza,50069,Calcena,1,1,0
2007,Zaragoza,50070,Calmarza,0,3,-3
2007,Zaragoza,50071,Campillo de Aragón,0,5,-5
2007,Zaragoza,50072,Carenas,2,4,-2
2007,Zaragoza,50073,Cariñena,33,46,-13
2007,Zaragoza,50074,Caspe,69,92,-23
2007,Zaragoza,50075,Castejón de Alarba,0,2,-2
2007,Zaragoza,50076,Castejón de las Armas,0,1,-1
2007,Zaragoza,50077,Castejón de Valdejasa,1,2,-1
2007,Zaragoza,50078,Castiliscar,2,5,-3
2007,Zaragoza,50079,Cervera de la Cañada,3,5,-2
2007,Zaragoza,50081,Cetina,8,6,2
2007,Zaragoza,50092,Chiprana,3,9,-6
2007,Zaragoza,50093,Chodes,1,1,0
2007,Zaragoza,50082,Cimballa,2,1,1
2007,Zaragoza,50083,Cinco Olivas,1,3,-2
2007,Zaragoza,50084,Clarés de Ribota,0,2,-2
2007,Zaragoza,50085,Codo,0,4,-4
2007,Zaragoza,50086,Codos,1,8,-7
2007,Zaragoza,50087,Contamina,0,1,-1
2007,Zaragoza,50088,Cosuenda,1,2,-1
2007,Zaragoza,50089,Cuarte de Huerva,115,25,90
2007,Zaragoza,50090,Cubel,1,1,0
2007,Zaragoza,50094,Daroca,12,33,-21
2007,Zaragoza,50095,Ejea de los Caballeros,167,168,-1
2007,Zaragoza,50096,Embid de Ariza,0,2,-2
2007,Zaragoza,50098,Encinacorba,1,5,-4
2007,Zaragoza,50100,Erla,2,9,-7
2007,Zaragoza,50101,Escatrón,4,17,-13
2007,Zaragoza,50102,Fabara,9,13,-4
2007,Zaragoza,50104,Farlete,2,4,-2
2007,Zaragoza,50106,Fayos (Los),0,3,-3
2007,Zaragoza,50105,Fayón,1,8,-7
2007,Zaragoza,50107,Figueruelas,14,28,-14
2007,Zaragoza,50109,Frago (El),0,2,-2
2007,Zaragoza,50110,Frasno (El),1,6,-5
2007,Zaragoza,50111,Fréscano,0,3,-3
2007,Zaragoza,50113,Fuendejalón,6,14,-8
2007,Zaragoza,50114,Fuendetodos,0,1,-1
2007,Zaragoza,50115,Fuentes de Ebro,41,32,9
2007,Zaragoza,50116,Fuentes de Jiloca,4,5,-1
2007,Zaragoza,50117,Gallocanta,3,2,1
2007,Zaragoza,50118,Gallur,33,36,-3
2007,Zaragoza,50119,Gelsa,15,12,3
2007,Zaragoza,50120,Godojos,0,1,-1
2007,Zaragoza,50121,Gotor,4,4,0
2007,Zaragoza,50122,Grisel,0,4,-4
2007,Zaragoza,50123,Grisén,3,14,-11
2007,Zaragoza,50124,Herrera de los Navarros,4,10,-6
2007,Zaragoza,50125,Ibdes,2,12,-10
2007,Zaragoza,50126,Illueca,20,33,-13
2007,Zaragoza,50129,Jaraba,5,4,1
2007,Zaragoza,50130,Jarque de Moncayo,1,3,-2
2007,Zaragoza,50131,Jaulín,3,3,0
2007,Zaragoza,50132,Joyosa (La),18,10,8
2007,Zaragoza,50133,Lagata,0,5,-5
2007,Zaragoza,50134,Langa del Castillo,0,1,-1
2007,Zaragoza,50135,Layana,0,1,-1
2007,Zaragoza,50137,Leciñena,8,5,3
2007,Zaragoza,50139,Letux,1,12,-11
2007,Zaragoza,50140,Litago,0,3,-3
2007,Zaragoza,50141,Lituénigo,0,2,-2
2007,Zaragoza,50142,Lobera de Onsella,0,3,-3
2007,Zaragoza,50143,Longares,8,7,1
2007,Zaragoza,50146,Lucena de Jalón,2,4,-2
2007,Zaragoza,50147,Luceni,5,14,-9
2007,Zaragoza,50148,Luesia,0,7,-7
2007,Zaragoza,50150,Lumpiaque,10,11,-1
2007,Zaragoza,50151,Luna,4,15,-11
2007,Zaragoza,50136,Lécera,4,5,-1
2007,Zaragoza,50152,Maella,1,16,-15
2007,Zaragoza,50153,Magallón,10,14,-4
2007,Zaragoza,50154,Mainar,2,4,-2
2007,Zaragoza,50156,Maleján,1,2,-1
2007,Zaragoza,50160,Mallén,28,29,-1
2007,Zaragoza,50159,Maluenda,7,13,-6
2007,Zaragoza,50157,Malón,0,8,-8
2007,Zaragoza,50161,Manchones,1,2,-1
2007,Zaragoza,50162,Mara,3,4,-1
2007,Zaragoza,50902,Marracos,1,3,-2
2007,Zaragoza,50163,María de Huerva,91,26,65
2007,Zaragoza,50164,Mediana de Aragón,5,8,-3
2007,Zaragoza,50165,Mequinenza,22,36,-14
2007,Zaragoza,50166,Mesones de Isuela,1,3,-2
2007,Zaragoza,50167,Mezalocha,0,3,-3
2007,Zaragoza,50168,Mianos,0,1,-1
2007,Zaragoza,50169,Miedes de Aragón,1,8,-7
2007,Zaragoza,50170,Monegrillo,4,3,1
2007,Zaragoza,50171,Moneva,0,2,-2
2007,Zaragoza,50172,Monreal de Ariza,0,4,-4
2007,Zaragoza,50173,Monterde,0,1,-1
2007,Zaragoza,50174,Montón,0,4,-4
2007,Zaragoza,50175,Morata de Jalón,4,23,-19
2007,Zaragoza,50176,Morata de Jiloca,0,4,-4
2007,Zaragoza,50178,Moros,5,8,-3
2007,Zaragoza,50177,Morés,4,13,-9
2007,Zaragoza,50179,Moyuela,1,6,-5
2007,Zaragoza,50180,Mozota,0,5,-5
2007,Zaragoza,50181,Muel,8,18,-10
2007,Zaragoza,50182,Muela (La),53,16,37
2007,Zaragoza,50183,Munébrega,1,4,-3
2007,Zaragoza,50184,Murero,1,0,1
2007,Zaragoza,50185,Murillo de Gállego,1,0,1
2007,Zaragoza,50187,Nigüella,0,1,-1
2007,Zaragoza,50188,Nombrevilla,0,1,-1
2007,Zaragoza,50189,Nonaspe,9,9,0
2007,Zaragoza,50190,Novallas,5,8,-3
2007,Zaragoza,50191,Novillas,4,8,-4
2007,Zaragoza,50193,Nuez de Ebro,5,6,-1
2007,Zaragoza,50192,Nuévalos,4,5,-1
2007,Zaragoza,50194,Olvés,0,1,-1
2007,Zaragoza,50195,Orcajo,0,1,-1
2007,Zaragoza,50196,Orera,1,2,-1
2007,Zaragoza,50197,Orés,0,3,-3
2007,Zaragoza,50199,Osera de Ebro,5,18,-13
2007,Zaragoza,50200,Paniza,5,9,-4
2007,Zaragoza,50201,Paracuellos de Jiloca,2,9,-7
2007,Zaragoza,50202,Paracuellos de la Ribera,0,7,-7
2007,Zaragoza,50203,Pastriz,16,19,-3
2007,Zaragoza,50204,Pedrola,33,32,1
2007,Zaragoza,50205,Pedrosas (Las),1,0,1
2007,Zaragoza,50206,Perdiguera,6,5,1
2007,Zaragoza,50207,Piedratajada,1,3,-2
2007,Zaragoza,50208,Pina de Ebro,32,19,13
2007,Zaragoza,50209,Pinseque,52,56,-4
2007,Zaragoza,50211,Plasencia de Jalón,0,3,-3
2007,Zaragoza,50213,Plenas,0,2,-2
2007,Zaragoza,50216,Pozuelo de Aragón,2,3,-1
2007,Zaragoza,50217,Pradilla de Ebro,5,7,-2
2007,Zaragoza,50218,Puebla de Albortón,0,1,-1
2007,Zaragoza,50219,Puebla de Alfindén (La),94,32,62
2007,Zaragoza,50220,Puendeluna,0,1,-1
2007,Zaragoza,50222,Quinto,14,27,-13
2007,Zaragoza,50223,Remolinos,4,18,-14
2007,Zaragoza,50224,Retascón,0,1,-1
2007,Zaragoza,50225,Ricla,23,20,3
2007,Zaragoza,50227,Romanos,0,0,0
2007,Zaragoza,50228,Rueda de Jalón,1,6,-5
2007,Zaragoza,50229,Ruesca,0,2,-2
2007,Zaragoza,50231,Salillas de Jalón,4,5,-1
2007,Zaragoza,50232,Salvatierra de Esca,2,5,-3
2007,Zaragoza,50233,Samper del Salz,0,2,-2
2007,Zaragoza,50234,San Martín de la Virgen de Moncayo,2,5,-3
2007,Zaragoza,50235,San Mateo de Gállego,24,26,-2
2007,Zaragoza,50236,Santa Cruz de Grío,0,4,-4
2007,Zaragoza,50237,Santa Cruz de Moncayo,0,3,-3
2007,Zaragoza,50238,Santa Eulalia de Gállego,0,1,-1
2007,Zaragoza,50239,Santed,0,1,-1
2007,Zaragoza,50241,Saviñán,7,9,-2
2007,Zaragoza,50242,Sediles,1,0,1
2007,Zaragoza,50243,Sestrica,0,8,-8
2007,Zaragoza,50244,Sierra de Luna,0,1,-1
2007,Zaragoza,50245,Sigüés,0,4,-4
2007,Zaragoza,50246,Sisamón,0,1,-1
2007,Zaragoza,50247,Sobradiel,3,7,-4
2007,Zaragoza,50248,Sos del Rey Católico,3,9,-6
2007,Zaragoza,50230,Sádaba,8,31,-23
2007,Zaragoza,50240,Sástago,1,10,-9
2007,Zaragoza,50249,Tabuenca,0,5,-5
2007,Zaragoza,50251,Tarazona,130,140,-10
2007,Zaragoza,50252,Tauste,72,74,-2
2007,Zaragoza,50253,Terrer,2,12,-10
2007,Zaragoza,50254,Tierga,1,4,-3
2007,Zaragoza,50255,Tobed,1,6,-5
2007,Zaragoza,50256,Torralba de los Frailes,0,1,-1
2007,Zaragoza,50257,Torralba de Ribota,0,3,-3
2007,Zaragoza,50258,Torralbilla,0,1,-1
2007,Zaragoza,50259,Torrehermosa,0,3,-3
2007,Zaragoza,50261,Torrellas,2,2,0
2007,Zaragoza,50262,Torres de Berrellén,13,14,-1
2007,Zaragoza,50263,Torrijo de la Cañada,1,8,-7
2007,Zaragoza,50264,Tosos,1,5,-4
2007,Zaragoza,50265,Trasmoz,0,1,-1
2007,Zaragoza,50266,Trasobares,0,1,-1
2007,Zaragoza,50267,Uncastillo,2,16,-14
2007,Zaragoza,50268,Undués de Lerda,0,0,0
2007,Zaragoza,50269,Urrea de Jalón,4,9,-5
2007,Zaragoza,50271,Used,2,6,-4
2007,Zaragoza,50272,Utebo,278,65,213
2007,Zaragoza,50274,Val de San Martín,0,3,-3
2007,Zaragoza,50275,Valmadrid,1,2,-1
2007,Zaragoza,50276,Valpalmas,0,2,-2
2007,Zaragoza,50277,Valtorres,0,3,-3
2007,Zaragoza,50278,Velilla de Ebro,4,7,-3
2007,Zaragoza,50279,Velilla de Jiloca,0,1,-1
2007,Zaragoza,50280,Vera de Moncayo,0,8,-8
2007,Zaragoza,50281,Vierlas,1,0,1
2007,Zaragoza,50284,Villafeliche,0,5,-5
2007,Zaragoza,50285,Villafranca de Ebro,10,16,-6
2007,Zaragoza,50286,Villalba de Perejil,0,2,-2
2007,Zaragoza,50287,Villalengua,2,7,-5
2007,Zaragoza,50903,Villamayor de Gállego,15,19,-4
2007,Zaragoza,50288,Villanueva de Gállego,54,40,14
2007,Zaragoza,50290,Villanueva de Huerva,4,8,-4
2007,Zaragoza,50289,Villanueva de Jiloca,0,1,-1
2007,Zaragoza,50291,Villar de los Navarros,0,4,-4
2007,Zaragoza,50292,Villarreal de Huerva,2,2,0
2007,Zaragoza,50293,Villarroya de la Sierra,5,15,-10
2007,Zaragoza,50294,Villarroya del Campo,0,1,-1
2007,Zaragoza,50296,Zaida (La),3,4,-1
2007,Zaragoza,50297,Zaragoza,6958,6032,926
2007,Zaragoza,50298,Zuera,67,63,4
2007,Zaragoza,50099,Épila,54,51,3
2006,Huesca,22001,Abiego,1,4,-3
2006,Huesca,22003,Adahuesca,0,2,-2
2006,Huesca,22004,Agüero,0,9,-9
2006,Huesca,22007,Albalate de Cinca,12,13,-1
2006,Huesca,22008,Albalatillo,0,4,-4
2006,Huesca,22009,Albelda,6,17,-11
2006,Huesca,22011,Albero Alto,0,1,-1
2006,Huesca,22012,Albero Bajo,3,1,2
2006,Huesca,22013,Alberuela de Tubo,1,5,-4
2006,Huesca,22014,Alcalá de Gurrea,1,5,-4
2006,Huesca,22015,Alcalá del Obispo,1,2,-1
2006,Huesca,22016,Alcampell,3,14,-11
2006,Huesca,22017,Alcolea de Cinca,5,13,-8
2006,Huesca,22018,Alcubierre,2,4,-2
2006,Huesca,22019,Alerre,0,3,-3
2006,Huesca,22020,Alfántega,1,0,1
2006,Huesca,22021,Almudévar,20,41,-21
2006,Huesca,22022,Almunia de San Juan,1,8,-7
2006,Huesca,22023,Almuniente,3,7,-4
2006,Huesca,22024,Alquézar,0,1,-1
2006,Huesca,22025,Altorricón,5,16,-11
2006,Huesca,22027,Angüés,4,8,-4
2006,Huesca,22028,Ansó,0,11,-11
2006,Huesca,22029,Antillón,1,0,1
2006,Huesca,22032,Aragüés del Puerto,0,1,-1
2006,Huesca,22036,Argavieso,0,5,-5
2006,Huesca,22035,Arén,2,5,-3
2006,Huesca,22039,Ayerbe,7,19,-12
2006,Huesca,22040,Azanuy-Alins,2,3,-1
2006,Huesca,22041,Azara,1,1,0
2006,Huesca,22042,Azlor,2,2,0
2006,Huesca,22907,Aínsa-Sobrarbe,16,20,-4
2006,Huesca,22006,Aísa,2,2,0
2006,Huesca,22043,Baells,1,1,0
2006,Huesca,22044,Bailo,0,8,-8
2006,Huesca,22045,Baldellou,0,2,-2
2006,Huesca,22046,Ballobar,4,10,-6
2006,Huesca,22047,Banastás,2,2,0
2006,Huesca,22048,Barbastro,156,190,-34
2006,Huesca,22049,Barbués,0,1,-1
2006,Huesca,22050,Barbuñales,0,1,-1
2006,Huesca,22052,Belver de Cinca,10,16,-6
2006,Huesca,22053,Benabarre,7,19,-12
2006,Huesca,22054,Benasque,13,5,8
2006,Huesca,22246,Beranuy,0,2,-2
2006,Huesca,22055,Berbegal,3,13,-10
2006,Huesca,22057,Bielsa,3,8,-5
2006,Huesca,22058,Bierge,1,2,-1
2006,Huesca,22059,Biescas,12,23,-11
2006,Huesca,22060,Binaced,15,22,-7
2006,Huesca,22061,Binéfar,105,94,11
2006,Huesca,22062,Bisaurri,1,4,-3
2006,Huesca,22063,Biscarrués,0,2,-2
2006,Huesca,22064,Blecua y Torres,1,1,0
2006,Huesca,22066,Boltaña,6,6,0
2006,Huesca,22069,Broto,4,5,-1
2006,Huesca,22072,Caldearenas,0,2,-2
2006,Huesca,22074,Campo,0,9,-9
2006,Huesca,22075,Camporrells,0,2,-2
2006,Huesca,22076,Canal de Berdún,1,5,-4
2006,Huesca,22078,Canfranc,5,0,5
2006,Huesca,22079,Capdesaso,0,4,-4
2006,Huesca,22080,Capella,1,5,-4
2006,Huesca,22081,Casbas de Huesca,2,4,-2
2006,Huesca,22083,Castejón de Monegros,0,11,-11
2006,Huesca,22084,Castejón de Sos,7,6,1
2006,Huesca,22082,Castejón del Puente,2,3,-1
2006,Huesca,22085,Castelflorite,1,2,-1
2006,Huesca,22086,Castiello de Jaca,2,2,0
2006,Huesca,22087,Castigaleu,1,2,-1
2006,Huesca,22088,Castillazuelo,1,1,0
2006,Huesca,22089,Castillonroy,3,5,-2
2006,Huesca,22094,Chalamera,2,1,1
2006,Huesca,22096,Chimillas,1,13,-12
2006,Huesca,22090,Colungo,0,2,-2
2006,Huesca,22099,Esplús,2,7,-5
2006,Huesca,22102,Estada,0,6,-6
2006,Huesca,22103,Estadilla,3,15,-12
2006,Huesca,22105,Estopiñán del Castillo,3,2,1
2006,Huesca,22107,Fanlo,1,0,1
2006,Huesca,22109,Fiscal,2,4,-2
2006,Huesca,22110,Fonz,3,22,-19
2006,Huesca,22111,Foradada del Toscar,2,2,0
2006,Huesca,22112,Fraga,131,102,29
2006,Huesca,22113,Fueva (La),1,5,-4
2006,Huesca,22114,Gistaín,0,1,-1
2006,Huesca,22115,Grado (El),0,10,-10
2006,Huesca,22117,Graus,24,57,-33
2006,Huesca,22116,Grañén,13,31,-18
2006,Huesca,22119,Gurrea de Gállego,13,26,-13
2006,Huesca,22122,Hoz de Jaca,1,1,0
2006,Huesca,22908,Hoz y Costeán,1,1,0
2006,Huesca,22124,Huerto,0,5,-5
2006,Huesca,22125,Huesca,557,506,51
2006,Huesca,22127,Igriés,8,11,-3
2006,Huesca,22128,Ilche,0,3,-3
2006,Huesca,22129,Isábena,1,8,-7
2006,Huesca,22130,Jaca,135,147,-12
2006,Huesca,22131,Jasa,0,0,0
2006,Huesca,22133,Labuerda,0,2,-2
2006,Huesca,22135,Laluenga,0,5,-5
2006,Huesca,22136,Lalueza,8,21,-13
2006,Huesca,22137,Lanaja,4,18,-14
2006,Huesca,22139,Laperdiguera,0,4,-4
2006,Huesca,22141,Lascellas-Ponzano,1,2,-1
2006,Huesca,22143,Laspaúles,1,1,0
2006,Huesca,22144,Laspuña,1,3,-2
2006,Huesca,22149,Loarre,0,3,-3
2006,Huesca,22150,Loporzano,3,4,-1
2006,Huesca,22151,Loscorrales,1,1,0
2006,Huesca,22905,Lupiñén-Ortilla,3,2,1
2006,Huesca,22155,Monesma y Cajigar,0,1,-1
2006,Huesca,22156,Monflorite-Lascasas,4,2,2
2006,Huesca,22157,Montanuy,1,5,-4
2006,Huesca,22158,Monzón,200,156,44
2006,Huesca,22160,Naval,2,4,-2
2006,Huesca,22162,Novales,3,1,2
2006,Huesca,22163,Nueno,7,1,6
2006,Huesca,22164,Olvena,2,2,0
2006,Huesca,22165,Ontiñena,5,7,-2
2006,Huesca,22167,Osso de Cinca,2,11,-9
2006,Huesca,22170,Panticosa,6,7,-1
2006,Huesca,22174,Peralta de Alcofea,3,10,-7
2006,Huesca,22175,Peralta de Calasanz,0,4,-4
2006,Huesca,22177,Perarrúa,0,3,-3
2006,Huesca,22178,Pertusa,0,2,-2
2006,Huesca,22172,Peñalba,1,2,-1
2006,Huesca,22173,Peñas de Riglos (Las),2,4,-2
2006,Huesca,22181,Piracés,0,1,-1
2006,Huesca,22182,Plan,1,1,0
2006,Huesca,22184,Poleñino,0,3,-3
2006,Huesca,22186,Pozán de Vero,0,6,-6
2006,Huesca,22187,Puebla de Castro (La),2,2,0
2006,Huesca,22188,Puente de Montañana,0,1,-1
2006,Huesca,22902,Puente la Reina de Jaca,2,0,2
2006,Huesca,22190,Pueyo de Araguás (El),1,0,1
2006,Huesca,22193,Pueyo de Santa Cruz,2,5,-3
2006,Huesca,22189,Puértolas,3,2,1
2006,Huesca,22195,Quicena,2,4,-2
2006,Huesca,22197,Robres,6,13,-7
2006,Huesca,22199,Sabiñánigo,80,98,-18
2006,Huesca,22200,Sahún,3,3,0
2006,Huesca,22201,Salas Altas,1,6,-5
2006,Huesca,22202,Salas Bajas,1,2,-1
2006,Huesca,22203,Salillas,0,1,-1
2006,Huesca,22204,Sallent de Gállego,13,6,7
2006,Huesca,22205,San Esteban de Litera,1,12,-11
2006,Huesca,22207,San Juan de Plan,2,2,0
2006,Huesca,22903,San Miguel del Cinca,6,11,-5
2006,Huesca,22206,Sangarrén,0,2,-2
2006,Huesca,22208,Santa Cilia,1,2,-1
2006,Huesca,22209,Santa Cruz de la Serós,0,1,-1
2006,Huesca,22906,Santa María de Dulcis,1,3,-2
2006,Huesca,22213,Sariñena,30,36,-6
2006,Huesca,22214,Secastilla,0,1,-1
2006,Huesca,22215,Seira,0,1,-1
2006,Huesca,22217,Sena,5,8,-3
2006,Huesca,22220,Sesa,1,6,-5
2006,Huesca,22221,Sesué,1,1,0
2006,Huesca,22222,Siétamo,6,5,1
2006,Huesca,22223,Sopeira,0,1,-1
2006,Huesca,22904,Sotonera (La),4,15,-11
2006,Huesca,22225,Tamarite de Litera,22,52,-30
2006,Huesca,22226,Tardienta,7,9,-2
2006,Huesca,22227,Tella-Sin,0,0,0
2006,Huesca,22228,Tierz,13,4,9
2006,Huesca,22229,Tolva,2,1,1
2006,Huesca,22230,Torla-Ordesa,1,8,-7
2006,Huesca,22233,Torre la Ribera,0,1,-1
2006,Huesca,22234,Torrente de Cinca,6,10,-4
2006,Huesca,22235,Torres de Alcanadre,0,1,-1
2006,Huesca,22236,Torres de Barbués,0,5,-5
2006,Huesca,22901,Valle de Hecho,5,13,-8
2006,Huesca,22244,Valle de Lierp,1,0,1
2006,Huesca,22245,Velilla de Cinca,5,7,-2
2006,Huesca,22909,Vencillón,1,5,-4
2006,Huesca,22248,Vicién,0,1,-1
2006,Huesca,22249,Villanova,2,2,0
2006,Huesca,22251,Villanueva de Sigena,1,7,-6
2006,Huesca,22250,Villanúa,6,3,3
2006,Huesca,22252,Yebra de Basa,1,3,-2
2006,Huesca,22253,Yésero,0,1,-1
2006,Huesca,22254,Zaidín,15,18,-3
2006,Teruel,44001,Ababuj,0,1,-1
2006,Teruel,44002,Abejuela,0,1,-1
2006,Teruel,44004,Aguaviva,3,5,-2
2006,Teruel,44005,Aguilar del Alfambra,0,1,-1
2006,Teruel,44006,Alacón,3,6,-3
2006,Teruel,44007,Alba,0,2,-2
2006,Teruel,44008,Albalate del Arzobispo,7,32,-25
2006,Teruel,44009,Albarracín,5,16,-11
2006,Teruel,44010,Albentosa,5,3,2
2006,Teruel,44012,Alcalá de la Selva,5,5,0
2006,Teruel,44013,Alcañiz,203,169,34
2006,Teruel,44014,Alcorisa,36,43,-7
2006,Teruel,44016,Alfambra,3,12,-9
2006,Teruel,44017,Aliaga,3,9,-6
2006,Teruel,44021,Allepuz,0,3,-3
2006,Teruel,44022,Alloza,4,10,-6
2006,Teruel,44023,Allueva,0,1,-1
2006,Teruel,44018,Almohaja,0,1,-1
2006,Teruel,44019,Alobras,0,2,-2
2006,Teruel,44025,Andorra,67,63,4
2006,Teruel,44026,Arcos de las Salinas,1,2,-1
2006,Teruel,44027,Arens de Lledó,0,4,-4
2006,Teruel,44028,Argente,0,3,-3
2006,Teruel,44029,Ariño,4,5,-1
2006,Teruel,44031,Azaila,1,5,-4
2006,Teruel,44035,Barrachina,0,3,-3
2006,Teruel,44034,Bañón,2,3,-1
2006,Teruel,44037,Beceite,3,10,-7
2006,Teruel,44039,Bello,0,7,-7
2006,Teruel,44038,Belmonte de San José,0,3,-3
2006,Teruel,44040,Berge,1,3,-2
2006,Teruel,44041,Bezas,0,1,-1
2006,Teruel,44042,Blancas,0,2,-2
2006,Teruel,44044,Bordón,0,4,-4
2006,Teruel,44045,Bronchales,1,6,-5
2006,Teruel,44046,Bueña,0,1,-1
2006,Teruel,44047,Burbáguena,0,12,-12
2006,Teruel,44033,Báguena,1,7,-6
2006,Teruel,44048,Cabra de Mora,0,1,-1
2006,Teruel,44049,Calaceite,5,19,-14
2006,Teruel,44050,Calamocha,38,48,-10
2006,Teruel,44051,Calanda,24,59,-35
2006,Teruel,44052,Calomarde,0,1,-1
2006,Teruel,44054,Camarena de la Sierra,0,2,-2
2006,Teruel,44055,Camarillas,1,1,0
2006,Teruel,44053,Camañas,0,1,-1
2006,Teruel,44056,Caminreal,2,11,-9
2006,Teruel,44059,Cantavieja,4,5,-1
2006,Teruel,44064,Cascante del Río,0,1,-1
2006,Teruel,44065,Castejón de Tornos,0,1,-1
2006,Teruel,44066,Castel de Cabra,0,4,-4
2006,Teruel,44071,Castellote,5,12,-7
2006,Teruel,44067,Castelnou,0,3,-3
2006,Teruel,44068,Castelserás,11,14,-3
2006,Teruel,44060,Cañada de Benatanduz,0,2,-2
2006,Teruel,44061,Cañada de Verich (La),0,1,-1
2006,Teruel,44062,Cañada Vellida,0,2,-2
2006,Teruel,44063,Cañizar del Olivar,0,1,-1
2006,Teruel,44074,Cedrillas,4,12,-8
2006,Teruel,44075,Celadas,2,8,-6
2006,Teruel,44076,Cella,24,28,-4
2006,Teruel,44077,Cerollera (La),1,2,-1
2006,Teruel,44080,Codoñera (La),1,3,-2
2006,Teruel,44082,Corbalán,0,0,0
2006,Teruel,44086,Cretas,5,10,-5
2006,Teruel,44087,Crivillén,0,4,-4
2006,Teruel,44088,Cuba (La),0,0,0
2006,Teruel,44090,Cucalón,2,0,2
2006,Teruel,44092,Cuervo (El),1,3,-2
2006,Teruel,44093,Cuevas de Almudén,2,1,1
2006,Teruel,44094,Cuevas Labradas,0,1,-1
2006,Teruel,44096,Ejulve,0,2,-2
2006,Teruel,44097,Escorihuela,0,4,-4
2006,Teruel,44099,Escucha,10,8,2
2006,Teruel,44100,Estercuel,0,5,-5
2006,Teruel,44101,Ferreruela de Huerva,0,2,-2
2006,Teruel,44103,Formiche Alto,1,1,0
2006,Teruel,44106,Fortanete,0,7,-7
2006,Teruel,44107,Foz-Calanda,0,3,-3
2006,Teruel,44108,Fresneda (La),3,4,-1
2006,Teruel,44109,Frías de Albarracín,0,1,-1
2006,Teruel,44110,Fuenferrada,0,1,-1
2006,Teruel,44111,Fuentes Calientes,0,1,-1
2006,Teruel,44112,Fuentes Claras,8,9,-1
2006,Teruel,44113,Fuentes de Rubielos,2,0,2
2006,Teruel,44114,Fuentespalda,2,4,-2
2006,Teruel,44105,Fórnoles,1,2,-1
2006,Teruel,44115,Galve,1,2,-1
2006,Teruel,44116,Gargallo,0,1,-1
2006,Teruel,44117,Gea de Albarracín,0,6,-6
2006,Teruel,44118,Ginebrosa (La),2,2,0
2006,Teruel,44119,Griegos,0,1,-1
2006,Teruel,44120,Guadalaviar,1,3,-2
2006,Teruel,44121,Gúdar,0,0,0
2006,Teruel,44123,Hinojosa de Jarque,0,3,-3
2006,Teruel,44124,Hoz de la Vieja (La),1,3,-2
2006,Teruel,44125,Huesa del Común,0,1,-1
2006,Teruel,44122,Híjar,19,22,-3
2006,Teruel,44126,Iglesuela del Cid (La),4,10,-6
2006,Teruel,44127,Jabaloyas,0,3,-3
2006,Teruel,44128,Jarque de la Val,0,2,-2
2006,Teruel,44129,Jatiel,0,2,-2
2006,Teruel,44131,Josa,1,1,0
2006,Teruel,44133,Lanzuela,0,2,-2
2006,Teruel,44135,Libros,0,2,-2
2006,Teruel,44136,Lidón,0,2,-2
2006,Teruel,44137,Linares de Mora,4,2,2
2006,Teruel,44141,Lledó,0,4,-4
2006,Teruel,44142,Maicas,0,1,-1
2006,Teruel,44143,Manzanera,6,7,-1
2006,Teruel,44144,Martín del Río,1,7,-6
2006,Teruel,44145,Mas de las Matas,10,17,-7
2006,Teruel,44146,Mata de los Olmos (La),0,1,-1
2006,Teruel,44147,Mazaleón,2,9,-7
2006,Teruel,44148,Mezquita de Jarque,1,3,-2
2006,Teruel,44149,Mirambel,1,2,-1
2006,Teruel,44151,Molinos,0,5,-5
2006,Teruel,44153,Monreal del Campo,22,31,-9
2006,Teruel,44154,Monroyo,5,6,-1
2006,Teruel,44155,Montalbán,9,21,-12
2006,Teruel,44156,Monteagudo del Castillo,0,1,-1
2006,Teruel,44158,Mora de Rubielos,13,18,-5
2006,Teruel,44159,Moscardón,0,1,-1
2006,Teruel,44160,Mosqueruela,7,4,3
2006,Teruel,44161,Muniesa,5,5,0
2006,Teruel,44163,Noguera de Albarracín,0,1,-1
2006,Teruel,44165,Nogueruelas,1,3,-2
2006,Teruel,44167,Obón,0,1,-1
2006,Teruel,44168,Odón,3,5,-2
2006,Teruel,44169,Ojos Negros,9,5,4
2006,Teruel,44171,Olba,0,2,-2
2006,Teruel,44172,Oliete,1,3,-2
2006,Teruel,44174,Orihuela del Tremedal,4,4,0
2006,Teruel,44175,Orrios,0,2,-2
2006,Teruel,44176,Palomar de Arroyos,0,3,-3
2006,Teruel,44177,Pancrudo,2,1,1
2006,Teruel,44178,Parras de Castellote (Las),1,0,1
2006,Teruel,44180,Peracense,0,1,-1
2006,Teruel,44181,Peralejos,0,1,-1
2006,Teruel,44182,Perales del Alfambra,3,4,-1
2006,Teruel,44179,Peñarroya de Tastavins,2,9,-7
2006,Teruel,44184,Plou,0,2,-2
2006,Teruel,44185,Pobo (El),1,1,0
2006,Teruel,44187,Portellada (La),2,7,-5
2006,Teruel,44189,Pozondón,0,2,-2
2006,Teruel,44190,Pozuel del Campo,0,1,-1
2006,Teruel,44191,Puebla de Híjar (La),6,18,-12
2006,Teruel,44192,Puebla de Valverde (La),4,5,-1
2006,Teruel,44193,Puertomingalvo,1,1,0
2006,Teruel,44195,Rillo,0,3,-3
2006,Teruel,44196,Riodeva,0,5,-5
2006,Teruel,44198,Royuela,2,5,-3
2006,Teruel,44199,Rubiales,0,1,-1
2006,Teruel,44201,Rubielos de Mora,7,4,3
2006,Teruel,44194,Ráfales,0,6,-6
2006,Teruel,44197,Ródenas,0,2,-2
2006,Teruel,44205,Samper de Calanda,5,19,-14
2006,Teruel,44206,San Agustín,0,1,-1
2006,Teruel,44207,San Martín del Río,0,3,-3
2006,Teruel,44208,Santa Cruz de Nogueras,0,1,-1
2006,Teruel,44209,Santa Eulalia,1,25,-24
2006,Teruel,44210,Sarrión,7,12,-5
2006,Teruel,44213,Singra,0,1,-1
2006,Teruel,44215,Terriente,0,4,-4
2006,Teruel,44216,Teruel,357,317,40
2006,Teruel,44217,Toril y Masegoso,0,2,-2
2006,Teruel,44219,Tornos,1,1,0
2006,Teruel,44220,Torralba de los Sisones,3,3,0
2006,Teruel,44223,Torre de Arcas,1,2,-1
2006,Teruel,44225,Torre del Compte,0,1,-1
2006,Teruel,44227,Torre los Negros,0,1,-1
2006,Teruel,44221,Torrecilla de Alcañiz,3,7,-4
2006,Teruel,44222,Torrecilla del Rebollar,1,2,-1
2006,Teruel,44226,Torrelacárcel,1,2,-1
2006,Teruel,44228,Torremocha de Jiloca,0,4,-4
2006,Teruel,44229,Torres de Albarracín,2,1,1
2006,Teruel,44230,Torrevelilla,1,3,-2
2006,Teruel,44232,Torrijo del Campo,2,7,-5
2006,Teruel,44234,Tramacastiel,0,3,-3
2006,Teruel,44235,Tramacastilla,3,1,2
2006,Teruel,44236,Tronchón,0,1,-1
2006,Teruel,44237,Urrea de Gaén,2,10,-8
2006,Teruel,44238,Utrillas,25,30,-5
2006,Teruel,44240,Valbona,1,2,-1
2006,Teruel,44241,Valdealgorfa,0,11,-11
2006,Teruel,44244,Valdelinares,0,1,-1
2006,Teruel,44245,Valdeltormo,0,1,-1
2006,Teruel,44246,Valderrobres,19,29,-10
2006,Teruel,44247,Valjunquera,2,4,-2
2006,Teruel,44249,Vallecillo (El),0,1,-1
2006,Teruel,44251,Villafranca del Campo,3,5,-2
2006,Teruel,44252,Villahermosa del Campo,0,3,-3
2006,Teruel,44257,Villar del Cobo,0,2,-2
2006,Teruel,44258,Villar del Salz,0,4,-4
2006,Teruel,44260,Villarluengo,1,4,-3
2006,Teruel,44261,Villarquemado,4,18,-14
2006,Teruel,44262,Villarroya de los Pinares,3,3,0
2006,Teruel,44263,Villastar,1,3,-2
2006,Teruel,44264,Villel,6,6,0
2006,Teruel,44265,Vinaceite,0,6,-6
2006,Teruel,44266,Visiedo,0,1,-1
2006,Teruel,44268,Zoma (La),0,1,-1
2006,Zaragoza,50001,Abanto,0,1,-1
2006,Zaragoza,50002,Acered,1,2,-1
2006,Zaragoza,50004,Aguarón,1,22,-21
2006,Zaragoza,50005,Aguilón,0,7,-7
2006,Zaragoza,50003,Agón,1,0,1
2006,Zaragoza,50006,Ainzón,8,19,-11
2006,Zaragoza,50007,Aladrén,1,0,1
2006,Zaragoza,50008,Alagón,73,74,-1
2006,Zaragoza,50009,Alarba,0,0,0
2006,Zaragoza,50011,Albeta,0,2,-2
2006,Zaragoza,50012,Alborge,0,2,-2
2006,Zaragoza,50013,Alcalá de Ebro,3,5,-2
2006,Zaragoza,50014,Alcalá de Moncayo,1,3,-2
2006,Zaragoza,50015,Alconchel de Ariza,0,0,0
2006,Zaragoza,50017,Alfajarín,17,19,-2
2006,Zaragoza,50018,Alfamén,9,18,-9
2006,Zaragoza,50020,Alhama de Aragón,19,13,6
2006,Zaragoza,50021,Almochuel,0,2,-2
2006,Zaragoza,50022,Almolda (La),5,8,-3
2006,Zaragoza,50023,Almonacid de la Cuba,0,4,-4
2006,Zaragoza,50024,Almonacid de la Sierra,2,17,-15
2006,Zaragoza,50025,Almunia de Doña Godina (La),99,79,20
2006,Zaragoza,50026,Alpartir,1,5,-4
2006,Zaragoza,50027,Ambel,2,5,-3
2006,Zaragoza,50029,Aniñón,1,14,-13
2006,Zaragoza,50031,Aranda de Moncayo,0,4,-4
2006,Zaragoza,50033,Ardisa,0,1,-1
2006,Zaragoza,50034,Ariza,12,21,-9
2006,Zaragoza,50035,Artieda,0,2,-2
2006,Zaragoza,50032,Arándiga,1,11,-10
2006,Zaragoza,50036,Asín,0,2,-2
2006,Zaragoza,50037,Atea,0,3,-3
2006,Zaragoza,50038,Ateca,16,26,-10
2006,Zaragoza,50039,Azuara,3,5,-2
2006,Zaragoza,50030,Añón de Moncayo,0,8,-8
2006,Zaragoza,50042,Balconchán,0,1,-1
2006,Zaragoza,50044,Bardallur,2,7,-5
2006,Zaragoza,50045,Belchite,14,23,-9
2006,Zaragoza,50046,Belmonte de Gracián,0,3,-3
2006,Zaragoza,50047,Berdejo,1,0,1
2006,Zaragoza,50901,Biel,2,3,-1
2006,Zaragoza,50050,Bijuesca,0,1,-1
2006,Zaragoza,50051,Biota,12,11,1
2006,Zaragoza,50052,Bisimbre,0,1,-1
2006,Zaragoza,50053,Boquiñeni,7,11,-4
2006,Zaragoza,50054,Bordalba,0,1,-1
2006,Zaragoza,50055,Borja,56,65,-9
2006,Zaragoza,50056,Botorrita,0,5,-5
2006,Zaragoza,50057,Brea de Aragón,24,21,3
2006,Zaragoza,50058,Bubierca,0,1,-1
2006,Zaragoza,50059,Bujaraloz,11,7,4
2006,Zaragoza,50060,Bulbuente,3,4,-1
2006,Zaragoza,50061,Bureta,2,5,-3
2006,Zaragoza,50062,Burgo de Ebro (El),22,9,13
2006,Zaragoza,50063,Buste (El),0,1,-1
2006,Zaragoza,50043,Bárboles,3,1,2
2006,Zaragoza,50064,Cabañas de Ebro,4,11,-7
2006,Zaragoza,50066,Cadrete,28,18,10
2006,Zaragoza,50067,Calatayud,182,233,-51
2006,Zaragoza,50068,Calatorao,26,35,-9
2006,Zaragoza,50070,Calmarza,0,0,0
2006,Zaragoza,50071,Campillo de Aragón,0,5,-5
2006,Zaragoza,50072,Carenas,1,5,-4
2006,Zaragoza,50073,Cariñena,19,40,-21
2006,Zaragoza,50074,Caspe,83,125,-42
2006,Zaragoza,50075,Castejón de Alarba,0,2,-2
2006,Zaragoza,50076,Castejón de las Armas,0,5,-5
2006,Zaragoza,50077,Castejón de Valdejasa,0,4,-4
2006,Zaragoza,50078,Castiliscar,2,1,1
2006,Zaragoza,50079,Cervera de la Cañada,0,6,-6
2006,Zaragoza,50080,Cerveruela,1,1,0
2006,Zaragoza,50081,Cetina,3,16,-13
2006,Zaragoza,50092,Chiprana,6,8,-2
2006,Zaragoza,50093,Chodes,0,2,-2
2006,Zaragoza,50082,Cimballa,0,1,-1
2006,Zaragoza,50083,Cinco Olivas,0,2,-2
2006,Zaragoza,50084,Clarés de Ribota,0,1,-1
2006,Zaragoza,50085,Codo,0,2,-2
2006,Zaragoza,50086,Codos,0,6,-6
2006,Zaragoza,50088,Cosuenda,5,3,2
2006,Zaragoza,50089,Cuarte de Huerva,75,28,47
2006,Zaragoza,50090,Cubel,1,6,-5
2006,Zaragoza,50091,Cuerlas (Las),0,3,-3
2006,Zaragoza,50094,Daroca,11,41,-30
2006,Zaragoza,50095,Ejea de los Caballeros,150,175,-25
2006,Zaragoza,50096,Embid de Ariza,0,1,-1
2006,Zaragoza,50098,Encinacorba,1,5,-4
2006,Zaragoza,50100,Erla,0,7,-7
2006,Zaragoza,50101,Escatrón,6,19,-13
2006,Zaragoza,50102,Fabara,6,9,-3
2006,Zaragoza,50104,Farlete,3,3,0
2006,Zaragoza,50106,Fayos (Los),0,5,-5
2006,Zaragoza,50105,Fayón,0,11,-11
2006,Zaragoza,50107,Figueruelas,13,16,-3
2006,Zaragoza,50109,Frago (El),0,1,-1
2006,Zaragoza,50110,Frasno (El),3,5,-2
2006,Zaragoza,50111,Fréscano,0,2,-2
2006,Zaragoza,50113,Fuendejalón,7,2,5
2006,Zaragoza,50114,Fuendetodos,1,2,-1
2006,Zaragoza,50115,Fuentes de Ebro,38,34,4
2006,Zaragoza,50116,Fuentes de Jiloca,1,10,-9
2006,Zaragoza,50117,Gallocanta,0,3,-3
2006,Zaragoza,50118,Gallur,17,21,-4
2006,Zaragoza,50119,Gelsa,5,13,-8
2006,Zaragoza,50120,Godojos,0,0,0
2006,Zaragoza,50121,Gotor,1,2,-1
2006,Zaragoza,50123,Grisén,3,9,-6
2006,Zaragoza,50124,Herrera de los Navarros,4,4,0
2006,Zaragoza,50125,Ibdes,6,7,-1
2006,Zaragoza,50126,Illueca,27,28,-1
2006,Zaragoza,50128,Isuerre,0,2,-2
2006,Zaragoza,50129,Jaraba,4,3,1
2006,Zaragoza,50130,Jarque de Moncayo,2,4,-2
2006,Zaragoza,50131,Jaulín,1,3,-2
2006,Zaragoza,50132,Joyosa (La),16,10,6
2006,Zaragoza,50133,Lagata,0,3,-3
2006,Zaragoza,50134,Langa del Castillo,0,7,-7
2006,Zaragoza,50137,Leciñena,8,17,-9
2006,Zaragoza,50139,Letux,1,12,-11
2006,Zaragoza,50140,Litago,0,2,-2
2006,Zaragoza,50141,Lituénigo,0,2,-2
2006,Zaragoza,50142,Lobera de Onsella,0,1,-1
2006,Zaragoza,50143,Longares,9,15,-6
2006,Zaragoza,50146,Lucena de Jalón,1,3,-2
2006,Zaragoza,50147,Luceni,7,12,-5
2006,Zaragoza,50148,Luesia,1,9,-8
2006,Zaragoza,50150,Lumpiaque,4,12,-8
2006,Zaragoza,50151,Luna,3,12,-9
2006,Zaragoza,50136,Lécera,4,12,-8
2006,Zaragoza,50152,Maella,0,15,-15
2006,Zaragoza,50153,Magallón,9,19,-10
2006,Zaragoza,50154,Mainar,2,3,-1
2006,Zaragoza,50156,Maleján,2,2,0
2006,Zaragoza,50160,Mallén,30,36,-6
2006,Zaragoza,50159,Maluenda,12,17,-5
2006,Zaragoza,50157,Malón,2,9,-7
2006,Zaragoza,50162,Mara,1,1,0
2006,Zaragoza,50902,Marracos,1,0,1
2006,Zaragoza,50163,María de Huerva,75,9,66
2006,Zaragoza,50164,Mediana de Aragón,4,12,-8
2006,Zaragoza,50165,Mequinenza,14,31,-17
2006,Zaragoza,50166,Mesones de Isuela,2,3,-1
2006,Zaragoza,50167,Mezalocha,0,4,-4
2006,Zaragoza,50168,Mianos,1,1,0
2006,Zaragoza,50169,Miedes de Aragón,1,7,-6
2006,Zaragoza,50170,Monegrillo,0,7,-7
2006,Zaragoza,50171,Moneva,0,1,-1
2006,Zaragoza,50172,Monreal de Ariza,0,2,-2
2006,Zaragoza,50173,Monterde,1,4,-3
2006,Zaragoza,50174,Montón,0,2,-2
2006,Zaragoza,50175,Morata de Jalón,11,13,-2
2006,Zaragoza,50176,Morata de Jiloca,1,2,-1
2006,Zaragoza,50178,Moros,1,4,-3
2006,Zaragoza,50177,Morés,2,5,-3
2006,Zaragoza,50179,Moyuela,3,2,1
2006,Zaragoza,50180,Mozota,0,1,-1
2006,Zaragoza,50181,Muel,9,17,-8
2006,Zaragoza,50182,Muela (La),38,18,20
2006,Zaragoza,50183,Munébrega,1,6,-5
2006,Zaragoza,50185,Murillo de Gállego,5,1,4
2006,Zaragoza,50186,Navardún,0,2,-2
2006,Zaragoza,50187,Nigüella,1,1,0
2006,Zaragoza,50188,Nombrevilla,0,1,-1
2006,Zaragoza,50189,Nonaspe,5,16,-11
2006,Zaragoza,50190,Novallas,6,11,-5
2006,Zaragoza,50191,Novillas,4,9,-5
2006,Zaragoza,50193,Nuez de Ebro,8,4,4
2006,Zaragoza,50192,Nuévalos,3,2,1
2006,Zaragoza,50195,Orcajo,0,1,-1
2006,Zaragoza,50196,Orera,0,6,-6
2006,Zaragoza,50197,Orés,1,4,-3
2006,Zaragoza,50199,Osera de Ebro,2,19,-17
2006,Zaragoza,50200,Paniza,3,10,-7
2006,Zaragoza,50201,Paracuellos de Jiloca,3,9,-6
2006,Zaragoza,50202,Paracuellos de la Ribera,1,5,-4
2006,Zaragoza,50203,Pastriz,15,7,8
2006,Zaragoza,50204,Pedrola,40,36,4
2006,Zaragoza,50205,Pedrosas (Las),0,2,-2
2006,Zaragoza,50206,Perdiguera,7,7,0
2006,Zaragoza,50207,Piedratajada,0,1,-1
2006,Zaragoza,50208,Pina de Ebro,21,32,-11
2006,Zaragoza,50209,Pinseque,38,44,-6
2006,Zaragoza,50210,Pintanos (Los),0,1,-1
2006,Zaragoza,50211,Plasencia de Jalón,3,8,-5
2006,Zaragoza,50212,Pleitas,0,1,-1
2006,Zaragoza,50213,Plenas,2,3,-1
2006,Zaragoza,50214,Pomer,0,2,-2
2006,Zaragoza,50216,Pozuelo de Aragón,2,2,0
2006,Zaragoza,50217,Pradilla de Ebro,2,5,-3
2006,Zaragoza,50218,Puebla de Albortón,1,2,-1
2006,Zaragoza,50219,Puebla de Alfindén (La),104,35,69
2006,Zaragoza,50222,Quinto,19,17,2
2006,Zaragoza,50223,Remolinos,12,20,-8
2006,Zaragoza,50224,Retascón,0,2,-2
2006,Zaragoza,50225,Ricla,34,36,-2
2006,Zaragoza,50227,Romanos,0,5,-5
2006,Zaragoza,50228,Rueda de Jalón,0,4,-4
2006,Zaragoza,50229,Ruesca,0,4,-4
2006,Zaragoza,50231,Salillas de Jalón,0,4,-4
2006,Zaragoza,50232,Salvatierra de Esca,1,3,-2
2006,Zaragoza,50234,San Martín de la Virgen de Moncayo,2,8,-6
2006,Zaragoza,50235,San Mateo de Gállego,23,25,-2
2006,Zaragoza,50236,Santa Cruz de Grío,0,4,-4
2006,Zaragoza,50238,Santa Eulalia de Gállego,0,2,-2
2006,Zaragoza,50239,Santed,1,2,-1
2006,Zaragoza,50241,Saviñán,8,13,-5
2006,Zaragoza,50242,Sediles,2,2,0
2006,Zaragoza,50243,Sestrica,1,5,-4
2006,Zaragoza,50244,Sierra de Luna,3,2,1
2006,Zaragoza,50245,Sigüés,1,3,-2
2006,Zaragoza,50246,Sisamón,0,1,-1
2006,Zaragoza,50247,Sobradiel,9,8,1
2006,Zaragoza,50248,Sos del Rey Católico,3,6,-3
2006,Zaragoza,50230,Sádaba,10,28,-18
2006,Zaragoza,50240,Sástago,2,6,-4
2006,Zaragoza,50249,Tabuenca,1,8,-7
2006,Zaragoza,50250,Talamantes,0,1,-1
2006,Zaragoza,50251,Tarazona,97,114,-17
2006,Zaragoza,50252,Tauste,74,79,-5
2006,Zaragoza,50253,Terrer,0,11,-11
2006,Zaragoza,50254,Tierga,1,3,-2
2006,Zaragoza,50255,Tobed,1,5,-4
2006,Zaragoza,50256,Torralba de los Frailes,0,1,-1
2006,Zaragoza,50257,Torralba de Ribota,1,0,1
2006,Zaragoza,50260,Torrelapaja,0,1,-1
2006,Zaragoza,50261,Torrellas,0,4,-4
2006,Zaragoza,50262,Torres de Berrellén,15,12,3
2006,Zaragoza,50263,Torrijo de la Cañada,1,8,-7
2006,Zaragoza,50264,Tosos,1,3,-2
2006,Zaragoza,50265,Trasmoz,0,3,-3
2006,Zaragoza,50266,Trasobares,0,4,-4
2006,Zaragoza,50267,Uncastillo,3,15,-12
2006,Zaragoza,50268,Undués de Lerda,0,0,0
2006,Zaragoza,50269,Urrea de Jalón,3,7,-4
2006,Zaragoza,50271,Used,1,2,-1
2006,Zaragoza,50272,Utebo,266,57,209
2006,Zaragoza,50274,Val de San Martín,1,0,1
2006,Zaragoza,50275,Valmadrid,0,1,-1
2006,Zaragoza,50276,Valpalmas,0,3,-3
2006,Zaragoza,50277,Valtorres,0,1,-1
2006,Zaragoza,50278,Velilla de Ebro,0,7,-7
2006,Zaragoza,50279,Velilla de Jiloca,0,3,-3
2006,Zaragoza,50280,Vera de Moncayo,1,3,-2
2006,Zaragoza,50281,Vierlas,0,1,-1
2006,Zaragoza,50283,Villadoz,0,1,-1
2006,Zaragoza,50284,Villafeliche,0,5,-5
2006,Zaragoza,50285,Villafranca de Ebro,6,13,-7
2006,Zaragoza,50286,Villalba de Perejil,0,2,-2
2006,Zaragoza,50287,Villalengua,3,7,-4
2006,Zaragoza,50903,Villamayor de Gállego,0,11,-11
2006,Zaragoza,50288,Villanueva de Gállego,62,39,23
2006,Zaragoza,50290,Villanueva de Huerva,2,6,-4
2006,Zaragoza,50289,Villanueva de Jiloca,0,2,-2
2006,Zaragoza,50292,Villarreal de Huerva,0,2,-2
2006,Zaragoza,50293,Villarroya de la Sierra,2,15,-13
2006,Zaragoza,50282,Vilueña (La),0,1,-1
2006,Zaragoza,50296,Zaida (La),1,6,-5
2006,Zaragoza,50297,Zaragoza,6708,5817,891
2006,Zaragoza,50298,Zuera,64,58,6
2006,Zaragoza,50099,Épila,54,59,-5
2005,Huesca,22001,Abiego,1,4,-3
2005,Huesca,22003,Adahuesca,4,3,1
2005,Huesca,22004,Agüero,0,4,-4
2005,Huesca,22007,Albalate de Cinca,11,13,-2
2005,Huesca,22008,Albalatillo,1,1,0
2005,Huesca,22009,Albelda,2,10,-8
2005,Huesca,22012,Albero Bajo,0,3,-3
2005,Huesca,22013,Alberuela de Tubo,0,4,-4
2005,Huesca,22014,Alcalá de Gurrea,1,4,-3
2005,Huesca,22015,Alcalá del Obispo,3,6,-3
2005,Huesca,22016,Alcampell,4,14,-10
2005,Huesca,22017,Alcolea de Cinca,10,6,4
2005,Huesca,22018,Alcubierre,2,4,-2
2005,Huesca,22019,Alerre,0,4,-4
2005,Huesca,22020,Alfántega,0,1,-1
2005,Huesca,22021,Almudévar,21,32,-11
2005,Huesca,22022,Almunia de San Juan,2,11,-9
2005,Huesca,22023,Almuniente,5,6,-1
2005,Huesca,22024,Alquézar,1,4,-3
2005,Huesca,22025,Altorricón,5,13,-8
2005,Huesca,22027,Angüés,1,9,-8
2005,Huesca,22028,Ansó,1,9,-8
2005,Huesca,22029,Antillón,2,0,2
2005,Huesca,22032,Aragüés del Puerto,1,4,-3
2005,Huesca,22036,Argavieso,1,1,0
2005,Huesca,22037,Arguis,0,1,-1
2005,Huesca,22035,Arén,2,6,-4
2005,Huesca,22039,Ayerbe,12,23,-11
2005,Huesca,22040,Azanuy-Alins,1,4,-3
2005,Huesca,22041,Azara,0,4,-4
2005,Huesca,22042,Azlor,0,2,-2
2005,Huesca,22907,Aínsa-Sobrarbe,14,20,-6
2005,Huesca,22006,Aísa,2,4,-2
2005,Huesca,22043,Baells,0,2,-2
2005,Huesca,22044,Bailo,0,3,-3
2005,Huesca,22045,Baldellou,0,4,-4
2005,Huesca,22046,Ballobar,4,13,-9
2005,Huesca,22047,Banastás,0,3,-3
2005,Huesca,22048,Barbastro,173,224,-51
2005,Huesca,22049,Barbués,0,2,-2
2005,Huesca,22050,Barbuñales,0,2,-2
2005,Huesca,22052,Belver de Cinca,13,19,-6
2005,Huesca,22053,Benabarre,4,26,-22
2005,Huesca,22054,Benasque,18,10,8
2005,Huesca,22246,Beranuy,0,3,-3
2005,Huesca,22055,Berbegal,0,7,-7
2005,Huesca,22057,Bielsa,5,9,-4
2005,Huesca,22058,Bierge,1,4,-3
2005,Huesca,22059,Biescas,7,25,-18
2005,Huesca,22060,Binaced,12,37,-25
2005,Huesca,22061,Binéfar,83,87,-4
2005,Huesca,22062,Bisaurri,2,3,-1
2005,Huesca,22064,Blecua y Torres,2,3,-1
2005,Huesca,22066,Boltaña,9,6,3
2005,Huesca,22067,Bonansa,1,2,-1
2005,Huesca,22069,Broto,3,4,-1
2005,Huesca,22051,Bárcabo,0,2,-2
2005,Huesca,22072,Caldearenas,0,1,-1
2005,Huesca,22074,Campo,1,1,0
2005,Huesca,22075,Camporrells,1,1,0
2005,Huesca,22076,Canal de Berdún,3,5,-2
2005,Huesca,22077,Candasnos,0,7,-7
2005,Huesca,22078,Canfranc,10,1,9
2005,Huesca,22079,Capdesaso,1,2,-1
2005,Huesca,22080,Capella,3,9,-6
2005,Huesca,22081,Casbas de Huesca,2,5,-3
2005,Huesca,22083,Castejón de Monegros,3,14,-11
2005,Huesca,22084,Castejón de Sos,8,9,-1
2005,Huesca,22082,Castejón del Puente,1,5,-4
2005,Huesca,22085,Castelflorite,1,3,-2
2005,Huesca,22086,Castiello de Jaca,4,3,1
2005,Huesca,22087,Castigaleu,0,2,-2
2005,Huesca,22088,Castillazuelo,4,3,1
2005,Huesca,22089,Castillonroy,2,2,0
2005,Huesca,22096,Chimillas,2,11,-9
2005,Huesca,22095,Chía,1,1,0
2005,Huesca,22090,Colungo,1,3,-2
2005,Huesca,22099,Esplús,4,4,0
2005,Huesca,22102,Estada,1,2,-1
2005,Huesca,22103,Estadilla,2,12,-10
2005,Huesca,22105,Estopiñán del Castillo,3,5,-2
2005,Huesca,22106,Fago,0,1,-1
2005,Huesca,22107,Fanlo,0,2,-2
2005,Huesca,22109,Fiscal,1,2,-1
2005,Huesca,22110,Fonz,5,24,-19
2005,Huesca,22111,Foradada del Toscar,0,3,-3
2005,Huesca,22112,Fraga,125,136,-11
2005,Huesca,22113,Fueva (La),4,7,-3
2005,Huesca,22114,Gistaín,0,3,-3
2005,Huesca,22115,Grado (El),1,8,-7
2005,Huesca,22117,Graus,26,55,-29
2005,Huesca,22116,Grañén,6,38,-32
2005,Huesca,22119,Gurrea de Gállego,12,19,-7
2005,Huesca,22122,Hoz de Jaca,1,1,0
2005,Huesca,22908,Hoz y Costeán,3,2,1
2005,Huesca,22124,Huerto,0,1,-1
2005,Huesca,22125,Huesca,480,497,-17
2005,Huesca,22126,Ibieca,0,4,-4
2005,Huesca,22127,Igriés,7,11,-4
2005,Huesca,22128,Ilche,3,2,1
2005,Huesca,22129,Isábena,3,3,0
2005,Huesca,22130,Jaca,120,134,-14
2005,Huesca,22131,Jasa,0,3,-3
2005,Huesca,22133,Labuerda,0,2,-2
2005,Huesca,22135,Laluenga,1,7,-6
2005,Huesca,22136,Lalueza,6,13,-7
2005,Huesca,22137,Lanaja,3,18,-15
2005,Huesca,22139,Laperdiguera,1,4,-3
2005,Huesca,22141,Lascellas-Ponzano,0,1,-1
2005,Huesca,22142,Lascuarre,0,2,-2
2005,Huesca,22143,Laspaúles,3,3,0
2005,Huesca,22144,Laspuña,2,4,-2
2005,Huesca,22149,Loarre,1,6,-5
2005,Huesca,22150,Loporzano,3,6,-3
2005,Huesca,22905,Lupiñén-Ortilla,0,7,-7
2005,Huesca,22155,Monesma y Cajigar,1,0,1
2005,Huesca,22156,Monflorite-Lascasas,1,1,0
2005,Huesca,22157,Montanuy,0,2,-2
2005,Huesca,22158,Monzón,171,157,14
2005,Huesca,22160,Naval,2,2,0
2005,Huesca,22162,Novales,0,2,-2
2005,Huesca,22163,Nueno,2,2,0
2005,Huesca,22165,Ontiñena,2,8,-6
2005,Huesca,22167,Osso de Cinca,3,6,-3
2005,Huesca,22168,Palo,0,3,-3
2005,Huesca,22170,Panticosa,8,7,1
2005,Huesca,22174,Peralta de Alcofea,1,9,-8
2005,Huesca,22175,Peralta de Calasanz,1,6,-5
2005,Huesca,22176,Peraltilla,0,4,-4
2005,Huesca,22177,Perarrúa,0,2,-2
2005,Huesca,22178,Pertusa,1,1,0
2005,Huesca,22172,Peñalba,4,4,0
2005,Huesca,22173,Peñas de Riglos (Las),1,3,-2
2005,Huesca,22181,Piracés,0,1,-1
2005,Huesca,22182,Plan,4,5,-1
2005,Huesca,22184,Poleñino,3,5,-2
2005,Huesca,22186,Pozán de Vero,0,6,-6
2005,Huesca,22187,Puebla de Castro (La),2,3,-1
2005,Huesca,22188,Puente de Montañana,0,3,-3
2005,Huesca,22902,Puente la Reina de Jaca,1,3,-2
2005,Huesca,22190,Pueyo de Araguás (El),1,2,-1
2005,Huesca,22193,Pueyo de Santa Cruz,2,2,0
2005,Huesca,22189,Puértolas,1,2,-1
2005,Huesca,22195,Quicena,0,4,-4
2005,Huesca,22197,Robres,0,13,-13
2005,Huesca,22199,Sabiñánigo,68,90,-22
2005,Huesca,22200,Sahún,0,4,-4
2005,Huesca,22201,Salas Altas,0,4,-4
2005,Huesca,22202,Salas Bajas,0,2,-2
2005,Huesca,22203,Salillas,2,2,0
2005,Huesca,22204,Sallent de Gállego,21,3,18
2005,Huesca,22205,San Esteban de Litera,0,15,-15
2005,Huesca,22207,San Juan de Plan,2,2,0
2005,Huesca,22903,San Miguel del Cinca,3,17,-14
2005,Huesca,22206,Sangarrén,2,4,-2
2005,Huesca,22208,Santa Cilia,0,3,-3
2005,Huesca,22209,Santa Cruz de la Serós,0,1,-1
2005,Huesca,22906,Santa María de Dulcis,0,4,-4
2005,Huesca,22212,Santaliestra y San Quílez,1,1,0
2005,Huesca,22213,Sariñena,43,46,-3
2005,Huesca,22214,Secastilla,1,3,-2
2005,Huesca,22215,Seira,2,2,0
2005,Huesca,22217,Sena,3,5,-2
2005,Huesca,22218,Senés de Alcubierre,0,1,-1
2005,Huesca,22220,Sesa,1,3,-2
2005,Huesca,22222,Siétamo,8,4,4
2005,Huesca,22223,Sopeira,0,1,-1
2005,Huesca,22904,Sotonera (La),8,17,-9
2005,Huesca,22225,Tamarite de Litera,31,70,-39
2005,Huesca,22226,Tardienta,3,19,-16
2005,Huesca,22227,Tella-Sin,3,6,-3
2005,Huesca,22228,Tierz,11,4,7
2005,Huesca,22229,Tolva,2,5,-3
2005,Huesca,22230,Torla-Ordesa,3,4,-1
2005,Huesca,22232,Torralba de Aragón,0,3,-3
2005,Huesca,22234,Torrente de Cinca,9,15,-6
2005,Huesca,22236,Torres de Barbués,1,7,-6
2005,Huesca,22239,Tramaced,1,0,1
2005,Huesca,22242,Valfarta,0,1,-1
2005,Huesca,22901,Valle de Hecho,5,15,-10
2005,Huesca,22244,Valle de Lierp,0,1,-1
2005,Huesca,22245,Velilla de Cinca,1,4,-3
2005,Huesca,22909,Vencillón,5,4,1
2005,Huesca,22248,Vicién,1,1,0
2005,Huesca,22249,Villanova,1,3,-2
2005,Huesca,22251,Villanueva de Sigena,3,13,-10
2005,Huesca,22250,Villanúa,4,4,0
2005,Huesca,22252,Yebra de Basa,1,1,0
2005,Huesca,22254,Zaidín,17,27,-10
2005,Teruel,44001,Ababuj,1,0,1
2005,Teruel,44002,Abejuela,1,0,1
2005,Teruel,44003,Aguatón,0,0,0
2005,Teruel,44004,Aguaviva,7,11,-4
2005,Teruel,44005,Aguilar del Alfambra,0,0,0
2005,Teruel,44006,Alacón,2,5,-3
2005,Teruel,44007,Alba,0,7,-7
2005,Teruel,44008,Albalate del Arzobispo,10,29,-19
2005,Teruel,44009,Albarracín,8,8,0
2005,Teruel,44010,Albentosa,2,3,-1
2005,Teruel,44011,Alcaine,1,3,-2
2005,Teruel,44012,Alcalá de la Selva,2,9,-7
2005,Teruel,44013,Alcañiz,199,153,46
2005,Teruel,44014,Alcorisa,35,39,-4
2005,Teruel,44016,Alfambra,4,19,-15
2005,Teruel,44017,Aliaga,5,7,-2
2005,Teruel,44021,Allepuz,2,2,0
2005,Teruel,44022,Alloza,3,7,-4
2005,Teruel,44019,Alobras,0,3,-3
2005,Teruel,44025,Andorra,51,74,-23
2005,Teruel,44026,Arcos de las Salinas,0,2,-2
2005,Teruel,44027,Arens de Lledó,2,1,1
2005,Teruel,44028,Argente,0,5,-5
2005,Teruel,44029,Ariño,2,5,-3
2005,Teruel,44031,Azaila,0,4,-4
2005,Teruel,44035,Barrachina,1,3,-2
2005,Teruel,44034,Bañón,0,2,-2
2005,Teruel,44037,Beceite,3,8,-5
2005,Teruel,44039,Bello,1,4,-3
2005,Teruel,44038,Belmonte de San José,0,1,-1
2005,Teruel,44040,Berge,2,5,-3
2005,Teruel,44041,Bezas,1,0,1
2005,Teruel,44043,Blesa,0,2,-2
2005,Teruel,44044,Bordón,1,0,1
2005,Teruel,44045,Bronchales,2,5,-3
2005,Teruel,44046,Bueña,0,4,-4
2005,Teruel,44047,Burbáguena,0,10,-10
2005,Teruel,44033,Báguena,2,7,-5
2005,Teruel,44048,Cabra de Mora,0,1,-1
2005,Teruel,44049,Calaceite,4,12,-8
2005,Teruel,44050,Calamocha,42,51,-9
2005,Teruel,44051,Calanda,22,50,-28
2005,Teruel,44052,Calomarde,0,0,0
2005,Teruel,44054,Camarena de la Sierra,0,2,-2
2005,Teruel,44055,Camarillas,0,1,-1
2005,Teruel,44053,Camañas,1,4,-3
2005,Teruel,44056,Caminreal,6,16,-10
2005,Teruel,44059,Cantavieja,5,7,-2
2005,Teruel,44064,Cascante del Río,1,0,1
2005,Teruel,44065,Castejón de Tornos,1,1,0
2005,Teruel,44066,Castel de Cabra,2,2,0
2005,Teruel,44070,Castellar (El),1,0,1
2005,Teruel,44071,Castellote,5,7,-2
2005,Teruel,44067,Castelnou,1,2,-1
2005,Teruel,44068,Castelserás,7,11,-4
2005,Teruel,44060,Cañada de Benatanduz,0,3,-3
2005,Teruel,44061,Cañada de Verich (La),0,1,-1
2005,Teruel,44063,Cañizar del Olivar,1,3,-2
2005,Teruel,44074,Cedrillas,8,5,3
2005,Teruel,44075,Celadas,3,6,-3
2005,Teruel,44076,Cella,30,35,-5
2005,Teruel,44080,Codoñera (La),2,2,0
2005,Teruel,44082,Corbalán,0,1,-1
2005,Teruel,44084,Cortes de Aragón,0,1,-1
2005,Teruel,44085,Cosa,0,1,-1
2005,Teruel,44086,Cretas,6,9,-3
2005,Teruel,44088,Cuba (La),1,2,-1
2005,Teruel,44089,Cubla,0,1,-1
2005,Teruel,44090,Cucalón,2,1,1
2005,Teruel,44093,Cuevas de Almudén,1,0,1
2005,Teruel,44094,Cuevas Labradas,0,5,-5
2005,Teruel,44096,Ejulve,2,1,1
2005,Teruel,44097,Escorihuela,0,4,-4
2005,Teruel,44099,Escucha,8,12,-4
2005,Teruel,44100,Estercuel,1,6,-5
2005,Teruel,44101,Ferreruela de Huerva,0,1,-1
2005,Teruel,44102,Fonfría,0,1,-1
2005,Teruel,44103,Formiche Alto,0,5,-5
2005,Teruel,44106,Fortanete,0,1,-1
2005,Teruel,44107,Foz-Calanda,3,5,-2
2005,Teruel,44108,Fresneda (La),3,10,-7
2005,Teruel,44109,Frías de Albarracín,1,3,-2
2005,Teruel,44110,Fuenferrada,0,1,-1
2005,Teruel,44111,Fuentes Calientes,1,4,-3
2005,Teruel,44112,Fuentes Claras,1,11,-10
2005,Teruel,44113,Fuentes de Rubielos,2,1,1
2005,Teruel,44114,Fuentespalda,1,10,-9
2005,Teruel,44115,Galve,1,5,-4
2005,Teruel,44116,Gargallo,2,3,-1
2005,Teruel,44117,Gea de Albarracín,0,7,-7
2005,Teruel,44118,Ginebrosa (La),1,5,-4
2005,Teruel,44119,Griegos,1,0,1
2005,Teruel,44120,Guadalaviar,2,4,-2
2005,Teruel,44121,Gúdar,1,2,-1
2005,Teruel,44123,Hinojosa de Jarque,0,6,-6
2005,Teruel,44124,Hoz de la Vieja (La),0,5,-5
2005,Teruel,44125,Huesa del Común,1,1,0
2005,Teruel,44122,Híjar,12,30,-18
2005,Teruel,44126,Iglesuela del Cid (La),3,6,-3
2005,Teruel,44127,Jabaloyas,0,1,-1
2005,Teruel,44128,Jarque de la Val,1,1,0
2005,Teruel,44129,Jatiel,0,1,-1
2005,Teruel,44130,Jorcas,0,1,-1
2005,Teruel,44131,Josa,0,1,-1
2005,Teruel,44132,Lagueruela,0,1,-1
2005,Teruel,44133,Lanzuela,0,1,-1
2005,Teruel,44137,Linares de Mora,0,7,-7
2005,Teruel,44141,Lledó,0,4,-4
2005,Teruel,44138,Loscos,0,8,-8
2005,Teruel,44142,Maicas,0,1,-1
2005,Teruel,44143,Manzanera,3,5,-2
2005,Teruel,44144,Martín del Río,4,5,-1
2005,Teruel,44145,Mas de las Matas,11,18,-7
2005,Teruel,44146,Mata de los Olmos (La),1,5,-4
2005,Teruel,44147,Mazaleón,3,8,-5
2005,Teruel,44148,Mezquita de Jarque,2,2,0
2005,Teruel,44149,Mirambel,0,5,-5
2005,Teruel,44151,Molinos,1,5,-4
2005,Teruel,44153,Monreal del Campo,18,24,-6
2005,Teruel,44154,Monroyo,4,10,-6
2005,Teruel,44155,Montalbán,6,9,-3
2005,Teruel,44156,Monteagudo del Castillo,0,1,-1
2005,Teruel,44157,Monterde de Albarracín,0,1,-1
2005,Teruel,44158,Mora de Rubielos,13,20,-7
2005,Teruel,44159,Moscardón,2,0,2
2005,Teruel,44160,Mosqueruela,5,7,-2
2005,Teruel,44161,Muniesa,2,11,-9
2005,Teruel,44163,Noguera de Albarracín,1,2,-1
2005,Teruel,44165,Nogueruelas,3,5,-2
2005,Teruel,44168,Odón,2,4,-2
2005,Teruel,44169,Ojos Negros,3,12,-9
2005,Teruel,44171,Olba,0,2,-2
2005,Teruel,44172,Oliete,2,11,-9
2005,Teruel,44174,Orihuela del Tremedal,2,9,-7
2005,Teruel,44175,Orrios,1,2,-1
2005,Teruel,44176,Palomar de Arroyos,1,3,-2
2005,Teruel,44177,Pancrudo,1,6,-5
2005,Teruel,44178,Parras de Castellote (Las),1,2,-1
2005,Teruel,44180,Peracense,0,3,-3
2005,Teruel,44181,Peralejos,0,4,-4
2005,Teruel,44182,Perales del Alfambra,0,5,-5
2005,Teruel,44179,Peñarroya de Tastavins,5,12,-7
2005,Teruel,44183,Pitarque,0,1,-1
2005,Teruel,44184,Plou,0,1,-1
2005,Teruel,44185,Pobo (El),0,1,-1
2005,Teruel,44187,Portellada (La),0,3,-3
2005,Teruel,44189,Pozondón,0,0,0
2005,Teruel,44190,Pozuel del Campo,0,2,-2
2005,Teruel,44191,Puebla de Híjar (La),12,14,-2
2005,Teruel,44192,Puebla de Valverde (La),4,11,-7
2005,Teruel,44193,Puertomingalvo,0,0,0
2005,Teruel,44195,Rillo,1,4,-3
2005,Teruel,44196,Riodeva,1,3,-2
2005,Teruel,44198,Royuela,0,2,-2
2005,Teruel,44199,Rubiales,0,1,-1
2005,Teruel,44201,Rubielos de Mora,5,8,-3
2005,Teruel,44194,Ráfales,0,4,-4
2005,Teruel,44197,Ródenas,0,2,-2
2005,Teruel,44204,Saldón,0,1,-1
2005,Teruel,44205,Samper de Calanda,6,12,-6
2005,Teruel,44206,San Agustín,0,2,-2
2005,Teruel,44207,San Martín del Río,2,4,-2
2005,Teruel,44208,Santa Cruz de Nogueras,0,1,-1
2005,Teruel,44209,Santa Eulalia,7,17,-10
2005,Teruel,44210,Sarrión,11,19,-8
2005,Teruel,44211,Segura de los Baños,0,1,-1
2005,Teruel,44212,Seno,0,1,-1
2005,Teruel,44213,Singra,0,2,-2
2005,Teruel,44215,Terriente,1,2,-1
2005,Teruel,44216,Teruel,346,339,7
2005,Teruel,44218,Tormón,0,1,-1
2005,Teruel,44219,Tornos,1,2,-1
2005,Teruel,44220,Torralba de los Sisones,0,1,-1
2005,Teruel,44223,Torre de Arcas,1,2,-1
2005,Teruel,44224,Torre de las Arcas,1,0,1
2005,Teruel,44225,Torre del Compte,0,4,-4
2005,Teruel,44227,Torre los Negros,1,0,1
2005,Teruel,44221,Torrecilla de Alcañiz,1,4,-3
2005,Teruel,44222,Torrecilla del Rebollar,0,3,-3
2005,Teruel,44226,Torrelacárcel,0,6,-6
2005,Teruel,44228,Torremocha de Jiloca,0,4,-4
2005,Teruel,44229,Torres de Albarracín,3,1,2
2005,Teruel,44230,Torrevelilla,2,2,0
2005,Teruel,44231,Torrijas,1,1,0
2005,Teruel,44232,Torrijo del Campo,2,9,-7
2005,Teruel,44234,Tramacastiel,0,2,-2
2005,Teruel,44235,Tramacastilla,0,4,-4
2005,Teruel,44237,Urrea de Gaén,1,8,-7
2005,Teruel,44238,Utrillas,10,33,-23
2005,Teruel,44239,Valacloche,0,1,-1
2005,Teruel,44240,Valbona,0,1,-1
2005,Teruel,44241,Valdealgorfa,3,11,-8
2005,Teruel,44245,Valdeltormo,2,2,0
2005,Teruel,44246,Valderrobres,23,27,-4
2005,Teruel,44247,Valjunquera,2,5,-3
2005,Teruel,44249,Vallecillo (El),0,1,-1
2005,Teruel,44251,Villafranca del Campo,2,10,-8
2005,Teruel,44252,Villahermosa del Campo,0,1,-1
2005,Teruel,44257,Villar del Cobo,1,4,-3
2005,Teruel,44258,Villar del Salz,0,2,-2
2005,Teruel,44260,Villarluengo,0,1,-1
2005,Teruel,44261,Villarquemado,4,16,-12
2005,Teruel,44262,Villarroya de los Pinares,1,1,0
2005,Teruel,44263,Villastar,2,4,-2
2005,Teruel,44264,Villel,3,8,-5
2005,Teruel,44265,Vinaceite,4,3,1
2005,Teruel,44266,Visiedo,0,7,-7
2005,Teruel,44267,Vivel del Río Martín,0,2,-2
2005,Teruel,44268,Zoma (La),0,1,-1
2005,Zaragoza,50001,Abanto,0,4,-4
2005,Zaragoza,50002,Acered,0,2,-2
2005,Zaragoza,50004,Aguarón,6,23,-17
2005,Zaragoza,50005,Aguilón,1,1,0
2005,Zaragoza,50003,Agón,0,4,-4
2005,Zaragoza,50006,Ainzón,6,18,-12
2005,Zaragoza,50008,Alagón,47,88,-41
2005,Zaragoza,50009,Alarba,1,3,-2
2005,Zaragoza,50010,Alberite de San Juan,1,1,0
2005,Zaragoza,50011,Albeta,1,3,-2
2005,Zaragoza,50013,Alcalá de Ebro,4,9,-5
2005,Zaragoza,50014,Alcalá de Moncayo,0,3,-3
2005,Zaragoza,50015,Alconchel de Ariza,0,1,-1
2005,Zaragoza,50016,Aldehuela de Liestos,0,1,-1
2005,Zaragoza,50017,Alfajarín,16,25,-9
2005,Zaragoza,50018,Alfamén,7,14,-7
2005,Zaragoza,50019,Alforque,0,1,-1
2005,Zaragoza,50020,Alhama de Aragón,6,17,-11
2005,Zaragoza,50021,Almochuel,0,2,-2
2005,Zaragoza,50022,Almolda (La),1,11,-10
2005,Zaragoza,50023,Almonacid de la Cuba,2,6,-4
2005,Zaragoza,50024,Almonacid de la Sierra,1,22,-21
2005,Zaragoza,50025,Almunia de Doña Godina (La),76,74,2
2005,Zaragoza,50026,Alpartir,4,10,-6
2005,Zaragoza,50027,Ambel,0,4,-4
2005,Zaragoza,50028,Anento,1,0,1
2005,Zaragoza,50029,Aniñón,4,10,-6
2005,Zaragoza,50031,Aranda de Moncayo,0,2,-2
2005,Zaragoza,50033,Ardisa,0,4,-4
2005,Zaragoza,50034,Ariza,12,25,-13
2005,Zaragoza,50035,Artieda,0,1,-1
2005,Zaragoza,50032,Arándiga,1,7,-6
2005,Zaragoza,50036,Asín,0,3,-3
2005,Zaragoza,50037,Atea,0,2,-2
2005,Zaragoza,50038,Ateca,15,25,-10
2005,Zaragoza,50039,Azuara,1,11,-10
2005,Zaragoza,50030,Añón de Moncayo,1,6,-5
2005,Zaragoza,50040,Badules,0,1,-1
2005,Zaragoza,50044,Bardallur,0,4,-4
2005,Zaragoza,50045,Belchite,6,28,-22
2005,Zaragoza,50046,Belmonte de Gracián,0,4,-4
2005,Zaragoza,50047,Berdejo,0,0,0
2005,Zaragoza,50901,Biel,0,5,-5
2005,Zaragoza,50050,Bijuesca,0,1,-1
2005,Zaragoza,50051,Biota,5,18,-13
2005,Zaragoza,50052,Bisimbre,0,3,-3
2005,Zaragoza,50053,Boquiñeni,2,11,-9
2005,Zaragoza,50054,Bordalba,0,1,-1
2005,Zaragoza,50055,Borja,44,68,-24
2005,Zaragoza,50056,Botorrita,5,3,2
2005,Zaragoza,50057,Brea de Aragón,14,15,-1
2005,Zaragoza,50058,Bubierca,0,1,-1
2005,Zaragoza,50059,Bujaraloz,10,11,-1
2005,Zaragoza,50060,Bulbuente,2,3,-1
2005,Zaragoza,50061,Bureta,0,8,-8
2005,Zaragoza,50062,Burgo de Ebro (El),25,12,13
2005,Zaragoza,50063,Buste (El),0,1,-1
2005,Zaragoza,50043,Bárboles,2,5,-3
2005,Zaragoza,50064,Cabañas de Ebro,3,3,0
2005,Zaragoza,50066,Cadrete,37,17,20
2005,Zaragoza,50067,Calatayud,173,228,-55
2005,Zaragoza,50068,Calatorao,39,40,-1
2005,Zaragoza,50069,Calcena,0,1,-1
2005,Zaragoza,50070,Calmarza,0,2,-2
2005,Zaragoza,50071,Campillo de Aragón,1,3,-2
2005,Zaragoza,50072,Carenas,0,3,-3
2005,Zaragoza,50073,Cariñena,30,39,-9
2005,Zaragoza,50074,Caspe,77,113,-36
2005,Zaragoza,50075,Castejón de Alarba,0,1,-1
2005,Zaragoza,50076,Castejón de las Armas,0,1,-1
2005,Zaragoza,50078,Castiliscar,0,4,-4
2005,Zaragoza,50079,Cervera de la Cañada,1,3,-2
2005,Zaragoza,50081,Cetina,6,9,-3
2005,Zaragoza,50092,Chiprana,1,7,-6
2005,Zaragoza,50093,Chodes,1,2,-1
2005,Zaragoza,50082,Cimballa,0,2,-2
2005,Zaragoza,50083,Cinco Olivas,0,0,0
2005,Zaragoza,50084,Clarés de Ribota,0,2,-2
2005,Zaragoza,50085,Codo,1,8,-7
2005,Zaragoza,50086,Codos,0,7,-7
2005,Zaragoza,50087,Contamina,0,2,-2
2005,Zaragoza,50088,Cosuenda,3,9,-6
2005,Zaragoza,50089,Cuarte de Huerva,63,24,39
2005,Zaragoza,50090,Cubel,0,0,0
2005,Zaragoza,50091,Cuerlas (Las),0,4,-4
2005,Zaragoza,50094,Daroca,15,31,-16
2005,Zaragoza,50095,Ejea de los Caballeros,153,183,-30
2005,Zaragoza,50096,Embid de Ariza,0,1,-1
2005,Zaragoza,50098,Encinacorba,2,2,0
2005,Zaragoza,50100,Erla,4,6,-2
2005,Zaragoza,50101,Escatrón,7,16,-9
2005,Zaragoza,50102,Fabara,6,18,-12
2005,Zaragoza,50104,Farlete,5,4,1
2005,Zaragoza,50106,Fayos (Los),1,3,-2
2005,Zaragoza,50105,Fayón,2,4,-2
2005,Zaragoza,50107,Figueruelas,14,15,-1
2005,Zaragoza,50110,Frasno (El),1,10,-9
2005,Zaragoza,50111,Fréscano,0,3,-3
2005,Zaragoza,50113,Fuendejalón,7,7,0
2005,Zaragoza,50114,Fuendetodos,0,2,-2
2005,Zaragoza,50115,Fuentes de Ebro,34,37,-3
2005,Zaragoza,50116,Fuentes de Jiloca,0,6,-6
2005,Zaragoza,50117,Gallocanta,0,3,-3
2005,Zaragoza,50118,Gallur,18,23,-5
2005,Zaragoza,50119,Gelsa,6,22,-16
2005,Zaragoza,50120,Godojos,0,2,-2
2005,Zaragoza,50121,Gotor,4,2,2
2005,Zaragoza,50123,Grisén,6,10,-4
2005,Zaragoza,50124,Herrera de los Navarros,3,10,-7
2005,Zaragoza,50125,Ibdes,4,12,-8
2005,Zaragoza,50126,Illueca,22,20,2
2005,Zaragoza,50128,Isuerre,0,1,-1
2005,Zaragoza,50129,Jaraba,3,1,2
2005,Zaragoza,50130,Jarque de Moncayo,0,2,-2
2005,Zaragoza,50131,Jaulín,0,3,-3
2005,Zaragoza,50132,Joyosa (La),16,7,9
2005,Zaragoza,50134,Langa del Castillo,0,2,-2
2005,Zaragoza,50135,Layana,0,0,0
2005,Zaragoza,50138,Lechón,0,1,-1
2005,Zaragoza,50137,Leciñena,9,12,-3
2005,Zaragoza,50139,Letux,2,10,-8
2005,Zaragoza,50140,Litago,1,5,-4
2005,Zaragoza,50141,Lituénigo,0,2,-2
2005,Zaragoza,50142,Lobera de Onsella,0,2,-2
2005,Zaragoza,50143,Longares,1,12,-11
2005,Zaragoza,50146,Lucena de Jalón,0,8,-8
2005,Zaragoza,50147,Luceni,9,12,-3
2005,Zaragoza,50148,Luesia,1,11,-10
2005,Zaragoza,50150,Lumpiaque,7,17,-10
2005,Zaragoza,50151,Luna,5,18,-13
2005,Zaragoza,50136,Lécera,3,16,-13
2005,Zaragoza,50152,Maella,5,17,-12
2005,Zaragoza,50153,Magallón,6,13,-7
2005,Zaragoza,50154,Mainar,0,3,-3
2005,Zaragoza,50155,Malanquilla,0,0,0
2005,Zaragoza,50156,Maleján,2,6,-4
2005,Zaragoza,50160,Mallén,16,36,-20
2005,Zaragoza,50159,Maluenda,6,16,-10
2005,Zaragoza,50157,Malón,2,6,-4
2005,Zaragoza,50161,Manchones,0,1,-1
2005,Zaragoza,50162,Mara,0,2,-2
2005,Zaragoza,50902,Marracos,0,1,-1
2005,Zaragoza,50163,María de Huerva,64,20,44
2005,Zaragoza,50164,Mediana de Aragón,3,10,-7
2005,Zaragoza,50165,Mequinenza,16,29,-13
2005,Zaragoza,50166,Mesones de Isuela,0,6,-6
2005,Zaragoza,50167,Mezalocha,0,3,-3
2005,Zaragoza,50169,Miedes de Aragón,3,8,-5
2005,Zaragoza,50170,Monegrillo,1,5,-4
2005,Zaragoza,50171,Moneva,0,1,-1
2005,Zaragoza,50172,Monreal de Ariza,0,2,-2
2005,Zaragoza,50173,Monterde,0,3,-3
2005,Zaragoza,50174,Montón,0,3,-3
2005,Zaragoza,50175,Morata de Jalón,6,32,-26
2005,Zaragoza,50176,Morata de Jiloca,0,6,-6
2005,Zaragoza,50178,Moros,0,8,-8
2005,Zaragoza,50177,Morés,6,7,-1
2005,Zaragoza,50179,Moyuela,1,6,-5
2005,Zaragoza,50180,Mozota,0,0,0
2005,Zaragoza,50181,Muel,7,20,-13
2005,Zaragoza,50182,Muela (La),33,18,15
2005,Zaragoza,50183,Munébrega,3,6,-3
2005,Zaragoza,50184,Murero,0,1,-1
2005,Zaragoza,50185,Murillo de Gállego,2,5,-3
2005,Zaragoza,50186,Navardún,0,1,-1
2005,Zaragoza,50187,Nigüella,0,1,-1
2005,Zaragoza,50189,Nonaspe,11,10,1
2005,Zaragoza,50190,Novallas,5,17,-12
2005,Zaragoza,50191,Novillas,3,9,-6
2005,Zaragoza,50193,Nuez de Ebro,7,8,-1
2005,Zaragoza,50192,Nuévalos,2,0,2
2005,Zaragoza,50194,Olvés,0,2,-2
2005,Zaragoza,50196,Orera,1,2,-1
2005,Zaragoza,50197,Orés,0,4,-4
2005,Zaragoza,50198,Oseja,1,0,1
2005,Zaragoza,50199,Osera de Ebro,3,19,-16
2005,Zaragoza,50200,Paniza,2,7,-5
2005,Zaragoza,50201,Paracuellos de Jiloca,6,8,-2
2005,Zaragoza,50202,Paracuellos de la Ribera,0,8,-8
2005,Zaragoza,50203,Pastriz,10,11,-1
2005,Zaragoza,50204,Pedrola,40,40,0
2005,Zaragoza,50205,Pedrosas (Las),0,1,-1
2005,Zaragoza,50206,Perdiguera,6,8,-2
2005,Zaragoza,50207,Piedratajada,1,1,0
2005,Zaragoza,50208,Pina de Ebro,27,19,8
2005,Zaragoza,50209,Pinseque,33,63,-30
2005,Zaragoza,50211,Plasencia de Jalón,2,4,-2
2005,Zaragoza,50213,Plenas,1,1,0
2005,Zaragoza,50214,Pomer,0,1,-1
2005,Zaragoza,50216,Pozuelo de Aragón,1,4,-3
2005,Zaragoza,50217,Pradilla de Ebro,2,8,-6
2005,Zaragoza,50218,Puebla de Albortón,1,1,0
2005,Zaragoza,50219,Puebla de Alfindén (La),104,29,75
2005,Zaragoza,50220,Puendeluna,0,1,-1
2005,Zaragoza,50222,Quinto,24,20,4
2005,Zaragoza,50223,Remolinos,7,15,-8
2005,Zaragoza,50225,Ricla,20,17,3
2005,Zaragoza,50227,Romanos,0,1,-1
2005,Zaragoza,50228,Rueda de Jalón,2,1,1
2005,Zaragoza,50231,Salillas de Jalón,2,8,-6
2005,Zaragoza,50232,Salvatierra de Esca,0,3,-3
2005,Zaragoza,50234,San Martín de la Virgen de Moncayo,1,3,-2
2005,Zaragoza,50235,San Mateo de Gállego,20,21,-1
2005,Zaragoza,50236,Santa Cruz de Grío,0,2,-2
2005,Zaragoza,50237,Santa Cruz de Moncayo,1,4,-3
2005,Zaragoza,50238,Santa Eulalia de Gállego,0,3,-3
2005,Zaragoza,50239,Santed,0,2,-2
2005,Zaragoza,50241,Saviñán,2,15,-13
2005,Zaragoza,50242,Sediles,1,3,-2
2005,Zaragoza,50243,Sestrica,5,6,-1
2005,Zaragoza,50244,Sierra de Luna,1,2,-1
2005,Zaragoza,50245,Sigüés,0,4,-4
2005,Zaragoza,50246,Sisamón,0,1,-1
2005,Zaragoza,50247,Sobradiel,12,14,-2
2005,Zaragoza,50248,Sos del Rey Católico,3,6,-3
2005,Zaragoza,50230,Sádaba,10,31,-21
2005,Zaragoza,50240,Sástago,1,9,-8
2005,Zaragoza,50249,Tabuenca,1,7,-6
2005,Zaragoza,50250,Talamantes,0,1,-1
2005,Zaragoza,50251,Tarazona,101,127,-26
2005,Zaragoza,50252,Tauste,70,90,-20
2005,Zaragoza,50253,Terrer,0,6,-6
2005,Zaragoza,50254,Tierga,0,6,-6
2005,Zaragoza,50255,Tobed,1,5,-4
2005,Zaragoza,50256,Torralba de los Frailes,0,2,-2
2005,Zaragoza,50257,Torralba de Ribota,0,3,-3
2005,Zaragoza,50258,Torralbilla,0,1,-1
2005,Zaragoza,50259,Torrehermosa,0,3,-3
2005,Zaragoza,50260,Torrelapaja,0,1,-1
2005,Zaragoza,50261,Torrellas,1,9,-8
2005,Zaragoza,50262,Torres de Berrellén,8,18,-10
2005,Zaragoza,50263,Torrijo de la Cañada,0,9,-9
2005,Zaragoza,50264,Tosos,0,2,-2
2005,Zaragoza,50265,Trasmoz,0,1,-1
2005,Zaragoza,50266,Trasobares,0,5,-5
2005,Zaragoza,50267,Uncastillo,6,14,-8
2005,Zaragoza,50268,Undués de Lerda,0,2,-2
2005,Zaragoza,50269,Urrea de Jalón,1,3,-2
2005,Zaragoza,50270,Urriés,0,1,-1
2005,Zaragoza,50271,Used,2,4,-2
2005,Zaragoza,50272,Utebo,197,75,122
2005,Zaragoza,50273,Valdehorna,0,1,-1
2005,Zaragoza,50276,Valpalmas,0,1,-1
2005,Zaragoza,50277,Valtorres,1,2,-1
2005,Zaragoza,50278,Velilla de Ebro,1,3,-2
2005,Zaragoza,50279,Velilla de Jiloca,0,1,-1
2005,Zaragoza,50280,Vera de Moncayo,2,11,-9
2005,Zaragoza,50281,Vierlas,0,2,-2
2005,Zaragoza,50283,Villadoz,1,0,1
2005,Zaragoza,50284,Villafeliche,0,3,-3
2005,Zaragoza,50285,Villafranca de Ebro,6,18,-12
2005,Zaragoza,50286,Villalba de Perejil,0,2,-2
2005,Zaragoza,50287,Villalengua,0,9,-9
2005,Zaragoza,50288,Villanueva de Gállego,48,31,17
2005,Zaragoza,50290,Villanueva de Huerva,1,5,-4
2005,Zaragoza,50289,Villanueva de Jiloca,0,0,0
2005,Zaragoza,50291,Villar de los Navarros,0,1,-1
2005,Zaragoza,50292,Villarreal de Huerva,1,4,-3
2005,Zaragoza,50293,Villarroya de la Sierra,2,17,-15
2005,Zaragoza,50282,Vilueña (La),0,4,-4
2005,Zaragoza,50295,Vistabella,0,1,-1
2005,Zaragoza,50296,Zaida (La),4,8,-4
2005,Zaragoza,50297,Zaragoza,6454,6173,281
2005,Zaragoza,50298,Zuera,51,68,-17
2005,Zaragoza,50099,Épila,52,48,4
2004,Huesca,22001,Abiego,2,7,-5
2004,Huesca,22002,Abizanda,0,1,-1
2004,Huesca,22003,Adahuesca,0,1,-1
2004,Huesca,22004,Agüero,0,2,-2
2004,Huesca,22007,Albalate de Cinca,8,13,-5
2004,Huesca,22008,Albalatillo,2,3,-1
2004,Huesca,22009,Albelda,4,13,-9
2004,Huesca,22011,Albero Alto,0,1,-1
2004,Huesca,22012,Albero Bajo,0,2,-2
2004,Huesca,22013,Alberuela de Tubo,0,3,-3
2004,Huesca,22014,Alcalá de Gurrea,1,8,-7
2004,Huesca,22015,Alcalá del Obispo,2,3,-1
2004,Huesca,22016,Alcampell,4,14,-10
2004,Huesca,22017,Alcolea de Cinca,8,13,-5
2004,Huesca,22018,Alcubierre,4,7,-3
2004,Huesca,22019,Alerre,0,1,-1
2004,Huesca,22020,Alfántega,2,3,-1
2004,Huesca,22021,Almudévar,19,31,-12
2004,Huesca,22022,Almunia de San Juan,2,12,-10
2004,Huesca,22023,Almuniente,3,4,-1
2004,Huesca,22024,Alquézar,2,2,0
2004,Huesca,22025,Altorricón,14,18,-4
2004,Huesca,22027,Angüés,1,14,-13
2004,Huesca,22028,Ansó,2,6,-4
2004,Huesca,22029,Antillón,1,4,-3
2004,Huesca,22032,Aragüés del Puerto,1,0,1
2004,Huesca,22036,Argavieso,0,2,-2
2004,Huesca,22037,Arguis,0,2,-2
2004,Huesca,22035,Arén,3,7,-4
2004,Huesca,22039,Ayerbe,8,12,-4
2004,Huesca,22040,Azanuy-Alins,2,5,-3
2004,Huesca,22041,Azara,3,1,2
2004,Huesca,22042,Azlor,2,2,0
2004,Huesca,22907,Aínsa-Sobrarbe,16,22,-6
2004,Huesca,22006,Aísa,1,2,-1
2004,Huesca,22043,Baells,0,8,-8
2004,Huesca,22044,Bailo,0,5,-5
2004,Huesca,22045,Baldellou,0,1,-1
2004,Huesca,22046,Ballobar,8,14,-6
2004,Huesca,22047,Banastás,4,4,0
2004,Huesca,22048,Barbastro,154,168,-14
2004,Huesca,22049,Barbués,2,0,2
2004,Huesca,22050,Barbuñales,0,3,-3
2004,Huesca,22052,Belver de Cinca,8,16,-8
2004,Huesca,22053,Benabarre,4,16,-12
2004,Huesca,22054,Benasque,31,13,18
2004,Huesca,22246,Beranuy,0,2,-2
2004,Huesca,22055,Berbegal,3,5,-2
2004,Huesca,22057,Bielsa,3,7,-4
2004,Huesca,22058,Bierge,0,3,-3
2004,Huesca,22059,Biescas,14,22,-8
2004,Huesca,22060,Binaced,13,24,-11
2004,Huesca,22061,Binéfar,81,104,-23
2004,Huesca,22062,Bisaurri,1,3,-2
2004,Huesca,22063,Biscarrués,0,8,-8
2004,Huesca,22064,Blecua y Torres,1,4,-3
2004,Huesca,22066,Boltaña,15,7,8
2004,Huesca,22067,Bonansa,0,2,-2
2004,Huesca,22069,Broto,9,5,4
2004,Huesca,22072,Caldearenas,0,3,-3
2004,Huesca,22074,Campo,0,2,-2
2004,Huesca,22075,Camporrells,4,4,0
2004,Huesca,22076,Canal de Berdún,3,5,-2
2004,Huesca,22077,Candasnos,2,10,-8
2004,Huesca,22078,Canfranc,6,4,2
2004,Huesca,22079,Capdesaso,0,1,-1
2004,Huesca,22080,Capella,1,10,-9
2004,Huesca,22081,Casbas de Huesca,1,5,-4
2004,Huesca,22083,Castejón de Monegros,2,11,-9
2004,Huesca,22084,Castejón de Sos,14,12,2
2004,Huesca,22082,Castejón del Puente,1,0,1
2004,Huesca,22085,Castelflorite,1,1,0
2004,Huesca,22086,Castiello de Jaca,0,0,0
2004,Huesca,22087,Castigaleu,1,2,-1
2004,Huesca,22088,Castillazuelo,0,4,-4
2004,Huesca,22089,Castillonroy,2,9,-7
2004,Huesca,22094,Chalamera,0,4,-4
2004,Huesca,22096,Chimillas,1,13,-12
2004,Huesca,22095,Chía,0,1,-1
2004,Huesca,22099,Esplús,5,6,-1
2004,Huesca,22102,Estada,1,3,-2
2004,Huesca,22103,Estadilla,8,8,0
2004,Huesca,22105,Estopiñán del Castillo,1,3,-2
2004,Huesca,22109,Fiscal,1,1,0
2004,Huesca,22110,Fonz,12,21,-9
2004,Huesca,22111,Foradada del Toscar,0,3,-3
2004,Huesca,22112,Fraga,141,120,21
2004,Huesca,22113,Fueva (La),2,11,-9
2004,Huesca,22114,Gistaín,3,2,1
2004,Huesca,22115,Grado (El),5,4,1
2004,Huesca,22117,Graus,27,63,-36
2004,Huesca,22116,Grañén,4,31,-27
2004,Huesca,22119,Gurrea de Gállego,12,21,-9
2004,Huesca,22122,Hoz de Jaca,1,0,1
2004,Huesca,22908,Hoz y Costeán,0,2,-2
2004,Huesca,22124,Huerto,2,2,0
2004,Huesca,22125,Huesca,502,491,11
2004,Huesca,22127,Igriés,3,6,-3
2004,Huesca,22128,Ilche,1,5,-4
2004,Huesca,22129,Isábena,1,5,-4
2004,Huesca,22130,Jaca,122,133,-11
2004,Huesca,22131,Jasa,0,1,-1
2004,Huesca,22133,Labuerda,0,1,-1
2004,Huesca,22135,Laluenga,1,3,-2
2004,Huesca,22136,Lalueza,4,16,-12
2004,Huesca,22137,Lanaja,5,21,-16
2004,Huesca,22141,Lascellas-Ponzano,2,2,0
2004,Huesca,22142,Lascuarre,3,6,-3
2004,Huesca,22143,Laspaúles,1,4,-3
2004,Huesca,22144,Laspuña,0,2,-2
2004,Huesca,22149,Loarre,4,2,2
2004,Huesca,22150,Loporzano,4,4,0
2004,Huesca,22151,Loscorrales,0,1,-1
2004,Huesca,22905,Lupiñén-Ortilla,4,1,3
2004,Huesca,22156,Monflorite-Lascasas,0,5,-5
2004,Huesca,22157,Montanuy,3,3,0
2004,Huesca,22158,Monzón,175,179,-4
2004,Huesca,22160,Naval,1,5,-4
2004,Huesca,22162,Novales,1,0,1
2004,Huesca,22163,Nueno,3,3,0
2004,Huesca,22164,Olvena,1,1,0
2004,Huesca,22165,Ontiñena,3,4,-1
2004,Huesca,22167,Osso de Cinca,5,4,1
2004,Huesca,22170,Panticosa,6,5,1
2004,Huesca,22174,Peralta de Alcofea,2,10,-8
2004,Huesca,22175,Peralta de Calasanz,1,8,-7
2004,Huesca,22177,Perarrúa,0,2,-2
2004,Huesca,22172,Peñalba,0,2,-2
2004,Huesca,22173,Peñas de Riglos (Las),2,3,-1
2004,Huesca,22182,Plan,5,2,3
2004,Huesca,22184,Poleñino,1,2,-1
2004,Huesca,22186,Pozán de Vero,2,4,-2
2004,Huesca,22187,Puebla de Castro (La),1,2,-1
2004,Huesca,22902,Puente la Reina de Jaca,2,3,-1
2004,Huesca,22190,Pueyo de Araguás (El),0,2,-2
2004,Huesca,22193,Pueyo de Santa Cruz,4,5,-1
2004,Huesca,22189,Puértolas,1,0,1
2004,Huesca,22195,Quicena,1,1,0
2004,Huesca,22197,Robres,2,10,-8
2004,Huesca,22199,Sabiñánigo,65,97,-32
2004,Huesca,22200,Sahún,0,4,-4
2004,Huesca,22201,Salas Altas,1,13,-12
2004,Huesca,22202,Salas Bajas,2,2,0
2004,Huesca,22203,Salillas,1,1,0
2004,Huesca,22204,Sallent de Gállego,19,9,10
2004,Huesca,22205,San Esteban de Litera,2,5,-3
2004,Huesca,22207,San Juan de Plan,0,3,-3
2004,Huesca,22903,San Miguel del Cinca,5,12,-7
2004,Huesca,22206,Sangarrén,1,6,-5
2004,Huesca,22208,Santa Cilia,0,3,-3
2004,Huesca,22209,Santa Cruz de la Serós,0,2,-2
2004,Huesca,22906,Santa María de Dulcis,1,2,-1
2004,Huesca,22212,Santaliestra y San Quílez,2,1,1
2004,Huesca,22213,Sariñena,30,51,-21
2004,Huesca,22214,Secastilla,0,8,-8
2004,Huesca,22215,Seira,0,2,-2
2004,Huesca,22217,Sena,5,6,-1
2004,Huesca,22218,Senés de Alcubierre,0,1,-1
2004,Huesca,22220,Sesa,2,7,-5
2004,Huesca,22221,Sesué,2,1,1
2004,Huesca,22222,Siétamo,7,4,3
2004,Huesca,22223,Sopeira,0,1,-1
2004,Huesca,22904,Sotonera (La),3,16,-13
2004,Huesca,22225,Tamarite de Litera,19,43,-24
2004,Huesca,22226,Tardienta,0,16,-16
2004,Huesca,22227,Tella-Sin,2,4,-2
2004,Huesca,22228,Tierz,8,4,4
2004,Huesca,22229,Tolva,0,3,-3
2004,Huesca,22230,Torla-Ordesa,4,1,3
2004,Huesca,22232,Torralba de Aragón,0,2,-2
2004,Huesca,22233,Torre la Ribera,0,0,0
2004,Huesca,22234,Torrente de Cinca,6,10,-4
2004,Huesca,22236,Torres de Barbués,0,5,-5
2004,Huesca,22239,Tramaced,1,0,1
2004,Huesca,22242,Valfarta,1,0,1
2004,Huesca,22243,Valle de Bardají,0,1,-1
2004,Huesca,22901,Valle de Hecho,6,14,-8
2004,Huesca,22245,Velilla de Cinca,5,5,0
2004,Huesca,22909,Vencillón,10,5,5
2004,Huesca,22247,Viacamp y Litera,1,0,1
2004,Huesca,22248,Vicién,0,1,-1
2004,Huesca,22249,Villanova,1,0,1
2004,Huesca,22251,Villanueva de Sigena,3,1,2
2004,Huesca,22250,Villanúa,2,1,1
2004,Huesca,22252,Yebra de Basa,0,1,-1
2004,Huesca,22254,Zaidín,12,13,-1
2004,Teruel,44001,Ababuj,0,1,-1
2004,Teruel,44003,Aguatón,0,1,-1
2004,Teruel,44004,Aguaviva,1,10,-9
2004,Teruel,44005,Aguilar del Alfambra,1,3,-2
2004,Teruel,44006,Alacón,3,9,-6
2004,Teruel,44007,Alba,2,6,-4
2004,Teruel,44008,Albalate del Arzobispo,11,38,-27
2004,Teruel,44009,Albarracín,9,7,2
2004,Teruel,44010,Albentosa,4,6,-2
2004,Teruel,44012,Alcalá de la Selva,2,3,-1
2004,Teruel,44013,Alcañiz,157,163,-6
2004,Teruel,44014,Alcorisa,30,42,-12
2004,Teruel,44016,Alfambra,3,14,-11
2004,Teruel,44017,Aliaga,0,6,-6
2004,Teruel,44021,Allepuz,0,6,-6
2004,Teruel,44022,Alloza,2,6,-4
2004,Teruel,44019,Alobras,1,0,1
2004,Teruel,44025,Andorra,67,61,6
2004,Teruel,44026,Arcos de las Salinas,0,1,-1
2004,Teruel,44027,Arens de Lledó,0,3,-3
2004,Teruel,44028,Argente,0,5,-5
2004,Teruel,44029,Ariño,7,14,-7
2004,Teruel,44031,Azaila,0,1,-1
2004,Teruel,44035,Barrachina,0,3,-3
2004,Teruel,44034,Bañón,1,0,1
2004,Teruel,44037,Beceite,2,9,-7
2004,Teruel,44039,Bello,2,9,-7
2004,Teruel,44038,Belmonte de San José,2,1,1
2004,Teruel,44040,Berge,2,2,0
2004,Teruel,44041,Bezas,0,1,-1
2004,Teruel,44042,Blancas,0,1,-1
2004,Teruel,44044,Bordón,1,0,1
2004,Teruel,44045,Bronchales,2,8,-6
2004,Teruel,44046,Bueña,0,1,-1
2004,Teruel,44047,Burbáguena,0,10,-10
2004,Teruel,44033,Báguena,0,12,-12
2004,Teruel,44048,Cabra de Mora,0,1,-1
2004,Teruel,44049,Calaceite,5,14,-9
2004,Teruel,44050,Calamocha,33,29,4
2004,Teruel,44051,Calanda,22,40,-18
2004,Teruel,44052,Calomarde,0,1,-1
2004,Teruel,44054,Camarena de la Sierra,1,2,-1
2004,Teruel,44055,Camarillas,0,1,-1
2004,Teruel,44056,Caminreal,2,9,-7
2004,Teruel,44059,Cantavieja,8,5,3
2004,Teruel,44064,Cascante del Río,0,5,-5
2004,Teruel,44065,Castejón de Tornos,0,2,-2
2004,Teruel,44066,Castel de Cabra,0,3,-3
2004,Teruel,44070,Castellar (El),0,1,-1
2004,Teruel,44071,Castellote,4,10,-6
2004,Teruel,44067,Castelnou,0,2,-2
2004,Teruel,44068,Castelserás,7,19,-12
2004,Teruel,44060,Cañada de Benatanduz,0,1,-1
2004,Teruel,44061,Cañada de Verich (La),2,0,2
2004,Teruel,44062,Cañada Vellida,0,3,-3
2004,Teruel,44063,Cañizar del Olivar,0,5,-5
2004,Teruel,44074,Cedrillas,3,14,-11
2004,Teruel,44075,Celadas,1,2,-1
2004,Teruel,44076,Cella,15,21,-6
2004,Teruel,44077,Cerollera (La),0,2,-2
2004,Teruel,44080,Codoñera (La),4,2,2
2004,Teruel,44082,Corbalán,0,1,-1
2004,Teruel,44084,Cortes de Aragón,0,5,-5
2004,Teruel,44085,Cosa,0,1,-1
2004,Teruel,44086,Cretas,6,10,-4
2004,Teruel,44089,Cubla,0,2,-2
2004,Teruel,44090,Cucalón,1,2,-1
2004,Teruel,44092,Cuervo (El),0,2,-2
2004,Teruel,44093,Cuevas de Almudén,1,2,-1
2004,Teruel,44094,Cuevas Labradas,1,3,-2
2004,Teruel,44096,Ejulve,2,2,0
2004,Teruel,44097,Escorihuela,0,6,-6
2004,Teruel,44099,Escucha,8,5,3
2004,Teruel,44100,Estercuel,0,6,-6
2004,Teruel,44101,Ferreruela de Huerva,0,1,-1
2004,Teruel,44102,Fonfría,0,1,-1
2004,Teruel,44103,Formiche Alto,4,2,2
2004,Teruel,44106,Fortanete,2,1,1
2004,Teruel,44107,Foz-Calanda,4,4,0
2004,Teruel,44108,Fresneda (La),4,6,-2
2004,Teruel,44109,Frías de Albarracín,1,3,-2
2004,Teruel,44110,Fuenferrada,0,2,-2
2004,Teruel,44111,Fuentes Calientes,0,2,-2
2004,Teruel,44112,Fuentes Claras,2,8,-6
2004,Teruel,44113,Fuentes de Rubielos,2,1,1
2004,Teruel,44114,Fuentespalda,3,3,0
2004,Teruel,44105,Fórnoles,1,1,0
2004,Teruel,44115,Galve,3,1,2
2004,Teruel,44116,Gargallo,0,2,-2
2004,Teruel,44117,Gea de Albarracín,3,4,-1
2004,Teruel,44118,Ginebrosa (La),1,7,-6
2004,Teruel,44119,Griegos,1,2,-1
2004,Teruel,44120,Guadalaviar,3,5,-2
2004,Teruel,44121,Gúdar,2,0,2
2004,Teruel,44123,Hinojosa de Jarque,1,5,-4
2004,Teruel,44125,Huesa del Común,0,2,-2
2004,Teruel,44122,Híjar,10,27,-17
2004,Teruel,44126,Iglesuela del Cid (La),4,5,-1
2004,Teruel,44127,Jabaloyas,0,2,-2
2004,Teruel,44128,Jarque de la Val,0,1,-1
2004,Teruel,44129,Jatiel,0,2,-2
2004,Teruel,44130,Jorcas,0,1,-1
2004,Teruel,44131,Josa,0,1,-1
2004,Teruel,44133,Lanzuela,0,1,-1
2004,Teruel,44135,Libros,0,5,-5
2004,Teruel,44136,Lidón,1,3,-2
2004,Teruel,44137,Linares de Mora,0,4,-4
2004,Teruel,44141,Lledó,0,1,-1
2004,Teruel,44138,Loscos,0,1,-1
2004,Teruel,44143,Manzanera,7,5,2
2004,Teruel,44144,Martín del Río,3,3,0
2004,Teruel,44145,Mas de las Matas,9,22,-13
2004,Teruel,44146,Mata de los Olmos (La),0,3,-3
2004,Teruel,44147,Mazaleón,7,4,3
2004,Teruel,44148,Mezquita de Jarque,1,1,0
2004,Teruel,44149,Mirambel,0,0,0
2004,Teruel,44150,Miravete de la Sierra,0,2,-2
2004,Teruel,44151,Molinos,1,4,-3
2004,Teruel,44153,Monreal del Campo,22,24,-2
2004,Teruel,44154,Monroyo,1,2,-1
2004,Teruel,44155,Montalbán,8,14,-6
2004,Teruel,44158,Mora de Rubielos,7,13,-6
2004,Teruel,44160,Mosqueruela,9,7,2
2004,Teruel,44161,Muniesa,3,6,-3
2004,Teruel,44163,Noguera de Albarracín,0,2,-2
2004,Teruel,44165,Nogueruelas,0,9,-9
2004,Teruel,44168,Odón,1,3,-2
2004,Teruel,44169,Ojos Negros,3,7,-4
2004,Teruel,44171,Olba,1,2,-1
2004,Teruel,44172,Oliete,1,8,-7
2004,Teruel,44173,Olmos (Los),1,0,1
2004,Teruel,44174,Orihuela del Tremedal,2,5,-3
2004,Teruel,44175,Orrios,0,5,-5
2004,Teruel,44177,Pancrudo,1,2,-1
2004,Teruel,44178,Parras de Castellote (Las),0,5,-5
2004,Teruel,44180,Peracense,0,3,-3
2004,Teruel,44181,Peralejos,0,1,-1
2004,Teruel,44182,Perales del Alfambra,1,4,-3
2004,Teruel,44179,Peñarroya de Tastavins,0,3,-3
2004,Teruel,44183,Pitarque,0,2,-2
2004,Teruel,44184,Plou,0,2,-2
2004,Teruel,44185,Pobo (El),0,2,-2
2004,Teruel,44187,Portellada (La),0,2,-2
2004,Teruel,44189,Pozondón,0,4,-4
2004,Teruel,44190,Pozuel del Campo,0,5,-5
2004,Teruel,44191,Puebla de Híjar (La),6,15,-9
2004,Teruel,44192,Puebla de Valverde (La),6,8,-2
2004,Teruel,44193,Puertomingalvo,2,4,-2
2004,Teruel,44195,Rillo,0,5,-5
2004,Teruel,44196,Riodeva,0,6,-6
2004,Teruel,44198,Royuela,2,5,-3
2004,Teruel,44199,Rubiales,0,1,-1
2004,Teruel,44201,Rubielos de Mora,5,7,-2
2004,Teruel,44194,Ráfales,0,9,-9
2004,Teruel,44197,Ródenas,0,2,-2
2004,Teruel,44204,Saldón,0,2,-2
2004,Teruel,44205,Samper de Calanda,7,16,-9
2004,Teruel,44206,San Agustín,2,1,1
2004,Teruel,44207,San Martín del Río,0,2,-2
2004,Teruel,44209,Santa Eulalia,4,20,-16
2004,Teruel,44210,Sarrión,5,15,-10
2004,Teruel,44211,Segura de los Baños,0,1,-1
2004,Teruel,44212,Seno,0,0,0
2004,Teruel,44215,Terriente,0,3,-3
2004,Teruel,44216,Teruel,367,324,43
2004,Teruel,44219,Tornos,1,7,-6
2004,Teruel,44220,Torralba de los Sisones,0,1,-1
2004,Teruel,44225,Torre del Compte,1,1,0
2004,Teruel,44227,Torre los Negros,0,0,0
2004,Teruel,44221,Torrecilla de Alcañiz,2,8,-6
2004,Teruel,44222,Torrecilla del Rebollar,0,4,-4
2004,Teruel,44226,Torrelacárcel,2,5,-3
2004,Teruel,44228,Torremocha de Jiloca,0,2,-2
2004,Teruel,44229,Torres de Albarracín,1,1,0
2004,Teruel,44230,Torrevelilla,0,3,-3
2004,Teruel,44231,Torrijas,0,1,-1
2004,Teruel,44232,Torrijo del Campo,1,8,-7
2004,Teruel,44234,Tramacastiel,0,2,-2
2004,Teruel,44235,Tramacastilla,0,1,-1
2004,Teruel,44236,Tronchón,0,1,-1
2004,Teruel,44237,Urrea de Gaén,1,5,-4
2004,Teruel,44238,Utrillas,42,23,19
2004,Teruel,44239,Valacloche,0,1,-1
2004,Teruel,44240,Valbona,2,3,-1
2004,Teruel,44241,Valdealgorfa,4,7,-3
2004,Teruel,44243,Valdecuenca,0,1,-1
2004,Teruel,44244,Valdelinares,0,2,-2
2004,Teruel,44245,Valdeltormo,0,7,-7
2004,Teruel,44246,Valderrobres,21,27,-6
2004,Teruel,44247,Valjunquera,1,6,-5
2004,Teruel,44250,Veguillas de la Sierra,0,2,-2
2004,Teruel,44251,Villafranca del Campo,1,4,-3
2004,Teruel,44252,Villahermosa del Campo,0,1,-1
2004,Teruel,44256,Villanueva del Rebollar de la Sierra,1,2,-1
2004,Teruel,44257,Villar del Cobo,0,2,-2
2004,Teruel,44258,Villar del Salz,0,1,-1
2004,Teruel,44260,Villarluengo,1,3,-2
2004,Teruel,44261,Villarquemado,6,19,-13
2004,Teruel,44262,Villarroya de los Pinares,1,2,-1
2004,Teruel,44263,Villastar,2,4,-2
2004,Teruel,44264,Villel,1,8,-7
2004,Teruel,44265,Vinaceite,0,2,-2
2004,Teruel,44266,Visiedo,0,5,-5
2004,Teruel,44267,Vivel del Río Martín,1,0,1
2004,Zaragoza,50001,Abanto,0,5,-5
2004,Zaragoza,50002,Acered,0,4,-4
2004,Zaragoza,50004,Aguarón,0,18,-18
2004,Zaragoza,50005,Aguilón,2,1,1
2004,Zaragoza,50003,Agón,1,4,-3
2004,Zaragoza,50006,Ainzón,8,19,-11
2004,Zaragoza,50007,Aladrén,1,0,1
2004,Zaragoza,50008,Alagón,61,68,-7
2004,Zaragoza,50009,Alarba,4,3,1
2004,Zaragoza,50010,Alberite de San Juan,0,2,-2
2004,Zaragoza,50011,Albeta,0,3,-3
2004,Zaragoza,50013,Alcalá de Ebro,1,5,-4
2004,Zaragoza,50015,Alconchel de Ariza,1,4,-3
2004,Zaragoza,50016,Aldehuela de Liestos,0,1,-1
2004,Zaragoza,50017,Alfajarín,15,13,2
2004,Zaragoza,50018,Alfamén,12,19,-7
2004,Zaragoza,50019,Alforque,1,1,0
2004,Zaragoza,50020,Alhama de Aragón,7,15,-8
2004,Zaragoza,50021,Almochuel,0,1,-1
2004,Zaragoza,50022,Almolda (La),0,7,-7
2004,Zaragoza,50023,Almonacid de la Cuba,2,5,-3
2004,Zaragoza,50024,Almonacid de la Sierra,4,19,-15
2004,Zaragoza,50025,Almunia de Doña Godina (La),83,74,9
2004,Zaragoza,50026,Alpartir,2,11,-9
2004,Zaragoza,50027,Ambel,4,7,-3
2004,Zaragoza,50028,Anento,1,0,1
2004,Zaragoza,50029,Aniñón,3,9,-6
2004,Zaragoza,50031,Aranda de Moncayo,0,7,-7
2004,Zaragoza,50033,Ardisa,0,1,-1
2004,Zaragoza,50034,Ariza,10,18,-8
2004,Zaragoza,50035,Artieda,1,0,1
2004,Zaragoza,50032,Arándiga,2,7,-5
2004,Zaragoza,50037,Atea,0,3,-3
2004,Zaragoza,50038,Ateca,12,28,-16
2004,Zaragoza,50039,Azuara,1,8,-7
2004,Zaragoza,50030,Añón de Moncayo,0,7,-7
2004,Zaragoza,50040,Badules,0,2,-2
2004,Zaragoza,50042,Balconchán,0,2,-2
2004,Zaragoza,50044,Bardallur,1,3,-2
2004,Zaragoza,50045,Belchite,13,19,-6
2004,Zaragoza,50046,Belmonte de Gracián,1,8,-7
2004,Zaragoza,50047,Berdejo,1,0,1
2004,Zaragoza,50048,Berrueco,0,3,-3
2004,Zaragoza,50901,Biel,0,4,-4
2004,Zaragoza,50051,Biota,8,14,-6
2004,Zaragoza,50052,Bisimbre,0,3,-3
2004,Zaragoza,50053,Boquiñeni,1,7,-6
2004,Zaragoza,50055,Borja,51,64,-13
2004,Zaragoza,50056,Botorrita,0,3,-3
2004,Zaragoza,50057,Brea de Aragón,10,16,-6
2004,Zaragoza,50058,Bubierca,0,2,-2
2004,Zaragoza,50059,Bujaraloz,11,11,0
2004,Zaragoza,50060,Bulbuente,2,4,-2
2004,Zaragoza,50061,Bureta,1,9,-8
2004,Zaragoza,50062,Burgo de Ebro (El),15,17,-2
2004,Zaragoza,50063,Buste (El),1,3,-2
2004,Zaragoza,50043,Bárboles,0,6,-6
2004,Zaragoza,50064,Cabañas de Ebro,4,6,-2
2004,Zaragoza,50065,Cabolafuente,0,1,-1
2004,Zaragoza,50066,Cadrete,36,10,26
2004,Zaragoza,50067,Calatayud,179,214,-35
2004,Zaragoza,50068,Calatorao,20,35,-15
2004,Zaragoza,50069,Calcena,0,1,-1
2004,Zaragoza,50070,Calmarza,1,3,-2
2004,Zaragoza,50071,Campillo de Aragón,2,3,-1
2004,Zaragoza,50072,Carenas,1,4,-3
2004,Zaragoza,50073,Cariñena,28,30,-2
2004,Zaragoza,50074,Caspe,83,101,-18
2004,Zaragoza,50075,Castejón de Alarba,0,3,-3
2004,Zaragoza,50076,Castejón de las Armas,0,1,-1
2004,Zaragoza,50077,Castejón de Valdejasa,0,10,-10
2004,Zaragoza,50078,Castiliscar,0,10,-10
2004,Zaragoza,50079,Cervera de la Cañada,1,2,-1
2004,Zaragoza,50080,Cerveruela,1,0,1
2004,Zaragoza,50081,Cetina,2,9,-7
2004,Zaragoza,50092,Chiprana,4,1,3
2004,Zaragoza,50093,Chodes,0,1,-1
2004,Zaragoza,50083,Cinco Olivas,0,1,-1
2004,Zaragoza,50084,Clarés de Ribota,1,1,0
2004,Zaragoza,50085,Codo,1,5,-4
2004,Zaragoza,50086,Codos,0,5,-5
2004,Zaragoza,50087,Contamina,0,1,-1
2004,Zaragoza,50088,Cosuenda,1,6,-5
2004,Zaragoza,50089,Cuarte de Huerva,49,21,28
2004,Zaragoza,50090,Cubel,2,3,-1
2004,Zaragoza,50091,Cuerlas (Las),0,1,-1
2004,Zaragoza,50094,Daroca,15,36,-21
2004,Zaragoza,50095,Ejea de los Caballeros,137,168,-31
2004,Zaragoza,50098,Encinacorba,0,4,-4
2004,Zaragoza,50100,Erla,0,6,-6
2004,Zaragoza,50101,Escatrón,5,19,-14
2004,Zaragoza,50102,Fabara,5,18,-13
2004,Zaragoza,50104,Farlete,3,3,0
2004,Zaragoza,50106,Fayos (Los),0,2,-2
2004,Zaragoza,50105,Fayón,3,9,-6
2004,Zaragoza,50107,Figueruelas,10,18,-8
2004,Zaragoza,50109,Frago (El),0,3,-3
2004,Zaragoza,50110,Frasno (El),0,10,-10
2004,Zaragoza,50111,Fréscano,1,2,-1
2004,Zaragoza,50113,Fuendejalón,5,17,-12
2004,Zaragoza,50114,Fuendetodos,0,5,-5
2004,Zaragoza,50115,Fuentes de Ebro,39,38,1
2004,Zaragoza,50116,Fuentes de Jiloca,0,4,-4
2004,Zaragoza,50117,Gallocanta,0,2,-2
2004,Zaragoza,50118,Gallur,24,44,-20
2004,Zaragoza,50119,Gelsa,8,17,-9
2004,Zaragoza,50121,Gotor,2,5,-3
2004,Zaragoza,50122,Grisel,0,1,-1
2004,Zaragoza,50123,Grisén,2,6,-4
2004,Zaragoza,50124,Herrera de los Navarros,4,13,-9
2004,Zaragoza,50125,Ibdes,4,10,-6
2004,Zaragoza,50126,Illueca,29,29,0
2004,Zaragoza,50128,Isuerre,1,1,0
2004,Zaragoza,50129,Jaraba,1,4,-3
2004,Zaragoza,50130,Jarque de Moncayo,1,7,-6
2004,Zaragoza,50131,Jaulín,2,4,-2
2004,Zaragoza,50132,Joyosa (La),10,6,4
2004,Zaragoza,50133,Lagata,1,1,0
2004,Zaragoza,50134,Langa del Castillo,0,1,-1
2004,Zaragoza,50135,Layana,1,0,1
2004,Zaragoza,50137,Leciñena,12,10,2
2004,Zaragoza,50139,Letux,3,8,-5
2004,Zaragoza,50140,Litago,0,3,-3
2004,Zaragoza,50141,Lituénigo,1,3,-2
2004,Zaragoza,50142,Lobera de Onsella,1,0,1
2004,Zaragoza,50143,Longares,6,15,-9
2004,Zaragoza,50146,Lucena de Jalón,2,1,1
2004,Zaragoza,50147,Luceni,4,14,-10
2004,Zaragoza,50148,Luesia,3,3,0
2004,Zaragoza,50150,Lumpiaque,8,12,-4
2004,Zaragoza,50151,Luna,3,15,-12
2004,Zaragoza,50136,Lécera,2,11,-9
2004,Zaragoza,50152,Maella,15,32,-17
2004,Zaragoza,50153,Magallón,7,18,-11
2004,Zaragoza,50154,Mainar,2,1,1
2004,Zaragoza,50155,Malanquilla,0,2,-2
2004,Zaragoza,50156,Maleján,1,6,-5
2004,Zaragoza,50160,Mallén,17,37,-20
2004,Zaragoza,50159,Maluenda,7,18,-11
2004,Zaragoza,50157,Malón,4,6,-2
2004,Zaragoza,50161,Manchones,1,4,-3
2004,Zaragoza,50162,Mara,1,3,-2
2004,Zaragoza,50902,Marracos,0,1,-1
2004,Zaragoza,50163,María de Huerva,43,18,25
2004,Zaragoza,50164,Mediana de Aragón,1,10,-9
2004,Zaragoza,50165,Mequinenza,15,41,-26
2004,Zaragoza,50166,Mesones de Isuela,0,5,-5
2004,Zaragoza,50167,Mezalocha,0,6,-6
2004,Zaragoza,50169,Miedes de Aragón,2,11,-9
2004,Zaragoza,50170,Monegrillo,5,3,2
2004,Zaragoza,50171,Moneva,0,2,-2
2004,Zaragoza,50172,Monreal de Ariza,0,7,-7
2004,Zaragoza,50173,Monterde,1,5,-4
2004,Zaragoza,50174,Montón,0,1,-1
2004,Zaragoza,50175,Morata de Jalón,8,18,-10
2004,Zaragoza,50176,Morata de Jiloca,0,3,-3
2004,Zaragoza,50178,Moros,2,7,-5
2004,Zaragoza,50177,Morés,1,4,-3
2004,Zaragoza,50179,Moyuela,1,10,-9
2004,Zaragoza,50180,Mozota,1,1,0
2004,Zaragoza,50181,Muel,10,17,-7
2004,Zaragoza,50182,Muela (La),27,20,7
2004,Zaragoza,50183,Munébrega,3,4,-1
2004,Zaragoza,50184,Murero,0,2,-2
2004,Zaragoza,50185,Murillo de Gállego,0,2,-2
2004,Zaragoza,50186,Navardún,0,2,-2
2004,Zaragoza,50189,Nonaspe,5,18,-13
2004,Zaragoza,50190,Novallas,2,13,-11
2004,Zaragoza,50191,Novillas,4,16,-12
2004,Zaragoza,50193,Nuez de Ebro,5,4,1
2004,Zaragoza,50192,Nuévalos,5,2,3
2004,Zaragoza,50194,Olvés,0,2,-2
2004,Zaragoza,50196,Orera,1,2,-1
2004,Zaragoza,50197,Orés,0,1,-1
2004,Zaragoza,50199,Osera de Ebro,4,21,-17
2004,Zaragoza,50200,Paniza,2,7,-5
2004,Zaragoza,50201,Paracuellos de Jiloca,2,5,-3
2004,Zaragoza,50202,Paracuellos de la Ribera,1,3,-2
2004,Zaragoza,50203,Pastriz,17,17,0
2004,Zaragoza,50204,Pedrola,28,30,-2
2004,Zaragoza,50205,Pedrosas (Las),0,1,-1
2004,Zaragoza,50206,Perdiguera,7,7,0
2004,Zaragoza,50208,Pina de Ebro,32,29,3
2004,Zaragoza,50209,Pinseque,30,64,-34
2004,Zaragoza,50211,Plasencia de Jalón,1,4,-3
2004,Zaragoza,50212,Pleitas,0,1,-1
2004,Zaragoza,50213,Plenas,0,4,-4
2004,Zaragoza,50214,Pomer,0,1,-1
2004,Zaragoza,50216,Pozuelo de Aragón,1,2,-1
2004,Zaragoza,50217,Pradilla de Ebro,8,11,-3
2004,Zaragoza,50218,Puebla de Albortón,1,1,0
2004,Zaragoza,50219,Puebla de Alfindén (La),78,24,54
2004,Zaragoza,50221,Purujosa,0,1,-1
2004,Zaragoza,50222,Quinto,8,25,-17
2004,Zaragoza,50223,Remolinos,6,14,-8
2004,Zaragoza,50225,Ricla,12,23,-11
2004,Zaragoza,50227,Romanos,0,2,-2
2004,Zaragoza,50228,Rueda de Jalón,2,7,-5
2004,Zaragoza,50229,Ruesca,0,1,-1
2004,Zaragoza,50231,Salillas de Jalón,2,2,0
2004,Zaragoza,50232,Salvatierra de Esca,1,9,-8
2004,Zaragoza,50233,Samper del Salz,1,2,-1
2004,Zaragoza,50234,San Martín de la Virgen de Moncayo,1,4,-3
2004,Zaragoza,50235,San Mateo de Gállego,23,22,1
2004,Zaragoza,50236,Santa Cruz de Grío,0,5,-5
2004,Zaragoza,50237,Santa Cruz de Moncayo,1,0,1
2004,Zaragoza,50238,Santa Eulalia de Gállego,0,3,-3
2004,Zaragoza,50239,Santed,1,1,0
2004,Zaragoza,50241,Saviñán,1,4,-3
2004,Zaragoza,50242,Sediles,1,4,-3
2004,Zaragoza,50243,Sestrica,2,7,-5
2004,Zaragoza,50244,Sierra de Luna,2,3,-1
2004,Zaragoza,50245,Sigüés,1,2,-1
2004,Zaragoza,50247,Sobradiel,9,5,4
2004,Zaragoza,50248,Sos del Rey Católico,3,4,-1
2004,Zaragoza,50230,Sádaba,4,32,-28
2004,Zaragoza,50240,Sástago,0,6,-6
2004,Zaragoza,50249,Tabuenca,3,4,-1
2004,Zaragoza,50251,Tarazona,90,145,-55
2004,Zaragoza,50252,Tauste,63,78,-15
2004,Zaragoza,50253,Terrer,1,9,-8
2004,Zaragoza,50254,Tierga,3,5,-2
2004,Zaragoza,50255,Tobed,0,4,-4
2004,Zaragoza,50256,Torralba de los Frailes,0,2,-2
2004,Zaragoza,50257,Torralba de Ribota,0,4,-4
2004,Zaragoza,50258,Torralbilla,0,1,-1
2004,Zaragoza,50259,Torrehermosa,0,2,-2
2004,Zaragoza,50260,Torrelapaja,0,1,-1
2004,Zaragoza,50261,Torrellas,2,4,-2
2004,Zaragoza,50262,Torres de Berrellén,7,15,-8
2004,Zaragoza,50263,Torrijo de la Cañada,0,4,-4
2004,Zaragoza,50264,Tosos,0,1,-1
2004,Zaragoza,50265,Trasmoz,0,1,-1
2004,Zaragoza,50266,Trasobares,1,5,-4
2004,Zaragoza,50267,Uncastillo,5,15,-10
2004,Zaragoza,50268,Undués de Lerda,1,0,1
2004,Zaragoza,50269,Urrea de Jalón,1,6,-5
2004,Zaragoza,50270,Urriés,0,2,-2
2004,Zaragoza,50271,Used,3,4,-1
2004,Zaragoza,50272,Utebo,213,55,158
2004,Zaragoza,50273,Valdehorna,0,1,-1
2004,Zaragoza,50276,Valpalmas,0,1,-1
2004,Zaragoza,50277,Valtorres,1,2,-1
2004,Zaragoza,50278,Velilla de Ebro,2,5,-3
2004,Zaragoza,50279,Velilla de Jiloca,0,0,0
2004,Zaragoza,50280,Vera de Moncayo,4,5,-1
2004,Zaragoza,50283,Villadoz,0,1,-1
2004,Zaragoza,50284,Villafeliche,0,4,-4
2004,Zaragoza,50285,Villafranca de Ebro,4,14,-10
2004,Zaragoza,50286,Villalba de Perejil,0,0,0
2004,Zaragoza,50287,Villalengua,1,4,-3
2004,Zaragoza,50288,Villanueva de Gállego,47,33,14
2004,Zaragoza,50290,Villanueva de Huerva,1,8,-7
2004,Zaragoza,50289,Villanueva de Jiloca,0,1,-1
2004,Zaragoza,50291,Villar de los Navarros,0,2,-2
2004,Zaragoza,50292,Villarreal de Huerva,1,1,0
2004,Zaragoza,50293,Villarroya de la Sierra,3,13,-10
2004,Zaragoza,50294,Villarroya del Campo,0,1,-1
2004,Zaragoza,50295,Vistabella,0,1,-1
2004,Zaragoza,50296,Zaida (La),2,8,-6
2004,Zaragoza,50297,Zaragoza,6357,6008,349
2004,Zaragoza,50298,Zuera,46,58,-12
2004,Zaragoza,50099,Épila,59,60,-1
2003,Huesca,22001,Abiego,2,8,-6
2003,Huesca,22002,Abizanda,0,5,-5
2003,Huesca,22003,Adahuesca,2,3,-1
2003,Huesca,22004,Agüero,0,7,-7
2003,Huesca,22007,Albalate de Cinca,5,12,-7
2003,Huesca,22008,Albalatillo,1,3,-2
2003,Huesca,22009,Albelda,6,17,-11
2003,Huesca,22011,Albero Alto,3,2,1
2003,Huesca,22012,Albero Bajo,0,1,-1
2003,Huesca,22013,Alberuela de Tubo,1,3,-2
2003,Huesca,22014,Alcalá de Gurrea,0,6,-6
2003,Huesca,22015,Alcalá del Obispo,2,2,0
2003,Huesca,22016,Alcampell,3,16,-13
2003,Huesca,22017,Alcolea de Cinca,11,11,0
2003,Huesca,22018,Alcubierre,1,5,-4
2003,Huesca,22019,Alerre,0,1,-1
2003,Huesca,22020,Alfántega,0,2,-2
2003,Huesca,22021,Almudévar,14,34,-20
2003,Huesca,22022,Almunia de San Juan,3,10,-7
2003,Huesca,22023,Almuniente,4,11,-7
2003,Huesca,22024,Alquézar,1,5,-4
2003,Huesca,22025,Altorricón,8,18,-10
2003,Huesca,22027,Angüés,2,11,-9
2003,Huesca,22028,Ansó,1,5,-4
2003,Huesca,22029,Antillón,0,2,-2
2003,Huesca,22032,Aragüés del Puerto,1,1,0
2003,Huesca,22036,Argavieso,0,3,-3
2003,Huesca,22035,Arén,3,6,-3
2003,Huesca,22039,Ayerbe,6,18,-12
2003,Huesca,22040,Azanuy-Alins,0,3,-3
2003,Huesca,22041,Azara,0,5,-5
2003,Huesca,22042,Azlor,0,6,-6
2003,Huesca,22907,Aínsa-Sobrarbe,12,25,-13
2003,Huesca,22006,Aísa,4,1,3
2003,Huesca,22043,Baells,0,2,-2
2003,Huesca,22044,Bailo,2,3,-1
2003,Huesca,22045,Baldellou,0,2,-2
2003,Huesca,22046,Ballobar,8,12,-4
2003,Huesca,22047,Banastás,1,2,-1
2003,Huesca,22048,Barbastro,119,192,-73
2003,Huesca,22049,Barbués,0,5,-5
2003,Huesca,22050,Barbuñales,1,1,0
2003,Huesca,22052,Belver de Cinca,12,15,-3
2003,Huesca,22053,Benabarre,10,22,-12
2003,Huesca,22054,Benasque,17,10,7
2003,Huesca,22246,Beranuy,0,5,-5
2003,Huesca,22055,Berbegal,2,5,-3
2003,Huesca,22057,Bielsa,3,7,-4
2003,Huesca,22058,Bierge,0,1,-1
2003,Huesca,22059,Biescas,11,16,-5
2003,Huesca,22060,Binaced,13,14,-1
2003,Huesca,22061,Binéfar,72,92,-20
2003,Huesca,22062,Bisaurri,2,3,-1
2003,Huesca,22063,Biscarrués,1,4,-3
2003,Huesca,22064,Blecua y Torres,1,3,-2
2003,Huesca,22066,Boltaña,7,9,-2
2003,Huesca,22067,Bonansa,0,1,-1
2003,Huesca,22068,Borau,0,1,-1
2003,Huesca,22069,Broto,1,7,-6
2003,Huesca,22051,Bárcabo,0,1,-1
2003,Huesca,22072,Caldearenas,0,3,-3
2003,Huesca,22074,Campo,0,3,-3
2003,Huesca,22075,Camporrells,0,7,-7
2003,Huesca,22076,Canal de Berdún,2,6,-4
2003,Huesca,22077,Candasnos,2,5,-3
2003,Huesca,22078,Canfranc,5,6,-1
2003,Huesca,22079,Capdesaso,0,6,-6
2003,Huesca,22080,Capella,3,8,-5
2003,Huesca,22081,Casbas de Huesca,2,4,-2
2003,Huesca,22083,Castejón de Monegros,2,4,-2
2003,Huesca,22084,Castejón de Sos,5,1,4
2003,Huesca,22082,Castejón del Puente,0,4,-4
2003,Huesca,22085,Castelflorite,0,2,-2
2003,Huesca,22086,Castiello de Jaca,0,1,-1
2003,Huesca,22087,Castigaleu,0,1,-1
2003,Huesca,22088,Castillazuelo,4,6,-2
2003,Huesca,22089,Castillonroy,1,4,-3
2003,Huesca,22096,Chimillas,3,7,-4
2003,Huesca,22095,Chía,0,1,-1
2003,Huesca,22090,Colungo,1,3,-2
2003,Huesca,22099,Esplús,2,9,-7
2003,Huesca,22103,Estadilla,6,16,-10
2003,Huesca,22105,Estopiñán del Castillo,2,1,1
2003,Huesca,22107,Fanlo,1,0,1
2003,Huesca,22109,Fiscal,2,1,1
2003,Huesca,22110,Fonz,2,19,-17
2003,Huesca,22111,Foradada del Toscar,0,2,-2
2003,Huesca,22112,Fraga,140,138,2
2003,Huesca,22113,Fueva (La),2,16,-14
2003,Huesca,22114,Gistaín,1,4,-3
2003,Huesca,22115,Grado (El),2,12,-10
2003,Huesca,22117,Graus,26,54,-28
2003,Huesca,22116,Grañén,9,33,-24
2003,Huesca,22119,Gurrea de Gállego,8,25,-17
2003,Huesca,22122,Hoz de Jaca,0,1,-1
2003,Huesca,22908,Hoz y Costeán,1,2,-1
2003,Huesca,22124,Huerto,0,1,-1
2003,Huesca,22125,Huesca,491,530,-39
2003,Huesca,22126,Ibieca,0,1,-1
2003,Huesca,22127,Igriés,1,8,-7
2003,Huesca,22128,Ilche,0,0,0
2003,Huesca,22129,Isábena,0,6,-6
2003,Huesca,22130,Jaca,112,135,-23
2003,Huesca,22131,Jasa,0,2,-2
2003,Huesca,22133,Labuerda,2,1,1
2003,Huesca,22135,Laluenga,2,6,-4
2003,Huesca,22136,Lalueza,4,13,-9
2003,Huesca,22137,Lanaja,8,20,-12
2003,Huesca,22139,Laperdiguera,1,2,-1
2003,Huesca,22141,Lascellas-Ponzano,0,3,-3
2003,Huesca,22142,Lascuarre,0,3,-3
2003,Huesca,22143,Laspaúles,2,5,-3
2003,Huesca,22144,Laspuña,0,4,-4
2003,Huesca,22149,Loarre,1,3,-2
2003,Huesca,22150,Loporzano,1,7,-6
2003,Huesca,22151,Loscorrales,0,2,-2
2003,Huesca,22905,Lupiñén-Ortilla,0,1,-1
2003,Huesca,22155,Monesma y Cajigar,0,1,-1
2003,Huesca,22156,Monflorite-Lascasas,1,1,0
2003,Huesca,22157,Montanuy,1,0,1
2003,Huesca,22158,Monzón,154,162,-8
2003,Huesca,22160,Naval,3,3,0
2003,Huesca,22162,Novales,1,1,0
2003,Huesca,22163,Nueno,7,3,4
2003,Huesca,22164,Olvena,0,0,0
2003,Huesca,22165,Ontiñena,1,15,-14
2003,Huesca,22167,Osso de Cinca,4,6,-2
2003,Huesca,22168,Palo,0,2,-2
2003,Huesca,22170,Panticosa,4,9,-5
2003,Huesca,22174,Peralta de Alcofea,2,10,-8
2003,Huesca,22175,Peralta de Calasanz,0,6,-6
2003,Huesca,22177,Perarrúa,0,5,-5
2003,Huesca,22178,Pertusa,2,4,-2
2003,Huesca,22172,Peñalba,0,1,-1
2003,Huesca,22173,Peñas de Riglos (Las),1,3,-2
2003,Huesca,22182,Plan,0,5,-5
2003,Huesca,22184,Poleñino,1,3,-2
2003,Huesca,22186,Pozán de Vero,0,4,-4
2003,Huesca,22187,Puebla de Castro (La),1,3,-2
2003,Huesca,22188,Puente de Montañana,0,1,-1
2003,Huesca,22902,Puente la Reina de Jaca,0,4,-4
2003,Huesca,22190,Pueyo de Araguás (El),1,1,0
2003,Huesca,22193,Pueyo de Santa Cruz,1,1,0
2003,Huesca,22189,Puértolas,1,1,0
2003,Huesca,22195,Quicena,0,4,-4
2003,Huesca,22197,Robres,2,4,-2
2003,Huesca,22199,Sabiñánigo,62,81,-19
2003,Huesca,22200,Sahún,2,2,0
2003,Huesca,22201,Salas Altas,0,5,-5
2003,Huesca,22202,Salas Bajas,1,4,-3
2003,Huesca,22204,Sallent de Gállego,9,9,0
2003,Huesca,22205,San Esteban de Litera,1,10,-9
2003,Huesca,22207,San Juan de Plan,0,2,-2
2003,Huesca,22903,San Miguel del Cinca,10,16,-6
2003,Huesca,22206,Sangarrén,0,5,-5
2003,Huesca,22906,Santa María de Dulcis,0,1,-1
2003,Huesca,22212,Santaliestra y San Quílez,1,2,-1
2003,Huesca,22213,Sariñena,30,52,-22
2003,Huesca,22214,Secastilla,0,1,-1
2003,Huesca,22215,Seira,0,5,-5
2003,Huesca,22217,Sena,5,14,-9
2003,Huesca,22218,Senés de Alcubierre,0,2,-2
2003,Huesca,22220,Sesa,0,1,-1
2003,Huesca,22221,Sesué,1,0,1
2003,Huesca,22222,Siétamo,5,4,1
2003,Huesca,22223,Sopeira,1,1,0
2003,Huesca,22904,Sotonera (La),7,18,-11
2003,Huesca,22225,Tamarite de Litera,25,54,-29
2003,Huesca,22226,Tardienta,9,13,-4
2003,Huesca,22227,Tella-Sin,0,2,-2
2003,Huesca,22228,Tierz,0,1,-1
2003,Huesca,22229,Tolva,1,3,-2
2003,Huesca,22230,Torla-Ordesa,2,8,-6
2003,Huesca,22233,Torre la Ribera,0,1,-1
2003,Huesca,22234,Torrente de Cinca,7,18,-11
2003,Huesca,22235,Torres de Alcanadre,2,3,-1
2003,Huesca,22236,Torres de Barbués,0,4,-4
2003,Huesca,22239,Tramaced,1,2,-1
2003,Huesca,22242,Valfarta,0,1,-1
2003,Huesca,22901,Valle de Hecho,12,16,-4
2003,Huesca,22245,Velilla de Cinca,3,5,-2
2003,Huesca,22909,Vencillón,5,6,-1
2003,Huesca,22247,Viacamp y Litera,0,1,-1
2003,Huesca,22248,Vicién,1,2,-1
2003,Huesca,22249,Villanova,2,1,1
2003,Huesca,22251,Villanueva de Sigena,4,6,-2
2003,Huesca,22250,Villanúa,2,4,-2
2003,Huesca,22252,Yebra de Basa,0,0,0
2003,Huesca,22254,Zaidín,15,19,-4
2003,Teruel,44001,Ababuj,0,1,-1
2003,Teruel,44002,Abejuela,1,0,1
2003,Teruel,44003,Aguatón,0,2,-2
2003,Teruel,44004,Aguaviva,4,8,-4
2003,Teruel,44005,Aguilar del Alfambra,1,0,1
2003,Teruel,44006,Alacón,1,8,-7
2003,Teruel,44007,Alba,0,2,-2
2003,Teruel,44008,Albalate del Arzobispo,11,35,-24
2003,Teruel,44009,Albarracín,5,20,-15
2003,Teruel,44010,Albentosa,2,9,-7
2003,Teruel,44012,Alcalá de la Selva,7,4,3
2003,Teruel,44013,Alcañiz,155,186,-31
2003,Teruel,44014,Alcorisa,35,31,4
2003,Teruel,44016,Alfambra,2,7,-5
2003,Teruel,44017,Aliaga,2,3,-1
2003,Teruel,44021,Allepuz,0,2,-2
2003,Teruel,44022,Alloza,3,11,-8
2003,Teruel,44018,Almohaja,0,1,-1
2003,Teruel,44019,Alobras,0,3,-3
2003,Teruel,44025,Andorra,49,55,-6
2003,Teruel,44026,Arcos de las Salinas,0,4,-4
2003,Teruel,44027,Arens de Lledó,1,3,-2
2003,Teruel,44028,Argente,3,2,1
2003,Teruel,44029,Ariño,7,12,-5
2003,Teruel,44031,Azaila,1,2,-1
2003,Teruel,44035,Barrachina,0,5,-5
2003,Teruel,44034,Bañón,1,4,-3
2003,Teruel,44037,Beceite,3,8,-5
2003,Teruel,44039,Bello,4,1,3
2003,Teruel,44038,Belmonte de San José,1,3,-2
2003,Teruel,44040,Berge,3,4,-1
2003,Teruel,44041,Bezas,1,0,1
2003,Teruel,44042,Blancas,0,4,-4
2003,Teruel,44043,Blesa,0,1,-1
2003,Teruel,44044,Bordón,2,2,0
2003,Teruel,44045,Bronchales,2,5,-3
2003,Teruel,44046,Bueña,0,4,-4
2003,Teruel,44047,Burbáguena,0,10,-10
2003,Teruel,44033,Báguena,2,12,-10
2003,Teruel,44049,Calaceite,5,23,-18
2003,Teruel,44050,Calamocha,38,50,-12
2003,Teruel,44051,Calanda,25,41,-16
2003,Teruel,44054,Camarena de la Sierra,2,6,-4
2003,Teruel,44055,Camarillas,0,1,-1
2003,Teruel,44053,Camañas,0,1,-1
2003,Teruel,44056,Caminreal,1,10,-9
2003,Teruel,44059,Cantavieja,5,10,-5
2003,Teruel,44064,Cascante del Río,0,4,-4
2003,Teruel,44065,Castejón de Tornos,0,1,-1
2003,Teruel,44066,Castel de Cabra,0,1,-1
2003,Teruel,44070,Castellar (El),0,2,-2
2003,Teruel,44071,Castellote,2,19,-17
2003,Teruel,44067,Castelnou,0,3,-3
2003,Teruel,44068,Castelserás,0,9,-9
2003,Teruel,44061,Cañada de Verich (La),0,2,-2
2003,Teruel,44062,Cañada Vellida,0,1,-1
2003,Teruel,44063,Cañizar del Olivar,3,4,-1
2003,Teruel,44074,Cedrillas,3,13,-10
2003,Teruel,44075,Celadas,1,4,-3
2003,Teruel,44076,Cella,14,45,-31
2003,Teruel,44080,Codoñera (La),0,6,-6
2003,Teruel,44082,Corbalán,1,1,0
2003,Teruel,44084,Cortes de Aragón,1,2,-1
2003,Teruel,44085,Cosa,0,1,-1
2003,Teruel,44086,Cretas,1,7,-6
2003,Teruel,44088,Cuba (La),1,1,0
2003,Teruel,44090,Cucalón,0,2,-2
2003,Teruel,44092,Cuervo (El),0,4,-4
2003,Teruel,44093,Cuevas de Almudén,1,3,-2
2003,Teruel,44096,Ejulve,0,2,-2
2003,Teruel,44097,Escorihuela,0,3,-3
2003,Teruel,44099,Escucha,10,6,4
2003,Teruel,44100,Estercuel,2,3,-1
2003,Teruel,44101,Ferreruela de Huerva,0,3,-3
2003,Teruel,44102,Fonfría,0,1,-1
2003,Teruel,44103,Formiche Alto,2,2,0
2003,Teruel,44106,Fortanete,1,2,-1
2003,Teruel,44107,Foz-Calanda,2,3,-1
2003,Teruel,44108,Fresneda (La),1,8,-7
2003,Teruel,44109,Frías de Albarracín,1,1,0
2003,Teruel,44112,Fuentes Claras,2,8,-6
2003,Teruel,44113,Fuentes de Rubielos,2,1,1
2003,Teruel,44114,Fuentespalda,4,4,0
2003,Teruel,44115,Galve,1,2,-1
2003,Teruel,44116,Gargallo,2,3,-1
2003,Teruel,44117,Gea de Albarracín,1,8,-7
2003,Teruel,44118,Ginebrosa (La),0,3,-3
2003,Teruel,44119,Griegos,0,2,-2
2003,Teruel,44120,Guadalaviar,1,4,-3
2003,Teruel,44121,Gúdar,0,0,0
2003,Teruel,44123,Hinojosa de Jarque,0,4,-4
2003,Teruel,44124,Hoz de la Vieja (La),0,5,-5
2003,Teruel,44122,Híjar,23,24,-1
2003,Teruel,44126,Iglesuela del Cid (La),5,4,1
2003,Teruel,44127,Jabaloyas,1,1,0
2003,Teruel,44128,Jarque de la Val,0,1,-1
2003,Teruel,44130,Jorcas,0,1,-1
2003,Teruel,44135,Libros,0,1,-1
2003,Teruel,44136,Lidón,0,3,-3
2003,Teruel,44137,Linares de Mora,2,11,-9
2003,Teruel,44141,Lledó,1,2,-1
2003,Teruel,44138,Loscos,0,1,-1
2003,Teruel,44142,Maicas,1,1,0
2003,Teruel,44143,Manzanera,1,7,-6
2003,Teruel,44144,Martín del Río,5,6,-1
2003,Teruel,44145,Mas de las Matas,7,37,-30
2003,Teruel,44146,Mata de los Olmos (La),4,7,-3
2003,Teruel,44147,Mazaleón,3,16,-13
2003,Teruel,44148,Mezquita de Jarque,0,4,-4
2003,Teruel,44149,Mirambel,1,2,-1
2003,Teruel,44150,Miravete de la Sierra,0,1,-1
2003,Teruel,44151,Molinos,2,4,-2
2003,Teruel,44152,Monforte de Moyuela,0,1,-1
2003,Teruel,44153,Monreal del Campo,15,21,-6
2003,Teruel,44154,Monroyo,0,2,-2
2003,Teruel,44155,Montalbán,13,18,-5
2003,Teruel,44158,Mora de Rubielos,12,20,-8
2003,Teruel,44159,Moscardón,1,1,0
2003,Teruel,44160,Mosqueruela,9,16,-7
2003,Teruel,44161,Muniesa,4,6,-2
2003,Teruel,44163,Noguera de Albarracín,1,6,-5
2003,Teruel,44164,Nogueras,0,1,-1
2003,Teruel,44165,Nogueruelas,1,5,-4
2003,Teruel,44167,Obón,0,1,-1
2003,Teruel,44168,Odón,1,4,-3
2003,Teruel,44169,Ojos Negros,2,6,-4
2003,Teruel,44171,Olba,1,3,-2
2003,Teruel,44172,Oliete,3,7,-4
2003,Teruel,44173,Olmos (Los),1,3,-2
2003,Teruel,44174,Orihuela del Tremedal,6,4,2
2003,Teruel,44175,Orrios,1,2,-1
2003,Teruel,44176,Palomar de Arroyos,0,6,-6
2003,Teruel,44177,Pancrudo,1,1,0
2003,Teruel,44178,Parras de Castellote (Las),0,1,-1
2003,Teruel,44180,Peracense,0,1,-1
2003,Teruel,44181,Peralejos,0,1,-1
2003,Teruel,44182,Perales del Alfambra,1,4,-3
2003,Teruel,44179,Peñarroya de Tastavins,2,7,-5
2003,Teruel,44183,Pitarque,1,1,0
2003,Teruel,44184,Plou,0,1,-1
2003,Teruel,44185,Pobo (El),0,2,-2
2003,Teruel,44187,Portellada (La),0,5,-5
2003,Teruel,44189,Pozondón,0,1,-1
2003,Teruel,44191,Puebla de Híjar (La),4,16,-12
2003,Teruel,44192,Puebla de Valverde (La),2,4,-2
2003,Teruel,44193,Puertomingalvo,0,1,-1
2003,Teruel,44195,Rillo,0,3,-3
2003,Teruel,44196,Riodeva,1,2,-1
2003,Teruel,44198,Royuela,0,2,-2
2003,Teruel,44200,Rubielos de la Cérida,0,2,-2
2003,Teruel,44201,Rubielos de Mora,4,5,-1
2003,Teruel,44194,Ráfales,0,3,-3
2003,Teruel,44197,Ródenas,0,1,-1
2003,Teruel,44205,Samper de Calanda,4,14,-10
2003,Teruel,44206,San Agustín,0,3,-3
2003,Teruel,44207,San Martín del Río,1,2,-1
2003,Teruel,44208,Santa Cruz de Nogueras,1,0,1
2003,Teruel,44209,Santa Eulalia,5,16,-11
2003,Teruel,44210,Sarrión,10,14,-4
2003,Teruel,44211,Segura de los Baños,0,2,-2
2003,Teruel,44213,Singra,1,1,0
2003,Teruel,44215,Terriente,0,2,-2
2003,Teruel,44216,Teruel,310,350,-40
2003,Teruel,44217,Toril y Masegoso,0,1,-1
2003,Teruel,44219,Tornos,2,4,-2
2003,Teruel,44220,Torralba de los Sisones,0,2,-2
2003,Teruel,44224,Torre de las Arcas,0,1,-1
2003,Teruel,44225,Torre del Compte,0,5,-5
2003,Teruel,44227,Torre los Negros,1,1,0
2003,Teruel,44221,Torrecilla de Alcañiz,3,8,-5
2003,Teruel,44222,Torrecilla del Rebollar,1,1,0
2003,Teruel,44226,Torrelacárcel,0,4,-4
2003,Teruel,44228,Torremocha de Jiloca,0,2,-2
2003,Teruel,44229,Torres de Albarracín,1,2,-1
2003,Teruel,44230,Torrevelilla,1,5,-4
2003,Teruel,44232,Torrijo del Campo,1,2,-1
2003,Teruel,44234,Tramacastiel,0,3,-3
2003,Teruel,44235,Tramacastilla,0,1,-1
2003,Teruel,44236,Tronchón,0,5,-5
2003,Teruel,44237,Urrea de Gaén,1,8,-7
2003,Teruel,44238,Utrillas,19,33,-14
2003,Teruel,44239,Valacloche,1,0,1
2003,Teruel,44240,Valbona,0,3,-3
2003,Teruel,44241,Valdealgorfa,3,12,-9
2003,Teruel,44244,Valdelinares,2,1,1
2003,Teruel,44245,Valdeltormo,1,6,-5
2003,Teruel,44246,Valderrobres,22,33,-11
2003,Teruel,44247,Valjunquera,2,10,-8
2003,Teruel,44251,Villafranca del Campo,1,2,-1
2003,Teruel,44252,Villahermosa del Campo,1,2,-1
2003,Teruel,44256,Villanueva del Rebollar de la Sierra,1,0,1
2003,Teruel,44257,Villar del Cobo,0,2,-2
2003,Teruel,44258,Villar del Salz,0,3,-3
2003,Teruel,44260,Villarluengo,0,3,-3
2003,Teruel,44261,Villarquemado,2,14,-12
2003,Teruel,44262,Villarroya de los Pinares,2,4,-2
2003,Teruel,44263,Villastar,3,7,-4
2003,Teruel,44264,Villel,2,8,-6
2003,Teruel,44265,Vinaceite,2,2,0
2003,Teruel,44266,Visiedo,1,1,0
2003,Teruel,44267,Vivel del Río Martín,0,2,-2
2003,Teruel,44268,Zoma (La),0,1,-1
2003,Zaragoza,50001,Abanto,1,4,-3
2003,Zaragoza,50002,Acered,0,2,-2
2003,Zaragoza,50004,Aguarón,2,21,-19
2003,Zaragoza,50005,Aguilón,0,4,-4
2003,Zaragoza,50003,Agón,0,1,-1
2003,Zaragoza,50006,Ainzón,14,16,-2
2003,Zaragoza,50008,Alagón,65,81,-16
2003,Zaragoza,50009,Alarba,1,2,-1
2003,Zaragoza,50010,Alberite de San Juan,2,0,2
2003,Zaragoza,50011,Albeta,1,0,1
2003,Zaragoza,50012,Alborge,1,3,-2
2003,Zaragoza,50013,Alcalá de Ebro,1,3,-2
2003,Zaragoza,50015,Alconchel de Ariza,1,1,0
2003,Zaragoza,50016,Aldehuela de Liestos,0,3,-3
2003,Zaragoza,50017,Alfajarín,22,20,2
2003,Zaragoza,50018,Alfamén,9,14,-5
2003,Zaragoza,50019,Alforque,1,0,1
2003,Zaragoza,50020,Alhama de Aragón,15,16,-1
2003,Zaragoza,50022,Almolda (La),1,14,-13
2003,Zaragoza,50023,Almonacid de la Cuba,2,5,-3
2003,Zaragoza,50024,Almonacid de la Sierra,0,18,-18
2003,Zaragoza,50025,Almunia de Doña Godina (La),75,77,-2
2003,Zaragoza,50026,Alpartir,6,11,-5
2003,Zaragoza,50027,Ambel,2,9,-7
2003,Zaragoza,50028,Anento,1,1,0
2003,Zaragoza,50029,Aniñón,4,18,-14
2003,Zaragoza,50031,Aranda de Moncayo,0,4,-4
2003,Zaragoza,50033,Ardisa,0,1,-1
2003,Zaragoza,50034,Ariza,10,31,-21
2003,Zaragoza,50035,Artieda,0,2,-2
2003,Zaragoza,50032,Arándiga,3,4,-1
2003,Zaragoza,50036,Asín,0,4,-4
2003,Zaragoza,50037,Atea,0,3,-3
2003,Zaragoza,50038,Ateca,11,26,-15
2003,Zaragoza,50039,Azuara,4,16,-12
2003,Zaragoza,50030,Añón de Moncayo,1,9,-8
2003,Zaragoza,50040,Badules,0,2,-2
2003,Zaragoza,50041,Bagüés,0,1,-1
2003,Zaragoza,50042,Balconchán,0,2,-2
2003,Zaragoza,50044,Bardallur,3,8,-5
2003,Zaragoza,50045,Belchite,15,22,-7
2003,Zaragoza,50046,Belmonte de Gracián,0,8,-8
2003,Zaragoza,50047,Berdejo,2,0,2
2003,Zaragoza,50048,Berrueco,0,1,-1
2003,Zaragoza,50901,Biel,1,5,-4
2003,Zaragoza,50050,Bijuesca,0,2,-2
2003,Zaragoza,50051,Biota,6,11,-5
2003,Zaragoza,50052,Bisimbre,1,3,-2
2003,Zaragoza,50053,Boquiñeni,7,17,-10
2003,Zaragoza,50054,Bordalba,0,1,-1
2003,Zaragoza,50055,Borja,42,76,-34
2003,Zaragoza,50056,Botorrita,0,2,-2
2003,Zaragoza,50057,Brea de Aragón,25,18,7
2003,Zaragoza,50058,Bubierca,0,2,-2
2003,Zaragoza,50059,Bujaraloz,6,10,-4
2003,Zaragoza,50060,Bulbuente,1,5,-4
2003,Zaragoza,50061,Bureta,0,3,-3
2003,Zaragoza,50062,Burgo de Ebro (El),19,19,0
2003,Zaragoza,50063,Buste (El),0,2,-2
2003,Zaragoza,50043,Bárboles,4,5,-1
2003,Zaragoza,50064,Cabañas de Ebro,3,6,-3
2003,Zaragoza,50065,Cabolafuente,0,1,-1
2003,Zaragoza,50066,Cadrete,26,9,17
2003,Zaragoza,50067,Calatayud,177,239,-62
2003,Zaragoza,50068,Calatorao,23,32,-9
2003,Zaragoza,50070,Calmarza,0,2,-2
2003,Zaragoza,50071,Campillo de Aragón,3,2,1
2003,Zaragoza,50072,Carenas,0,6,-6
2003,Zaragoza,50073,Cariñena,27,43,-16
2003,Zaragoza,50074,Caspe,65,97,-32
2003,Zaragoza,50075,Castejón de Alarba,0,1,-1
2003,Zaragoza,50076,Castejón de las Armas,0,3,-3
2003,Zaragoza,50077,Castejón de Valdejasa,1,3,-2
2003,Zaragoza,50078,Castiliscar,2,7,-5
2003,Zaragoza,50079,Cervera de la Cañada,2,7,-5
2003,Zaragoza,50081,Cetina,6,8,-2
2003,Zaragoza,50092,Chiprana,1,6,-5
2003,Zaragoza,50093,Chodes,0,3,-3
2003,Zaragoza,50082,Cimballa,0,3,-3
2003,Zaragoza,50083,Cinco Olivas,0,2,-2
2003,Zaragoza,50084,Clarés de Ribota,0,4,-4
2003,Zaragoza,50085,Codo,2,4,-2
2003,Zaragoza,50086,Codos,0,4,-4
2003,Zaragoza,50087,Contamina,0,1,-1
2003,Zaragoza,50088,Cosuenda,1,12,-11
2003,Zaragoza,50089,Cuarte de Huerva,33,27,6
2003,Zaragoza,50090,Cubel,1,4,-3
2003,Zaragoza,50091,Cuerlas (Las),0,1,-1
2003,Zaragoza,50094,Daroca,14,46,-32
2003,Zaragoza,50095,Ejea de los Caballeros,134,154,-20
2003,Zaragoza,50096,Embid de Ariza,0,1,-1
2003,Zaragoza,50098,Encinacorba,2,6,-4
2003,Zaragoza,50100,Erla,1,2,-1
2003,Zaragoza,50101,Escatrón,7,24,-17
2003,Zaragoza,50102,Fabara,6,17,-11
2003,Zaragoza,50104,Farlete,2,7,-5
2003,Zaragoza,50106,Fayos (Los),0,3,-3
2003,Zaragoza,50105,Fayón,1,8,-7
2003,Zaragoza,50107,Figueruelas,10,22,-12
2003,Zaragoza,50109,Frago (El),0,2,-2
2003,Zaragoza,50110,Frasno (El),1,3,-2
2003,Zaragoza,50111,Fréscano,0,4,-4
2003,Zaragoza,50113,Fuendejalón,2,13,-11
2003,Zaragoza,50114,Fuendetodos,0,1,-1
2003,Zaragoza,50115,Fuentes de Ebro,45,32,13
2003,Zaragoza,50116,Fuentes de Jiloca,2,4,-2
2003,Zaragoza,50117,Gallocanta,0,1,-1
2003,Zaragoza,50118,Gallur,14,43,-29
2003,Zaragoza,50119,Gelsa,8,10,-2
2003,Zaragoza,50120,Godojos,0,2,-2
2003,Zaragoza,50121,Gotor,4,5,-1
2003,Zaragoza,50122,Grisel,0,1,-1
2003,Zaragoza,50123,Grisén,2,8,-6
2003,Zaragoza,50124,Herrera de los Navarros,5,14,-9
2003,Zaragoza,50125,Ibdes,5,5,0
2003,Zaragoza,50126,Illueca,30,34,-4
2003,Zaragoza,50128,Isuerre,0,1,-1
2003,Zaragoza,50129,Jaraba,4,5,-1
2003,Zaragoza,50130,Jarque de Moncayo,2,15,-13
2003,Zaragoza,50131,Jaulín,2,7,-5
2003,Zaragoza,50132,Joyosa (La),9,9,0
2003,Zaragoza,50134,Langa del Castillo,0,3,-3
2003,Zaragoza,50135,Layana,1,2,-1
2003,Zaragoza,50137,Leciñena,8,12,-4
2003,Zaragoza,50139,Letux,0,13,-13
2003,Zaragoza,50141,Lituénigo,0,1,-1
2003,Zaragoza,50143,Longares,5,14,-9
2003,Zaragoza,50146,Lucena de Jalón,1,1,0
2003,Zaragoza,50147,Luceni,2,15,-13
2003,Zaragoza,50148,Luesia,0,0,0
2003,Zaragoza,50149,Luesma,0,1,-1
2003,Zaragoza,50150,Lumpiaque,2,10,-8
2003,Zaragoza,50151,Luna,3,13,-10
2003,Zaragoza,50136,Lécera,3,20,-17
2003,Zaragoza,50152,Maella,16,28,-12
2003,Zaragoza,50153,Magallón,7,19,-12
2003,Zaragoza,50154,Mainar,0,2,-2
2003,Zaragoza,50155,Malanquilla,0,2,-2
2003,Zaragoza,50156,Maleján,2,5,-3
2003,Zaragoza,50160,Mallén,32,35,-3
2003,Zaragoza,50159,Maluenda,6,17,-11
2003,Zaragoza,50157,Malón,3,3,0
2003,Zaragoza,50161,Manchones,0,2,-2
2003,Zaragoza,50162,Mara,0,1,-1
2003,Zaragoza,50902,Marracos,0,3,-3
2003,Zaragoza,50163,María de Huerva,33,12,21
2003,Zaragoza,50164,Mediana de Aragón,1,9,-8
2003,Zaragoza,50165,Mequinenza,19,35,-16
2003,Zaragoza,50166,Mesones de Isuela,1,2,-1
2003,Zaragoza,50167,Mezalocha,2,2,0
2003,Zaragoza,50169,Miedes de Aragón,3,8,-5
2003,Zaragoza,50170,Monegrillo,1,5,-4
2003,Zaragoza,50172,Monreal de Ariza,0,2,-2
2003,Zaragoza,50173,Monterde,0,5,-5
2003,Zaragoza,50174,Montón,0,2,-2
2003,Zaragoza,50175,Morata de Jalón,4,25,-21
2003,Zaragoza,50176,Morata de Jiloca,0,5,-5
2003,Zaragoza,50178,Moros,4,8,-4
2003,Zaragoza,50177,Morés,2,9,-7
2003,Zaragoza,50179,Moyuela,1,5,-4
2003,Zaragoza,50180,Mozota,0,2,-2
2003,Zaragoza,50181,Muel,11,16,-5
2003,Zaragoza,50182,Muela (La),26,14,12
2003,Zaragoza,50183,Munébrega,2,3,-1
2003,Zaragoza,50184,Murero,1,0,1
2003,Zaragoza,50185,Murillo de Gállego,1,2,-1
2003,Zaragoza,50186,Navardún,0,1,-1
2003,Zaragoza,50187,Nigüella,0,1,-1
2003,Zaragoza,50189,Nonaspe,7,15,-8
2003,Zaragoza,50190,Novallas,5,12,-7
2003,Zaragoza,50191,Novillas,2,14,-12
2003,Zaragoza,50193,Nuez de Ebro,2,6,-4
2003,Zaragoza,50192,Nuévalos,4,4,0
2003,Zaragoza,50194,Olvés,1,1,0
2003,Zaragoza,50195,Orcajo,0,1,-1
2003,Zaragoza,50196,Orera,0,3,-3
2003,Zaragoza,50197,Orés,0,3,-3
2003,Zaragoza,50198,Oseja,0,1,-1
2003,Zaragoza,50199,Osera de Ebro,3,21,-18
2003,Zaragoza,50200,Paniza,5,11,-6
2003,Zaragoza,50201,Paracuellos de Jiloca,3,7,-4
2003,Zaragoza,50202,Paracuellos de la Ribera,0,7,-7
2003,Zaragoza,50203,Pastriz,11,14,-3
2003,Zaragoza,50204,Pedrola,23,36,-13
2003,Zaragoza,50205,Pedrosas (Las),0,3,-3
2003,Zaragoza,50206,Perdiguera,2,5,-3
2003,Zaragoza,50208,Pina de Ebro,19,14,5
2003,Zaragoza,50209,Pinseque,16,56,-40
2003,Zaragoza,50210,Pintanos (Los),0,1,-1
2003,Zaragoza,50211,Plasencia de Jalón,3,6,-3
2003,Zaragoza,50213,Plenas,0,1,-1
2003,Zaragoza,50214,Pomer,0,0,0
2003,Zaragoza,50215,Pozuel de Ariza,0,1,-1
2003,Zaragoza,50216,Pozuelo de Aragón,2,4,-2
2003,Zaragoza,50217,Pradilla de Ebro,5,10,-5
2003,Zaragoza,50218,Puebla de Albortón,0,2,-2
2003,Zaragoza,50219,Puebla de Alfindén (La),36,19,17
2003,Zaragoza,50222,Quinto,6,25,-19
2003,Zaragoza,50223,Remolinos,6,18,-12
2003,Zaragoza,50224,Retascón,0,1,-1
2003,Zaragoza,50225,Ricla,21,31,-10
2003,Zaragoza,50227,Romanos,0,2,-2
2003,Zaragoza,50228,Rueda de Jalón,0,8,-8
2003,Zaragoza,50231,Salillas de Jalón,3,9,-6
2003,Zaragoza,50232,Salvatierra de Esca,4,5,-1
2003,Zaragoza,50233,Samper del Salz,1,2,-1
2003,Zaragoza,50234,San Martín de la Virgen de Moncayo,2,6,-4
2003,Zaragoza,50235,San Mateo de Gállego,22,19,3
2003,Zaragoza,50236,Santa Cruz de Grío,1,5,-4
2003,Zaragoza,50237,Santa Cruz de Moncayo,2,3,-1
2003,Zaragoza,50238,Santa Eulalia de Gállego,0,1,-1
2003,Zaragoza,50239,Santed,0,1,-1
2003,Zaragoza,50241,Saviñán,0,11,-11
2003,Zaragoza,50242,Sediles,0,1,-1
2003,Zaragoza,50243,Sestrica,0,4,-4
2003,Zaragoza,50244,Sierra de Luna,2,7,-5
2003,Zaragoza,50245,Sigüés,0,2,-2
2003,Zaragoza,50246,Sisamón,0,1,-1
2003,Zaragoza,50247,Sobradiel,3,4,-1
2003,Zaragoza,50248,Sos del Rey Católico,5,7,-2
2003,Zaragoza,50230,Sádaba,8,29,-21
2003,Zaragoza,50240,Sástago,2,13,-11
2003,Zaragoza,50249,Tabuenca,3,9,-6
2003,Zaragoza,50250,Talamantes,0,2,-2
2003,Zaragoza,50251,Tarazona,88,143,-55
2003,Zaragoza,50252,Tauste,59,92,-33
2003,Zaragoza,50253,Terrer,0,12,-12
2003,Zaragoza,50254,Tierga,2,3,-1
2003,Zaragoza,50255,Tobed,0,2,-2
2003,Zaragoza,50256,Torralba de los Frailes,0,1,-1
2003,Zaragoza,50257,Torralba de Ribota,0,5,-5
2003,Zaragoza,50258,Torralbilla,0,2,-2
2003,Zaragoza,50259,Torrehermosa,1,1,0
2003,Zaragoza,50260,Torrelapaja,0,1,-1
2003,Zaragoza,50261,Torrellas,0,4,-4
2003,Zaragoza,50262,Torres de Berrellén,11,19,-8
2003,Zaragoza,50263,Torrijo de la Cañada,2,9,-7
2003,Zaragoza,50264,Tosos,0,5,-5
2003,Zaragoza,50265,Trasmoz,0,1,-1
2003,Zaragoza,50266,Trasobares,0,6,-6
2003,Zaragoza,50267,Uncastillo,7,8,-1
2003,Zaragoza,50268,Undués de Lerda,0,1,-1
2003,Zaragoza,50269,Urrea de Jalón,4,7,-3
2003,Zaragoza,50270,Urriés,0,1,-1
2003,Zaragoza,50271,Used,0,5,-5
2003,Zaragoza,50272,Utebo,206,69,137
2003,Zaragoza,50274,Val de San Martín,0,1,-1
2003,Zaragoza,50273,Valdehorna,0,1,-1
2003,Zaragoza,50275,Valmadrid,0,2,-2
2003,Zaragoza,50276,Valpalmas,1,2,-1
2003,Zaragoza,50278,Velilla de Ebro,3,1,2
2003,Zaragoza,50279,Velilla de Jiloca,0,2,-2
2003,Zaragoza,50280,Vera de Moncayo,1,5,-4
2003,Zaragoza,50283,Villadoz,0,2,-2
2003,Zaragoza,50284,Villafeliche,2,2,0
2003,Zaragoza,50285,Villafranca de Ebro,3,9,-6
2003,Zaragoza,50286,Villalba de Perejil,0,1,-1
2003,Zaragoza,50287,Villalengua,0,5,-5
2003,Zaragoza,50288,Villanueva de Gállego,52,29,23
2003,Zaragoza,50290,Villanueva de Huerva,5,13,-8
2003,Zaragoza,50289,Villanueva de Jiloca,0,1,-1
2003,Zaragoza,50291,Villar de los Navarros,0,4,-4
2003,Zaragoza,50292,Villarreal de Huerva,4,1,3
2003,Zaragoza,50293,Villarroya de la Sierra,2,18,-16
2003,Zaragoza,50294,Villarroya del Campo,0,1,-1
2003,Zaragoza,50282,Vilueña (La),0,4,-4
2003,Zaragoza,50295,Vistabella,0,1,-1
2003,Zaragoza,50296,Zaida (La),3,7,-4
2003,Zaragoza,50297,Zaragoza,6282,6149,133
2003,Zaragoza,50298,Zuera,59,62,-3
2003,Zaragoza,50099,Épila,37,53,-16
2002,Huesca,22001,Abiego,1,5,-4
2002,Huesca,22002,Abizanda,0,1,-1
2002,Huesca,22003,Adahuesca,0,1,-1
2002,Huesca,22004,Agüero,0,5,-5
2002,Huesca,22007,Albalate de Cinca,5,14,-9
2002,Huesca,22008,Albalatillo,0,4,-4
2002,Huesca,22009,Albelda,4,23,-19
2002,Huesca,22011,Albero Alto,1,0,1
2002,Huesca,22012,Albero Bajo,0,2,-2
2002,Huesca,22013,Alberuela de Tubo,1,3,-2
2002,Huesca,22014,Alcalá de Gurrea,0,7,-7
2002,Huesca,22015,Alcalá del Obispo,0,7,-7
2002,Huesca,22016,Alcampell,3,16,-13
2002,Huesca,22017,Alcolea de Cinca,9,13,-4
2002,Huesca,22018,Alcubierre,3,8,-5
2002,Huesca,22020,Alfántega,0,6,-6
2002,Huesca,22021,Almudévar,11,34,-23
2002,Huesca,22022,Almunia de San Juan,6,10,-4
2002,Huesca,22023,Almuniente,2,12,-10
2002,Huesca,22024,Alquézar,2,6,-4
2002,Huesca,22025,Altorricón,9,19,-10
2002,Huesca,22027,Angüés,3,14,-11
2002,Huesca,22028,Ansó,3,5,-2
2002,Huesca,22029,Antillón,0,2,-2
2002,Huesca,22032,Aragüés del Puerto,1,1,0
2002,Huesca,22036,Argavieso,0,1,-1
2002,Huesca,22037,Arguis,0,2,-2
2002,Huesca,22035,Arén,2,3,-1
2002,Huesca,22039,Ayerbe,3,19,-16
2002,Huesca,22040,Azanuy-Alins,2,6,-4
2002,Huesca,22041,Azara,1,4,-3
2002,Huesca,22042,Azlor,1,6,-5
2002,Huesca,22907,Aínsa-Sobrarbe,11,26,-15
2002,Huesca,22006,Aísa,3,14,-11
2002,Huesca,22043,Baells,0,4,-4
2002,Huesca,22044,Bailo,0,8,-8
2002,Huesca,22045,Baldellou,0,2,-2
2002,Huesca,22046,Ballobar,5,19,-14
2002,Huesca,22047,Banastás,0,1,-1
2002,Huesca,22048,Barbastro,151,164,-13
2002,Huesca,22049,Barbués,1,3,-2
2002,Huesca,22050,Barbuñales,0,1,-1
2002,Huesca,22052,Belver de Cinca,10,10,0
2002,Huesca,22053,Benabarre,4,20,-16
2002,Huesca,22054,Benasque,11,10,1
2002,Huesca,22246,Beranuy,0,2,-2
2002,Huesca,22055,Berbegal,3,4,-1
2002,Huesca,22057,Bielsa,1,3,-2
2002,Huesca,22058,Bierge,2,3,-1
2002,Huesca,22059,Biescas,10,16,-6
2002,Huesca,22060,Binaced,17,23,-6
2002,Huesca,22061,Binéfar,68,72,-4
2002,Huesca,22062,Bisaurri,2,6,-4
2002,Huesca,22063,Biscarrués,3,6,-3
2002,Huesca,22064,Blecua y Torres,1,3,-2
2002,Huesca,22066,Boltaña,4,10,-6
2002,Huesca,22067,Bonansa,2,0,2
2002,Huesca,22069,Broto,2,6,-4
2002,Huesca,22072,Caldearenas,0,9,-9
2002,Huesca,22074,Campo,0,4,-4
2002,Huesca,22075,Camporrells,1,3,-2
2002,Huesca,22076,Canal de Berdún,1,11,-10
2002,Huesca,22077,Candasnos,7,10,-3
2002,Huesca,22078,Canfranc,4,5,-1
2002,Huesca,22079,Capdesaso,0,1,-1
2002,Huesca,22080,Capella,2,7,-5
2002,Huesca,22081,Casbas de Huesca,0,2,-2
2002,Huesca,22083,Castejón de Monegros,3,6,-3
2002,Huesca,22084,Castejón de Sos,5,6,-1
2002,Huesca,22082,Castejón del Puente,2,5,-3
2002,Huesca,22085,Castelflorite,1,1,0
2002,Huesca,22086,Castiello de Jaca,0,2,-2
2002,Huesca,22087,Castigaleu,0,1,-1
2002,Huesca,22088,Castillazuelo,0,7,-7
2002,Huesca,22089,Castillonroy,1,9,-8
2002,Huesca,22094,Chalamera,0,1,-1
2002,Huesca,22096,Chimillas,1,2,-1
2002,Huesca,22095,Chía,0,2,-2
2002,Huesca,22099,Esplús,5,6,-1
2002,Huesca,22102,Estada,0,7,-7
2002,Huesca,22103,Estadilla,4,10,-6
2002,Huesca,22105,Estopiñán del Castillo,3,5,-2
2002,Huesca,22106,Fago,1,1,0
2002,Huesca,22109,Fiscal,4,0,4
2002,Huesca,22110,Fonz,5,16,-11
2002,Huesca,22111,Foradada del Toscar,0,1,-1
2002,Huesca,22112,Fraga,122,125,-3
2002,Huesca,22113,Fueva (La),4,5,-1
2002,Huesca,22114,Gistaín,1,3,-2
2002,Huesca,22115,Grado (El),1,6,-5
2002,Huesca,22117,Graus,23,42,-19
2002,Huesca,22116,Grañén,7,31,-24
2002,Huesca,22119,Gurrea de Gállego,6,24,-18
2002,Huesca,22122,Hoz de Jaca,1,1,0
2002,Huesca,22908,Hoz y Costeán,2,2,0
2002,Huesca,22124,Huerto,1,9,-8
2002,Huesca,22125,Huesca,457,489,-32
2002,Huesca,22126,Ibieca,0,2,-2
2002,Huesca,22127,Igriés,4,8,-4
2002,Huesca,22128,Ilche,0,6,-6
2002,Huesca,22129,Isábena,1,5,-4
2002,Huesca,22130,Jaca,99,135,-36
2002,Huesca,22131,Jasa,0,3,-3
2002,Huesca,22133,Labuerda,1,3,-2
2002,Huesca,22135,Laluenga,0,6,-6
2002,Huesca,22136,Lalueza,6,15,-9
2002,Huesca,22137,Lanaja,6,13,-7
2002,Huesca,22139,Laperdiguera,0,1,-1
2002,Huesca,22141,Lascellas-Ponzano,0,3,-3
2002,Huesca,22142,Lascuarre,1,3,-2
2002,Huesca,22143,Laspaúles,1,2,-1
2002,Huesca,22144,Laspuña,3,1,2
2002,Huesca,22149,Loarre,1,7,-6
2002,Huesca,22150,Loporzano,2,4,-2
2002,Huesca,22151,Loscorrales,0,1,-1
2002,Huesca,22905,Lupiñén-Ortilla,2,8,-6
2002,Huesca,22155,Monesma y Cajigar,0,1,-1
2002,Huesca,22156,Monflorite-Lascasas,2,2,0
2002,Huesca,22157,Montanuy,3,5,-2
2002,Huesca,22158,Monzón,165,162,3
2002,Huesca,22160,Naval,4,5,-1
2002,Huesca,22162,Novales,2,6,-4
2002,Huesca,22163,Nueno,1,1,0
2002,Huesca,22164,Olvena,0,1,-1
2002,Huesca,22165,Ontiñena,4,11,-7
2002,Huesca,22167,Osso de Cinca,4,12,-8
2002,Huesca,22170,Panticosa,12,5,7
2002,Huesca,22174,Peralta de Alcofea,2,19,-17
2002,Huesca,22175,Peralta de Calasanz,0,2,-2
2002,Huesca,22176,Peraltilla,0,3,-3
2002,Huesca,22177,Perarrúa,1,0,1
2002,Huesca,22178,Pertusa,0,3,-3
2002,Huesca,22172,Peñalba,3,5,-2
2002,Huesca,22173,Peñas de Riglos (Las),0,4,-4
2002,Huesca,22181,Piracés,1,1,0
2002,Huesca,22182,Plan,8,4,4
2002,Huesca,22184,Poleñino,1,2,-1
2002,Huesca,22186,Pozán de Vero,0,5,-5
2002,Huesca,22187,Puebla de Castro (La),4,2,2
2002,Huesca,22188,Puente de Montañana,1,2,-1
2002,Huesca,22902,Puente la Reina de Jaca,2,1,1
2002,Huesca,22190,Pueyo de Araguás (El),1,6,-5
2002,Huesca,22193,Pueyo de Santa Cruz,0,4,-4
2002,Huesca,22189,Puértolas,1,4,-3
2002,Huesca,22195,Quicena,0,9,-9
2002,Huesca,22197,Robres,5,11,-6
2002,Huesca,22199,Sabiñánigo,72,81,-9
2002,Huesca,22200,Sahún,0,2,-2
2002,Huesca,22201,Salas Altas,1,6,-5
2002,Huesca,22202,Salas Bajas,1,3,-2
2002,Huesca,22203,Salillas,2,2,0
2002,Huesca,22204,Sallent de Gállego,9,10,-1
2002,Huesca,22205,San Esteban de Litera,2,7,-5
2002,Huesca,22207,San Juan de Plan,3,0,3
2002,Huesca,22903,San Miguel del Cinca,6,11,-5
2002,Huesca,22206,Sangarrén,2,1,1
2002,Huesca,22208,Santa Cilia,0,4,-4
2002,Huesca,22209,Santa Cruz de la Serós,1,1,0
2002,Huesca,22906,Santa María de Dulcis,0,5,-5
2002,Huesca,22212,Santaliestra y San Quílez,1,2,-1
2002,Huesca,22213,Sariñena,25,50,-25
2002,Huesca,22214,Secastilla,1,3,-2
2002,Huesca,22215,Seira,0,3,-3
2002,Huesca,22217,Sena,1,7,-6
2002,Huesca,22218,Senés de Alcubierre,0,1,-1
2002,Huesca,22220,Sesa,3,3,0
2002,Huesca,22221,Sesué,0,1,-1
2002,Huesca,22222,Siétamo,4,4,0
2002,Huesca,22223,Sopeira,0,0,0
2002,Huesca,22904,Sotonera (La),6,19,-13
2002,Huesca,22225,Tamarite de Litera,21,58,-37
2002,Huesca,22226,Tardienta,2,14,-12
2002,Huesca,22227,Tella-Sin,2,8,-6
2002,Huesca,22228,Tierz,0,2,-2
2002,Huesca,22229,Tolva,0,6,-6
2002,Huesca,22230,Torla-Ordesa,3,4,-1
2002,Huesca,22232,Torralba de Aragón,0,2,-2
2002,Huesca,22233,Torre la Ribera,1,0,1
2002,Huesca,22234,Torrente de Cinca,7,13,-6
2002,Huesca,22235,Torres de Alcanadre,0,2,-2
2002,Huesca,22236,Torres de Barbués,1,5,-4
2002,Huesca,22239,Tramaced,0,1,-1
2002,Huesca,22242,Valfarta,0,1,-1
2002,Huesca,22901,Valle de Hecho,4,6,-2
2002,Huesca,22245,Velilla de Cinca,6,7,-1
2002,Huesca,22909,Vencillón,3,7,-4
2002,Huesca,22248,Vicién,0,1,-1
2002,Huesca,22249,Villanova,2,2,0
2002,Huesca,22251,Villanueva de Sigena,5,6,-1
2002,Huesca,22250,Villanúa,2,2,0
2002,Huesca,22253,Yésero,1,1,0
2002,Huesca,22254,Zaidín,10,22,-12
2002,Teruel,44001,Ababuj,1,0,1
2002,Teruel,44002,Abejuela,0,1,-1
2002,Teruel,44003,Aguatón,0,1,-1
2002,Teruel,44004,Aguaviva,6,10,-4
2002,Teruel,44005,Aguilar del Alfambra,0,2,-2
2002,Teruel,44006,Alacón,1,9,-8
2002,Teruel,44007,Alba,0,6,-6
2002,Teruel,44008,Albalate del Arzobispo,15,35,-20
2002,Teruel,44009,Albarracín,2,21,-19
2002,Teruel,44010,Albentosa,2,2,0
2002,Teruel,44011,Alcaine,0,0,0
2002,Teruel,44012,Alcalá de la Selva,6,6,0
2002,Teruel,44013,Alcañiz,161,174,-13
2002,Teruel,44014,Alcorisa,23,33,-10
2002,Teruel,44016,Alfambra,0,6,-6
2002,Teruel,44017,Aliaga,0,6,-6
2002,Teruel,44021,Allepuz,1,3,-2
2002,Teruel,44022,Alloza,3,15,-12
2002,Teruel,44019,Alobras,0,1,-1
2002,Teruel,44025,Andorra,60,50,10
2002,Teruel,44026,Arcos de las Salinas,0,3,-3
2002,Teruel,44027,Arens de Lledó,1,7,-6
2002,Teruel,44028,Argente,0,1,-1
2002,Teruel,44029,Ariño,2,7,-5
2002,Teruel,44031,Azaila,0,3,-3
2002,Teruel,44035,Barrachina,0,2,-2
2002,Teruel,44034,Bañón,0,4,-4
2002,Teruel,44036,Bea,0,1,-1
2002,Teruel,44037,Beceite,3,5,-2
2002,Teruel,44039,Bello,0,5,-5
2002,Teruel,44038,Belmonte de San José,1,3,-2
2002,Teruel,44040,Berge,1,1,0
2002,Teruel,44041,Bezas,1,1,0
2002,Teruel,44042,Blancas,1,2,-1
2002,Teruel,44044,Bordón,1,4,-3
2002,Teruel,44045,Bronchales,2,5,-3
2002,Teruel,44046,Bueña,0,2,-2
2002,Teruel,44047,Burbáguena,0,13,-13
2002,Teruel,44033,Báguena,1,6,-5
2002,Teruel,44048,Cabra de Mora,0,2,-2
2002,Teruel,44049,Calaceite,10,14,-4
2002,Teruel,44050,Calamocha,30,36,-6
2002,Teruel,44051,Calanda,28,44,-16
2002,Teruel,44052,Calomarde,0,4,-4
2002,Teruel,44054,Camarena de la Sierra,0,1,-1
2002,Teruel,44055,Camarillas,0,1,-1
2002,Teruel,44053,Camañas,2,3,-1
2002,Teruel,44056,Caminreal,3,10,-7
2002,Teruel,44059,Cantavieja,7,9,-2
2002,Teruel,44064,Cascante del Río,0,3,-3
2002,Teruel,44065,Castejón de Tornos,0,1,-1
2002,Teruel,44066,Castel de Cabra,1,3,-2
2002,Teruel,44070,Castellar (El),1,2,-1
2002,Teruel,44071,Castellote,3,7,-4
2002,Teruel,44067,Castelnou,0,1,-1
2002,Teruel,44068,Castelserás,7,7,0
2002,Teruel,44060,Cañada de Benatanduz,0,2,-2
2002,Teruel,44063,Cañizar del Olivar,0,4,-4
2002,Teruel,44074,Cedrillas,4,12,-8
2002,Teruel,44075,Celadas,1,5,-4
2002,Teruel,44076,Cella,13,31,-18
2002,Teruel,44077,Cerollera (La),0,2,-2
2002,Teruel,44080,Codoñera (La),1,3,-2
2002,Teruel,44082,Corbalán,0,2,-2
2002,Teruel,44084,Cortes de Aragón,0,8,-8
2002,Teruel,44086,Cretas,1,7,-6
2002,Teruel,44087,Crivillén,0,2,-2
2002,Teruel,44088,Cuba (La),0,1,-1
2002,Teruel,44089,Cubla,0,4,-4
2002,Teruel,44090,Cucalón,0,2,-2
2002,Teruel,44092,Cuervo (El),1,2,-1
2002,Teruel,44093,Cuevas de Almudén,0,0,0
2002,Teruel,44094,Cuevas Labradas,0,0,0
2002,Teruel,44096,Ejulve,1,3,-2
2002,Teruel,44097,Escorihuela,0,6,-6
2002,Teruel,44099,Escucha,9,8,1
2002,Teruel,44100,Estercuel,2,4,-2
2002,Teruel,44101,Ferreruela de Huerva,0,1,-1
2002,Teruel,44102,Fonfría,0,1,-1
2002,Teruel,44103,Formiche Alto,2,3,-1
2002,Teruel,44106,Fortanete,1,2,-1
2002,Teruel,44107,Foz-Calanda,3,5,-2
2002,Teruel,44108,Fresneda (La),0,6,-6
2002,Teruel,44109,Frías de Albarracín,0,2,-2
2002,Teruel,44111,Fuentes Calientes,0,0,0
2002,Teruel,44112,Fuentes Claras,1,4,-3
2002,Teruel,44113,Fuentes de Rubielos,2,1,1
2002,Teruel,44114,Fuentespalda,0,6,-6
2002,Teruel,44105,Fórnoles,1,1,0
2002,Teruel,44115,Galve,1,2,-1
2002,Teruel,44116,Gargallo,1,3,-2
2002,Teruel,44117,Gea de Albarracín,1,11,-10
2002,Teruel,44118,Ginebrosa (La),0,4,-4
2002,Teruel,44119,Griegos,0,5,-5
2002,Teruel,44120,Guadalaviar,0,3,-3
2002,Teruel,44121,Gúdar,0,1,-1
2002,Teruel,44123,Hinojosa de Jarque,0,4,-4
2002,Teruel,44125,Huesa del Común,0,1,-1
2002,Teruel,44122,Híjar,11,31,-20
2002,Teruel,44126,Iglesuela del Cid (La),3,7,-4
2002,Teruel,44127,Jabaloyas,1,1,0
2002,Teruel,44128,Jarque de la Val,0,1,-1
2002,Teruel,44130,Jorcas,0,1,-1
2002,Teruel,44132,Lagueruela,0,1,-1
2002,Teruel,44135,Libros,1,2,-1
2002,Teruel,44136,Lidón,0,1,-1
2002,Teruel,44137,Linares de Mora,2,7,-5
2002,Teruel,44141,Lledó,0,4,-4
2002,Teruel,44138,Loscos,1,3,-2
2002,Teruel,44143,Manzanera,4,9,-5
2002,Teruel,44144,Martín del Río,3,8,-5
2002,Teruel,44145,Mas de las Matas,9,18,-9
2002,Teruel,44146,Mata de los Olmos (La),1,4,-3
2002,Teruel,44147,Mazaleón,2,7,-5
2002,Teruel,44148,Mezquita de Jarque,0,4,-4
2002,Teruel,44149,Mirambel,0,1,-1
2002,Teruel,44151,Molinos,2,7,-5
2002,Teruel,44152,Monforte de Moyuela,0,2,-2
2002,Teruel,44153,Monreal del Campo,16,23,-7
2002,Teruel,44154,Monroyo,0,2,-2
2002,Teruel,44155,Montalbán,8,12,-4
2002,Teruel,44156,Monteagudo del Castillo,1,1,0
2002,Teruel,44158,Mora de Rubielos,5,13,-8
2002,Teruel,44159,Moscardón,0,0,0
2002,Teruel,44160,Mosqueruela,2,11,-9
2002,Teruel,44161,Muniesa,6,13,-7
2002,Teruel,44163,Noguera de Albarracín,0,3,-3
2002,Teruel,44165,Nogueruelas,0,3,-3
2002,Teruel,44168,Odón,2,2,0
2002,Teruel,44169,Ojos Negros,2,7,-5
2002,Teruel,44171,Olba,0,3,-3
2002,Teruel,44172,Oliete,0,5,-5
2002,Teruel,44173,Olmos (Los),1,4,-3
2002,Teruel,44174,Orihuela del Tremedal,5,6,-1
2002,Teruel,44175,Orrios,0,1,-1
2002,Teruel,44176,Palomar de Arroyos,0,1,-1
2002,Teruel,44177,Pancrudo,1,2,-1
2002,Teruel,44178,Parras de Castellote (Las),0,2,-2
2002,Teruel,44180,Peracense,0,1,-1
2002,Teruel,44181,Peralejos,0,1,-1
2002,Teruel,44182,Perales del Alfambra,0,2,-2
2002,Teruel,44179,Peñarroya de Tastavins,4,9,-5
2002,Teruel,44183,Pitarque,0,1,-1
2002,Teruel,44184,Plou,0,1,-1
2002,Teruel,44187,Portellada (La),0,8,-8
2002,Teruel,44189,Pozondón,0,1,-1
2002,Teruel,44190,Pozuel del Campo,1,4,-3
2002,Teruel,44191,Puebla de Híjar (La),4,13,-9
2002,Teruel,44192,Puebla de Valverde (La),5,3,2
2002,Teruel,44193,Puertomingalvo,1,2,-1
2002,Teruel,44195,Rillo,0,2,-2
2002,Teruel,44196,Riodeva,0,7,-7
2002,Teruel,44198,Royuela,3,6,-3
2002,Teruel,44200,Rubielos de la Cérida,0,1,-1
2002,Teruel,44201,Rubielos de Mora,2,7,-5
2002,Teruel,44194,Ráfales,0,6,-6
2002,Teruel,44197,Ródenas,0,1,-1
2002,Teruel,44203,Salcedillo,0,1,-1
2002,Teruel,44204,Saldón,0,1,-1
2002,Teruel,44205,Samper de Calanda,8,15,-7
2002,Teruel,44206,San Agustín,0,5,-5
2002,Teruel,44207,San Martín del Río,0,2,-2
2002,Teruel,44208,Santa Cruz de Nogueras,0,0,0
2002,Teruel,44209,Santa Eulalia,5,20,-15
2002,Teruel,44210,Sarrión,2,20,-18
2002,Teruel,44213,Singra,0,2,-2
2002,Teruel,44215,Terriente,1,6,-5
2002,Teruel,44216,Teruel,287,340,-53
2002,Teruel,44219,Tornos,0,3,-3
2002,Teruel,44220,Torralba de los Sisones,0,2,-2
2002,Teruel,44224,Torre de las Arcas,0,2,-2
2002,Teruel,44225,Torre del Compte,0,7,-7
2002,Teruel,44227,Torre los Negros,0,3,-3
2002,Teruel,44221,Torrecilla de Alcañiz,3,7,-4
2002,Teruel,44222,Torrecilla del Rebollar,0,7,-7
2002,Teruel,44226,Torrelacárcel,0,5,-5
2002,Teruel,44228,Torremocha de Jiloca,0,4,-4
2002,Teruel,44229,Torres de Albarracín,1,3,-2
2002,Teruel,44230,Torrevelilla,0,1,-1
2002,Teruel,44231,Torrijas,0,1,-1
2002,Teruel,44232,Torrijo del Campo,0,5,-5
2002,Teruel,44234,Tramacastiel,1,0,1
2002,Teruel,44235,Tramacastilla,0,3,-3
2002,Teruel,44236,Tronchón,0,1,-1
2002,Teruel,44237,Urrea de Gaén,4,8,-4
2002,Teruel,44238,Utrillas,25,29,-4
2002,Teruel,44240,Valbona,0,2,-2
2002,Teruel,44241,Valdealgorfa,4,14,-10
2002,Teruel,44243,Valdecuenca,0,3,-3
2002,Teruel,44244,Valdelinares,0,2,-2
2002,Teruel,44245,Valdeltormo,0,3,-3
2002,Teruel,44246,Valderrobres,14,21,-7
2002,Teruel,44247,Valjunquera,0,4,-4
2002,Teruel,44251,Villafranca del Campo,1,5,-4
2002,Teruel,44252,Villahermosa del Campo,2,2,0
2002,Teruel,44257,Villar del Cobo,1,1,0
2002,Teruel,44258,Villar del Salz,1,1,0
2002,Teruel,44260,Villarluengo,2,3,-1
2002,Teruel,44261,Villarquemado,3,11,-8
2002,Teruel,44262,Villarroya de los Pinares,1,2,-1
2002,Teruel,44263,Villastar,1,4,-3
2002,Teruel,44264,Villel,0,5,-5
2002,Teruel,44265,Vinaceite,0,5,-5
2002,Teruel,44266,Visiedo,0,3,-3
2002,Teruel,44267,Vivel del Río Martín,0,2,-2
2002,Zaragoza,50001,Abanto,0,2,-2
2002,Zaragoza,50002,Acered,1,4,-3
2002,Zaragoza,50004,Aguarón,4,20,-16
2002,Zaragoza,50005,Aguilón,0,2,-2
2002,Zaragoza,50003,Agón,3,1,2
2002,Zaragoza,50006,Ainzón,7,26,-19
2002,Zaragoza,50008,Alagón,42,80,-38
2002,Zaragoza,50009,Alarba,0,1,-1
2002,Zaragoza,50011,Albeta,1,1,0
2002,Zaragoza,50012,Alborge,2,0,2
2002,Zaragoza,50013,Alcalá de Ebro,4,1,3
2002,Zaragoza,50014,Alcalá de Moncayo,1,0,1
2002,Zaragoza,50015,Alconchel de Ariza,0,5,-5
2002,Zaragoza,50016,Aldehuela de Liestos,0,1,-1
2002,Zaragoza,50017,Alfajarín,13,22,-9
2002,Zaragoza,50018,Alfamén,8,15,-7
2002,Zaragoza,50019,Alforque,0,1,-1
2002,Zaragoza,50020,Alhama de Aragón,12,20,-8
2002,Zaragoza,50021,Almochuel,0,2,-2
2002,Zaragoza,50022,Almolda (La),4,9,-5
2002,Zaragoza,50023,Almonacid de la Cuba,1,7,-6
2002,Zaragoza,50024,Almonacid de la Sierra,5,20,-15
2002,Zaragoza,50025,Almunia de Doña Godina (La),62,70,-8
2002,Zaragoza,50026,Alpartir,3,4,-1
2002,Zaragoza,50027,Ambel,1,3,-2
2002,Zaragoza,50028,Anento,1,1,0
2002,Zaragoza,50029,Aniñón,5,13,-8
2002,Zaragoza,50031,Aranda de Moncayo,0,5,-5
2002,Zaragoza,50034,Ariza,9,15,-6
2002,Zaragoza,50035,Artieda,2,0,2
2002,Zaragoza,50032,Arándiga,0,7,-7
2002,Zaragoza,50036,Asín,0,1,-1
2002,Zaragoza,50037,Atea,0,8,-8
2002,Zaragoza,50038,Ateca,8,18,-10
2002,Zaragoza,50039,Azuara,4,10,-6
2002,Zaragoza,50030,Añón de Moncayo,0,6,-6
2002,Zaragoza,50040,Badules,0,2,-2
2002,Zaragoza,50044,Bardallur,2,5,-3
2002,Zaragoza,50045,Belchite,14,24,-10
2002,Zaragoza,50046,Belmonte de Gracián,0,5,-5
2002,Zaragoza,50048,Berrueco,0,1,-1
2002,Zaragoza,50901,Biel,0,4,-4
2002,Zaragoza,50050,Bijuesca,0,2,-2
2002,Zaragoza,50051,Biota,6,16,-10
2002,Zaragoza,50052,Bisimbre,0,1,-1
2002,Zaragoza,50053,Boquiñeni,3,15,-12
2002,Zaragoza,50055,Borja,58,73,-15
2002,Zaragoza,50056,Botorrita,3,8,-5
2002,Zaragoza,50057,Brea de Aragón,10,15,-5
2002,Zaragoza,50058,Bubierca,1,2,-1
2002,Zaragoza,50059,Bujaraloz,8,11,-3
2002,Zaragoza,50060,Bulbuente,1,8,-7
2002,Zaragoza,50061,Bureta,1,8,-7
2002,Zaragoza,50062,Burgo de Ebro (El),11,16,-5
2002,Zaragoza,50063,Buste (El),0,2,-2
2002,Zaragoza,50043,Bárboles,2,2,0
2002,Zaragoza,50064,Cabañas de Ebro,1,5,-4
2002,Zaragoza,50066,Cadrete,20,9,11
2002,Zaragoza,50067,Calatayud,168,215,-47
2002,Zaragoza,50068,Calatorao,21,26,-5
2002,Zaragoza,50069,Calcena,1,2,-1
2002,Zaragoza,50070,Calmarza,0,2,-2
2002,Zaragoza,50071,Campillo de Aragón,1,3,-2
2002,Zaragoza,50072,Carenas,2,4,-2
2002,Zaragoza,50073,Cariñena,29,35,-6
2002,Zaragoza,50074,Caspe,67,107,-40
2002,Zaragoza,50075,Castejón de Alarba,0,1,-1
2002,Zaragoza,50076,Castejón de las Armas,0,2,-2
2002,Zaragoza,50077,Castejón de Valdejasa,1,6,-5
2002,Zaragoza,50078,Castiliscar,1,8,-7
2002,Zaragoza,50079,Cervera de la Cañada,1,2,-1
2002,Zaragoza,50081,Cetina,2,15,-13
2002,Zaragoza,50092,Chiprana,3,3,0
2002,Zaragoza,50093,Chodes,1,1,0
2002,Zaragoza,50082,Cimballa,0,3,-3
2002,Zaragoza,50083,Cinco Olivas,0,3,-3
2002,Zaragoza,50084,Clarés de Ribota,0,2,-2
2002,Zaragoza,50085,Codo,1,7,-6
2002,Zaragoza,50086,Codos,0,4,-4
2002,Zaragoza,50087,Contamina,0,1,-1
2002,Zaragoza,50088,Cosuenda,0,11,-11
2002,Zaragoza,50089,Cuarte de Huerva,21,27,-6
2002,Zaragoza,50090,Cubel,1,3,-2
2002,Zaragoza,50091,Cuerlas (Las),1,1,0
2002,Zaragoza,50094,Daroca,14,27,-13
2002,Zaragoza,50095,Ejea de los Caballeros,102,145,-43
2002,Zaragoza,50098,Encinacorba,0,2,-2
2002,Zaragoza,50100,Erla,3,8,-5
2002,Zaragoza,50101,Escatrón,10,17,-7
2002,Zaragoza,50102,Fabara,7,21,-14
2002,Zaragoza,50104,Farlete,1,4,-3
2002,Zaragoza,50106,Fayos (Los),0,3,-3
2002,Zaragoza,50105,Fayón,0,6,-6
2002,Zaragoza,50107,Figueruelas,14,17,-3
2002,Zaragoza,50109,Frago (El),0,1,-1
2002,Zaragoza,50110,Frasno (El),1,7,-6
2002,Zaragoza,50111,Fréscano,0,3,-3
2002,Zaragoza,50113,Fuendejalón,4,10,-6
2002,Zaragoza,50114,Fuendetodos,0,3,-3
2002,Zaragoza,50115,Fuentes de Ebro,37,43,-6
2002,Zaragoza,50116,Fuentes de Jiloca,0,2,-2
2002,Zaragoza,50117,Gallocanta,0,2,-2
2002,Zaragoza,50118,Gallur,15,36,-21
2002,Zaragoza,50119,Gelsa,4,10,-6
2002,Zaragoza,50121,Gotor,6,0,6
2002,Zaragoza,50122,Grisel,0,1,-1
2002,Zaragoza,50123,Grisén,2,10,-8
2002,Zaragoza,50124,Herrera de los Navarros,2,12,-10
2002,Zaragoza,50125,Ibdes,6,5,1
2002,Zaragoza,50126,Illueca,34,24,10
2002,Zaragoza,50129,Jaraba,0,1,-1
2002,Zaragoza,50130,Jarque de Moncayo,4,10,-6
2002,Zaragoza,50131,Jaulín,0,8,-8
2002,Zaragoza,50132,Joyosa (La),4,8,-4
2002,Zaragoza,50133,Lagata,1,1,0
2002,Zaragoza,50134,Langa del Castillo,0,1,-1
2002,Zaragoza,50135,Layana,1,3,-2
2002,Zaragoza,50137,Leciñena,4,11,-7
2002,Zaragoza,50139,Letux,1,5,-4
2002,Zaragoza,50140,Litago,0,1,-1
2002,Zaragoza,50141,Lituénigo,0,1,-1
2002,Zaragoza,50142,Lobera de Onsella,0,1,-1
2002,Zaragoza,50143,Longares,2,12,-10
2002,Zaragoza,50146,Lucena de Jalón,2,3,-1
2002,Zaragoza,50147,Luceni,2,15,-13
2002,Zaragoza,50148,Luesia,0,2,-2
2002,Zaragoza,50149,Luesma,0,1,-1
2002,Zaragoza,50150,Lumpiaque,5,11,-6
2002,Zaragoza,50151,Luna,2,14,-12
2002,Zaragoza,50136,Lécera,6,23,-17
2002,Zaragoza,50152,Maella,11,22,-11
2002,Zaragoza,50153,Magallón,8,12,-4
2002,Zaragoza,50154,Mainar,1,3,-2
2002,Zaragoza,50155,Malanquilla,1,2,-1
2002,Zaragoza,50156,Maleján,2,2,0
2002,Zaragoza,50160,Mallén,20,38,-18
2002,Zaragoza,50159,Maluenda,6,6,0
2002,Zaragoza,50157,Malón,5,7,-2
2002,Zaragoza,50162,Mara,0,1,-1
2002,Zaragoza,50902,Marracos,0,3,-3
2002,Zaragoza,50163,María de Huerva,32,22,10
2002,Zaragoza,50164,Mediana de Aragón,2,7,-5
2002,Zaragoza,50165,Mequinenza,17,29,-12
2002,Zaragoza,50166,Mesones de Isuela,0,5,-5
2002,Zaragoza,50167,Mezalocha,4,3,1
2002,Zaragoza,50169,Miedes de Aragón,2,6,-4
2002,Zaragoza,50170,Monegrillo,1,2,-1
2002,Zaragoza,50171,Moneva,0,1,-1
2002,Zaragoza,50172,Monreal de Ariza,2,7,-5
2002,Zaragoza,50173,Monterde,1,1,0
2002,Zaragoza,50174,Montón,0,1,-1
2002,Zaragoza,50175,Morata de Jalón,4,18,-14
2002,Zaragoza,50176,Morata de Jiloca,0,3,-3
2002,Zaragoza,50178,Moros,3,7,-4
2002,Zaragoza,50177,Morés,2,4,-2
2002,Zaragoza,50179,Moyuela,0,2,-2
2002,Zaragoza,50180,Mozota,0,5,-5
2002,Zaragoza,50181,Muel,8,13,-5
2002,Zaragoza,50182,Muela (La),12,18,-6
2002,Zaragoza,50183,Munébrega,1,4,-3
2002,Zaragoza,50184,Murero,0,4,-4
2002,Zaragoza,50185,Murillo de Gállego,0,4,-4
2002,Zaragoza,50186,Navardún,0,2,-2
2002,Zaragoza,50187,Nigüella,0,1,-1
2002,Zaragoza,50189,Nonaspe,9,13,-4
2002,Zaragoza,50190,Novallas,4,8,-4
2002,Zaragoza,50191,Novillas,7,6,1
2002,Zaragoza,50193,Nuez de Ebro,5,4,1
2002,Zaragoza,50192,Nuévalos,5,1,4
2002,Zaragoza,50194,Olvés,1,2,-1
2002,Zaragoza,50196,Orera,0,2,-2
2002,Zaragoza,50199,Osera de Ebro,2,14,-12
2002,Zaragoza,50200,Paniza,2,10,-8
2002,Zaragoza,50201,Paracuellos de Jiloca,5,6,-1
2002,Zaragoza,50202,Paracuellos de la Ribera,0,2,-2
2002,Zaragoza,50203,Pastriz,11,6,5
2002,Zaragoza,50204,Pedrola,12,23,-11
2002,Zaragoza,50206,Perdiguera,12,4,8
2002,Zaragoza,50207,Piedratajada,0,4,-4
2002,Zaragoza,50208,Pina de Ebro,18,30,-12
2002,Zaragoza,50209,Pinseque,19,56,-37
2002,Zaragoza,50210,Pintanos (Los),0,1,-1
2002,Zaragoza,50211,Plasencia de Jalón,1,6,-5
2002,Zaragoza,50212,Pleitas,0,1,-1
2002,Zaragoza,50213,Plenas,1,1,0
2002,Zaragoza,50216,Pozuelo de Aragón,3,4,-1
2002,Zaragoza,50217,Pradilla de Ebro,4,9,-5
2002,Zaragoza,50218,Puebla de Albortón,0,3,-3
2002,Zaragoza,50219,Puebla de Alfindén (La),36,18,18
2002,Zaragoza,50222,Quinto,17,29,-12
2002,Zaragoza,50223,Remolinos,11,12,-1
2002,Zaragoza,50225,Ricla,17,24,-7
2002,Zaragoza,50227,Romanos,0,2,-2
2002,Zaragoza,50228,Rueda de Jalón,1,7,-6
2002,Zaragoza,50229,Ruesca,3,2,1
2002,Zaragoza,50231,Salillas de Jalón,2,8,-6
2002,Zaragoza,50232,Salvatierra de Esca,2,4,-2
2002,Zaragoza,50233,Samper del Salz,0,1,-1
2002,Zaragoza,50234,San Martín de la Virgen de Moncayo,1,2,-1
2002,Zaragoza,50235,San Mateo de Gállego,20,14,6
2002,Zaragoza,50236,Santa Cruz de Grío,0,4,-4
2002,Zaragoza,50237,Santa Cruz de Moncayo,0,0,0
2002,Zaragoza,50238,Santa Eulalia de Gállego,0,1,-1
2002,Zaragoza,50241,Saviñán,0,4,-4
2002,Zaragoza,50242,Sediles,0,2,-2
2002,Zaragoza,50243,Sestrica,2,5,-3
2002,Zaragoza,50244,Sierra de Luna,2,5,-3
2002,Zaragoza,50245,Sigüés,0,1,-1
2002,Zaragoza,50246,Sisamón,0,1,-1
2002,Zaragoza,50247,Sobradiel,8,12,-4
2002,Zaragoza,50248,Sos del Rey Católico,3,16,-13
2002,Zaragoza,50230,Sádaba,10,29,-19
2002,Zaragoza,50240,Sástago,2,14,-12
2002,Zaragoza,50249,Tabuenca,3,8,-5
2002,Zaragoza,50250,Talamantes,0,1,-1
2002,Zaragoza,50251,Tarazona,91,148,-57
2002,Zaragoza,50252,Tauste,65,92,-27
2002,Zaragoza,50253,Terrer,2,13,-11
2002,Zaragoza,50254,Tierga,0,1,-1
2002,Zaragoza,50255,Tobed,0,6,-6
2002,Zaragoza,50256,Torralba de los Frailes,1,2,-1
2002,Zaragoza,50257,Torralba de Ribota,0,4,-4
2002,Zaragoza,50258,Torralbilla,0,3,-3
2002,Zaragoza,50259,Torrehermosa,0,1,-1
2002,Zaragoza,50260,Torrelapaja,0,0,0
2002,Zaragoza,50261,Torrellas,0,5,-5
2002,Zaragoza,50262,Torres de Berrellén,14,15,-1
2002,Zaragoza,50263,Torrijo de la Cañada,1,10,-9
2002,Zaragoza,50264,Tosos,1,4,-3
2002,Zaragoza,50265,Trasmoz,0,1,-1
2002,Zaragoza,50266,Trasobares,0,6,-6
2002,Zaragoza,50267,Uncastillo,6,17,-11
2002,Zaragoza,50269,Urrea de Jalón,2,5,-3
2002,Zaragoza,50270,Urriés,0,2,-2
2002,Zaragoza,50271,Used,1,4,-3
2002,Zaragoza,50272,Utebo,151,75,76
2002,Zaragoza,50274,Val de San Martín,1,0,1
2002,Zaragoza,50273,Valdehorna,0,2,-2
2002,Zaragoza,50275,Valmadrid,1,1,0
2002,Zaragoza,50276,Valpalmas,0,1,-1
2002,Zaragoza,50277,Valtorres,0,1,-1
2002,Zaragoza,50278,Velilla de Ebro,3,1,2
2002,Zaragoza,50279,Velilla de Jiloca,0,2,-2
2002,Zaragoza,50280,Vera de Moncayo,0,7,-7
2002,Zaragoza,50281,Vierlas,2,0,2
2002,Zaragoza,50283,Villadoz,0,1,-1
2002,Zaragoza,50284,Villafeliche,2,6,-4
2002,Zaragoza,50285,Villafranca de Ebro,8,6,2
2002,Zaragoza,50286,Villalba de Perejil,0,3,-3
2002,Zaragoza,50287,Villalengua,1,9,-8
2002,Zaragoza,50288,Villanueva de Gállego,59,40,19
2002,Zaragoza,50290,Villanueva de Huerva,3,7,-4
2002,Zaragoza,50291,Villar de los Navarros,0,4,-4
2002,Zaragoza,50292,Villarreal de Huerva,2,1,1
2002,Zaragoza,50293,Villarroya de la Sierra,2,8,-6
2002,Zaragoza,50282,Vilueña (La),0,1,-1
2002,Zaragoza,50295,Vistabella,0,1,-1
2002,Zaragoza,50296,Zaida (La),2,7,-5
2002,Zaragoza,50297,Zaragoza,5952,5798,154
2002,Zaragoza,50298,Zuera,47,59,-12
2002,Zaragoza,50099,Épila,43,44,-1
2001,Huesca,22001,Abiego,2,6,-4
2001,Huesca,22002,Abizanda,0,2,-2
2001,Huesca,22003,Adahuesca,1,3,-2
2001,Huesca,22004,Agüero,1,6,-5
2001,Huesca,22007,Albalate de Cinca,5,9,-4
2001,Huesca,22008,Albalatillo,2,4,-2
2001,Huesca,22009,Albelda,1,11,-10
2001,Huesca,22011,Albero Alto,0,1,-1
2001,Huesca,22012,Albero Bajo,0,1,-1
2001,Huesca,22013,Alberuela de Tubo,1,3,-2
2001,Huesca,22014,Alcalá de Gurrea,1,11,-10
2001,Huesca,22015,Alcalá del Obispo,0,6,-6
2001,Huesca,22016,Alcampell,5,17,-12
2001,Huesca,22017,Alcolea de Cinca,10,12,-2
2001,Huesca,22018,Alcubierre,2,7,-5
2001,Huesca,22019,Alerre,0,2,-2
2001,Huesca,22020,Alfántega,1,4,-3
2001,Huesca,22021,Almudévar,10,31,-21
2001,Huesca,22022,Almunia de San Juan,1,5,-4
2001,Huesca,22023,Almuniente,3,7,-4
2001,Huesca,22024,Alquézar,1,4,-3
2001,Huesca,22025,Altorricón,8,19,-11
2001,Huesca,22027,Angüés,4,15,-11
2001,Huesca,22028,Ansó,4,12,-8
2001,Huesca,22029,Antillón,0,1,-1
2001,Huesca,22032,Aragüés del Puerto,1,2,-1
2001,Huesca,22035,Arén,1,5,-4
2001,Huesca,22039,Ayerbe,4,19,-15
2001,Huesca,22040,Azanuy-Alins,1,1,0
2001,Huesca,22041,Azara,0,1,-1
2001,Huesca,22042,Azlor,1,2,-1
2001,Huesca,22907,Aínsa-Sobrarbe,22,19,3
2001,Huesca,22006,Aísa,2,5,-3
2001,Huesca,22043,Baells,0,4,-4
2001,Huesca,22044,Bailo,1,4,-3
2001,Huesca,22045,Baldellou,0,3,-3
2001,Huesca,22046,Ballobar,6,19,-13
2001,Huesca,22047,Banastás,1,0,1
2001,Huesca,22048,Barbastro,161,189,-28
2001,Huesca,22049,Barbués,2,6,-4
2001,Huesca,22050,Barbuñales,0,1,-1
2001,Huesca,22052,Belver de Cinca,10,21,-11
2001,Huesca,22053,Benabarre,5,19,-14
2001,Huesca,22054,Benasque,16,11,5
2001,Huesca,22246,Beranuy,0,1,-1
2001,Huesca,22055,Berbegal,2,7,-5
2001,Huesca,22057,Bielsa,4,3,1
2001,Huesca,22058,Bierge,1,4,-3
2001,Huesca,22059,Biescas,12,21,-9
2001,Huesca,22060,Binaced,11,16,-5
2001,Huesca,22061,Binéfar,79,80,-1
2001,Huesca,22062,Bisaurri,1,0,1
2001,Huesca,22063,Biscarrués,2,2,0
2001,Huesca,22064,Blecua y Torres,1,2,-1
2001,Huesca,22066,Boltaña,4,11,-7
2001,Huesca,22067,Bonansa,0,1,-1
2001,Huesca,22069,Broto,6,6,0
2001,Huesca,22072,Caldearenas,0,1,-1
2001,Huesca,22074,Campo,0,4,-4
2001,Huesca,22075,Camporrells,1,6,-5
2001,Huesca,22076,Canal de Berdún,1,1,0
2001,Huesca,22077,Candasnos,3,10,-7
2001,Huesca,22078,Canfranc,5,2,3
2001,Huesca,22079,Capdesaso,0,2,-2
2001,Huesca,22080,Capella,7,8,-1
2001,Huesca,22081,Casbas de Huesca,0,3,-3
2001,Huesca,22083,Castejón de Monegros,5,13,-8
2001,Huesca,22084,Castejón de Sos,12,7,5
2001,Huesca,22082,Castejón del Puente,3,3,0
2001,Huesca,22085,Castelflorite,1,3,-2
2001,Huesca,22086,Castiello de Jaca,1,1,0
2001,Huesca,22087,Castigaleu,1,0,1
2001,Huesca,22088,Castillazuelo,2,3,-1
2001,Huesca,22089,Castillonroy,3,3,0
2001,Huesca,22094,Chalamera,0,3,-3
2001,Huesca,22096,Chimillas,0,1,-1
2001,Huesca,22095,Chía,0,1,-1
2001,Huesca,22090,Colungo,0,1,-1
2001,Huesca,22099,Esplús,3,7,-4
2001,Huesca,22102,Estada,0,1,-1
2001,Huesca,22103,Estadilla,2,12,-10
2001,Huesca,22105,Estopiñán del Castillo,3,4,-1
2001,Huesca,22107,Fanlo,1,0,1
2001,Huesca,22109,Fiscal,1,1,0
2001,Huesca,22110,Fonz,9,26,-17
2001,Huesca,22111,Foradada del Toscar,1,2,-1
2001,Huesca,22112,Fraga,112,114,-2
2001,Huesca,22113,Fueva (La),3,4,-1
2001,Huesca,22114,Gistaín,0,4,-4
2001,Huesca,22115,Grado (El),2,4,-2
2001,Huesca,22117,Graus,21,51,-30
2001,Huesca,22116,Grañén,6,23,-17
2001,Huesca,22119,Gurrea de Gállego,4,22,-18
2001,Huesca,22122,Hoz de Jaca,0,1,-1
2001,Huesca,22908,Hoz y Costeán,1,6,-5
2001,Huesca,22124,Huerto,0,6,-6
2001,Huesca,22125,Huesca,481,462,19
2001,Huesca,22126,Ibieca,0,2,-2
2001,Huesca,22127,Igriés,0,16,-16
2001,Huesca,22128,Ilche,1,2,-1
2001,Huesca,22129,Isábena,0,3,-3
2001,Huesca,22130,Jaca,100,142,-42
2001,Huesca,22131,Jasa,0,1,-1
2001,Huesca,22133,Labuerda,0,2,-2
2001,Huesca,22135,Laluenga,2,6,-4
2001,Huesca,22136,Lalueza,7,11,-4
2001,Huesca,22137,Lanaja,5,20,-15
2001,Huesca,22139,Laperdiguera,1,2,-1
2001,Huesca,22141,Lascellas-Ponzano,2,2,0
2001,Huesca,22142,Lascuarre,0,6,-6
2001,Huesca,22143,Laspaúles,1,2,-1
2001,Huesca,22144,Laspuña,0,3,-3
2001,Huesca,22149,Loarre,0,6,-6
2001,Huesca,22150,Loporzano,2,4,-2
2001,Huesca,22151,Loscorrales,0,2,-2
2001,Huesca,22905,Lupiñén-Ortilla,3,4,-1
2001,Huesca,22156,Monflorite-Lascasas,0,1,-1
2001,Huesca,22157,Montanuy,1,4,-3
2001,Huesca,22158,Monzón,147,160,-13
2001,Huesca,22160,Naval,1,5,-4
2001,Huesca,22162,Novales,1,0,1
2001,Huesca,22163,Nueno,0,1,-1
2001,Huesca,22164,Olvena,0,1,-1
2001,Huesca,22165,Ontiñena,5,11,-6
2001,Huesca,22167,Osso de Cinca,1,9,-8
2001,Huesca,22168,Palo,1,0,1
2001,Huesca,22170,Panticosa,5,2,3
2001,Huesca,22174,Peralta de Alcofea,4,15,-11
2001,Huesca,22175,Peralta de Calasanz,1,8,-7
2001,Huesca,22176,Peraltilla,0,2,-2
2001,Huesca,22177,Perarrúa,0,1,-1
2001,Huesca,22178,Pertusa,1,5,-4
2001,Huesca,22172,Peñalba,3,6,-3
2001,Huesca,22173,Peñas de Riglos (Las),0,1,-1
2001,Huesca,22181,Piracés,1,1,0
2001,Huesca,22182,Plan,1,4,-3
2001,Huesca,22184,Poleñino,0,8,-8
2001,Huesca,22186,Pozán de Vero,1,3,-2
2001,Huesca,22187,Puebla de Castro (La),1,4,-3
2001,Huesca,22188,Puente de Montañana,0,2,-2
2001,Huesca,22902,Puente la Reina de Jaca,0,2,-2
2001,Huesca,22190,Pueyo de Araguás (El),1,1,0
2001,Huesca,22193,Pueyo de Santa Cruz,1,2,-1
2001,Huesca,22189,Puértolas,3,4,-1
2001,Huesca,22195,Quicena,1,9,-8
2001,Huesca,22197,Robres,1,10,-9
2001,Huesca,22199,Sabiñánigo,76,83,-7
2001,Huesca,22200,Sahún,1,4,-3
2001,Huesca,22201,Salas Altas,0,3,-3
2001,Huesca,22202,Salas Bajas,1,0,1
2001,Huesca,22203,Salillas,0,1,-1
2001,Huesca,22204,Sallent de Gállego,17,9,8
2001,Huesca,22205,San Esteban de Litera,1,6,-5
2001,Huesca,22207,San Juan de Plan,1,4,-3
2001,Huesca,22903,San Miguel del Cinca,6,23,-17
2001,Huesca,22206,Sangarrén,1,2,-1
2001,Huesca,22208,Santa Cilia,1,3,-2
2001,Huesca,22209,Santa Cruz de la Serós,0,1,-1
2001,Huesca,22906,Santa María de Dulcis,2,3,-1
2001,Huesca,22212,Santaliestra y San Quílez,0,4,-4
2001,Huesca,22213,Sariñena,20,47,-27
2001,Huesca,22214,Secastilla,0,1,-1
2001,Huesca,22215,Seira,2,2,0
2001,Huesca,22217,Sena,4,10,-6
2001,Huesca,22220,Sesa,2,3,-1
2001,Huesca,22221,Sesué,2,1,1
2001,Huesca,22222,Siétamo,3,7,-4
2001,Huesca,22223,Sopeira,0,5,-5
2001,Huesca,22904,Sotonera (La),5,12,-7
2001,Huesca,22225,Tamarite de Litera,26,49,-23
2001,Huesca,22226,Tardienta,7,13,-6
2001,Huesca,22227,Tella-Sin,2,3,-1
2001,Huesca,22228,Tierz,2,2,0
2001,Huesca,22229,Tolva,1,3,-2
2001,Huesca,22230,Torla-Ordesa,3,4,-1
2001,Huesca,22232,Torralba de Aragón,0,1,-1
2001,Huesca,22233,Torre la Ribera,1,1,0
2001,Huesca,22234,Torrente de Cinca,4,17,-13
2001,Huesca,22236,Torres de Barbués,2,5,-3
2001,Huesca,22239,Tramaced,0,1,-1
2001,Huesca,22242,Valfarta,1,0,1
2001,Huesca,22901,Valle de Hecho,5,12,-7
2001,Huesca,22244,Valle de Lierp,0,1,-1
2001,Huesca,22245,Velilla de Cinca,1,9,-8
2001,Huesca,22909,Vencillón,2,3,-1
2001,Huesca,22247,Viacamp y Litera,1,1,0
2001,Huesca,22248,Vicién,0,1,-1
2001,Huesca,22251,Villanueva de Sigena,5,2,3
2001,Huesca,22250,Villanúa,2,2,0
2001,Huesca,22253,Yésero,0,1,-1
2001,Huesca,22254,Zaidín,17,19,-2
2001,Teruel,44001,Ababuj,1,1,0
2001,Teruel,44002,Abejuela,0,1,-1
2001,Teruel,44003,Aguatón,0,1,-1
2001,Teruel,44004,Aguaviva,3,10,-7
2001,Teruel,44005,Aguilar del Alfambra,0,0,0
2001,Teruel,44006,Alacón,4,4,0
2001,Teruel,44007,Alba,1,1,0
2001,Teruel,44008,Albalate del Arzobispo,15,30,-15
2001,Teruel,44009,Albarracín,11,15,-4
2001,Teruel,44010,Albentosa,2,1,1
2001,Teruel,44012,Alcalá de la Selva,5,12,-7
2001,Teruel,44013,Alcañiz,149,168,-19
2001,Teruel,44014,Alcorisa,38,30,8
2001,Teruel,44016,Alfambra,0,9,-9
2001,Teruel,44017,Aliaga,3,7,-4
2001,Teruel,44021,Allepuz,1,2,-1
2001,Teruel,44022,Alloza,2,17,-15
2001,Teruel,44018,Almohaja,0,1,-1
2001,Teruel,44019,Alobras,0,3,-3
2001,Teruel,44020,Alpeñés,1,0,1
2001,Teruel,44025,Andorra,68,59,9
2001,Teruel,44026,Arcos de las Salinas,0,1,-1
2001,Teruel,44027,Arens de Lledó,1,8,-7
2001,Teruel,44028,Argente,0,2,-2
2001,Teruel,44029,Ariño,3,10,-7
2001,Teruel,44031,Azaila,0,2,-2
2001,Teruel,44035,Barrachina,0,1,-1
2001,Teruel,44034,Bañón,1,3,-2
2001,Teruel,44037,Beceite,5,10,-5
2001,Teruel,44039,Bello,4,4,0
2001,Teruel,44038,Belmonte de San José,2,3,-1
2001,Teruel,44040,Berge,3,1,2
2001,Teruel,44042,Blancas,1,2,-1
2001,Teruel,44043,Blesa,0,1,-1
2001,Teruel,44044,Bordón,1,1,0
2001,Teruel,44045,Bronchales,3,7,-4
2001,Teruel,44046,Bueña,0,1,-1
2001,Teruel,44047,Burbáguena,1,5,-4
2001,Teruel,44032,Bádenas,0,2,-2
2001,Teruel,44033,Báguena,5,8,-3
2001,Teruel,44048,Cabra de Mora,0,1,-1
2001,Teruel,44049,Calaceite,5,11,-6
2001,Teruel,44050,Calamocha,27,37,-10
2001,Teruel,44051,Calanda,35,45,-10
2001,Teruel,44052,Calomarde,0,1,-1
2001,Teruel,44054,Camarena de la Sierra,1,2,-1
2001,Teruel,44055,Camarillas,0,3,-3
2001,Teruel,44053,Camañas,1,2,-1
2001,Teruel,44056,Caminreal,1,13,-12
2001,Teruel,44059,Cantavieja,6,13,-7
2001,Teruel,44064,Cascante del Río,0,0,0
2001,Teruel,44065,Castejón de Tornos,1,3,-2
2001,Teruel,44066,Castel de Cabra,0,1,-1
2001,Teruel,44070,Castellar (El),0,1,-1
2001,Teruel,44071,Castellote,2,12,-10
2001,Teruel,44067,Castelnou,1,0,1
2001,Teruel,44068,Castelserás,5,13,-8
2001,Teruel,44060,Cañada de Benatanduz,0,1,-1
2001,Teruel,44061,Cañada de Verich (La),3,1,2
2001,Teruel,44062,Cañada Vellida,0,1,-1
2001,Teruel,44063,Cañizar del Olivar,0,1,-1
2001,Teruel,44074,Cedrillas,1,11,-10
2001,Teruel,44075,Celadas,3,4,-1
2001,Teruel,44076,Cella,7,40,-33
2001,Teruel,44080,Codoñera (La),0,4,-4
2001,Teruel,44082,Corbalán,0,1,-1
2001,Teruel,44085,Cosa,1,1,0
2001,Teruel,44086,Cretas,4,7,-3
2001,Teruel,44087,Crivillén,0,3,-3
2001,Teruel,44088,Cuba (La),0,4,-4
2001,Teruel,44089,Cubla,0,3,-3
2001,Teruel,44090,Cucalón,0,1,-1
2001,Teruel,44092,Cuervo (El),0,1,-1
2001,Teruel,44093,Cuevas de Almudén,1,3,-2
2001,Teruel,44094,Cuevas Labradas,0,5,-5
2001,Teruel,44096,Ejulve,1,2,-1
2001,Teruel,44097,Escorihuela,0,3,-3
2001,Teruel,44099,Escucha,13,11,2
2001,Teruel,44100,Estercuel,1,9,-8
2001,Teruel,44101,Ferreruela de Huerva,0,1,-1
2001,Teruel,44103,Formiche Alto,2,2,0
2001,Teruel,44106,Fortanete,2,2,0
2001,Teruel,44107,Foz-Calanda,1,1,0
2001,Teruel,44108,Fresneda (La),0,3,-3
2001,Teruel,44109,Frías de Albarracín,1,3,-2
2001,Teruel,44110,Fuenferrada,0,1,-1
2001,Teruel,44111,Fuentes Calientes,0,2,-2
2001,Teruel,44112,Fuentes Claras,2,9,-7
2001,Teruel,44113,Fuentes de Rubielos,2,0,2
2001,Teruel,44114,Fuentespalda,1,4,-3
2001,Teruel,44105,Fórnoles,0,4,-4
2001,Teruel,44115,Galve,4,2,2
2001,Teruel,44116,Gargallo,2,1,1
2001,Teruel,44117,Gea de Albarracín,1,7,-6
2001,Teruel,44118,Ginebrosa (La),3,5,-2
2001,Teruel,44119,Griegos,0,0,0
2001,Teruel,44120,Guadalaviar,1,3,-2
2001,Teruel,44121,Gúdar,0,1,-1
2001,Teruel,44123,Hinojosa de Jarque,2,1,1
2001,Teruel,44124,Hoz de la Vieja (La),0,2,-2
2001,Teruel,44122,Híjar,17,31,-14
2001,Teruel,44126,Iglesuela del Cid (La),5,5,0
2001,Teruel,44128,Jarque de la Val,0,2,-2
2001,Teruel,44129,Jatiel,0,1,-1
2001,Teruel,44130,Jorcas,0,1,-1
2001,Teruel,44131,Josa,0,1,-1
2001,Teruel,44132,Lagueruela,0,2,-2
2001,Teruel,44135,Libros,1,4,-3
2001,Teruel,44136,Lidón,0,2,-2
2001,Teruel,44137,Linares de Mora,2,1,1
2001,Teruel,44141,Lledó,1,1,0
2001,Teruel,44138,Loscos,0,2,-2
2001,Teruel,44143,Manzanera,3,6,-3
2001,Teruel,44144,Martín del Río,3,5,-2
2001,Teruel,44145,Mas de las Matas,5,25,-20
2001,Teruel,44147,Mazaleón,5,7,-2
2001,Teruel,44148,Mezquita de Jarque,1,1,0
2001,Teruel,44149,Mirambel,0,1,-1
2001,Teruel,44150,Miravete de la Sierra,0,1,-1
2001,Teruel,44151,Molinos,0,5,-5
2001,Teruel,44153,Monreal del Campo,23,21,2
2001,Teruel,44154,Monroyo,0,4,-4
2001,Teruel,44155,Montalbán,10,14,-4
2001,Teruel,44157,Monterde de Albarracín,0,1,-1
2001,Teruel,44158,Mora de Rubielos,13,23,-10
2001,Teruel,44160,Mosqueruela,5,9,-4
2001,Teruel,44161,Muniesa,4,13,-9
2001,Teruel,44163,Noguera de Albarracín,0,1,-1
2001,Teruel,44165,Nogueruelas,0,4,-4
2001,Teruel,44167,Obón,0,1,-1
2001,Teruel,44168,Odón,1,4,-3
2001,Teruel,44169,Ojos Negros,0,5,-5
2001,Teruel,44171,Olba,0,2,-2
2001,Teruel,44172,Oliete,1,7,-6
2001,Teruel,44173,Olmos (Los),3,2,1
2001,Teruel,44174,Orihuela del Tremedal,7,9,-2
2001,Teruel,44176,Palomar de Arroyos,1,0,1
2001,Teruel,44177,Pancrudo,0,5,-5
2001,Teruel,44178,Parras de Castellote (Las),0,3,-3
2001,Teruel,44180,Peracense,0,1,-1
2001,Teruel,44181,Peralejos,0,2,-2
2001,Teruel,44182,Perales del Alfambra,1,2,-1
2001,Teruel,44179,Peñarroya de Tastavins,5,4,1
2001,Teruel,44183,Pitarque,2,0,2
2001,Teruel,44184,Plou,0,1,-1
2001,Teruel,44185,Pobo (El),0,1,-1
2001,Teruel,44187,Portellada (La),0,8,-8
2001,Teruel,44189,Pozondón,0,1,-1
2001,Teruel,44190,Pozuel del Campo,0,3,-3
2001,Teruel,44191,Puebla de Híjar (La),0,11,-11
2001,Teruel,44192,Puebla de Valverde (La),4,1,3
2001,Teruel,44193,Puertomingalvo,0,0,0
2001,Teruel,44195,Rillo,1,1,0
2001,Teruel,44196,Riodeva,1,4,-3
2001,Teruel,44198,Royuela,3,5,-2
2001,Teruel,44200,Rubielos de la Cérida,0,3,-3
2001,Teruel,44201,Rubielos de Mora,4,9,-5
2001,Teruel,44194,Ráfales,0,3,-3
2001,Teruel,44197,Ródenas,0,2,-2
2001,Teruel,44204,Saldón,0,4,-4
2001,Teruel,44205,Samper de Calanda,6,17,-11
2001,Teruel,44206,San Agustín,1,1,0
2001,Teruel,44207,San Martín del Río,0,3,-3
2001,Teruel,44208,Santa Cruz de Nogueras,0,1,-1
2001,Teruel,44209,Santa Eulalia,3,10,-7
2001,Teruel,44210,Sarrión,3,17,-14
2001,Teruel,44211,Segura de los Baños,0,2,-2
2001,Teruel,44212,Seno,0,1,-1
2001,Teruel,44213,Singra,1,3,-2
2001,Teruel,44215,Terriente,0,1,-1
2001,Teruel,44216,Teruel,301,348,-47
2001,Teruel,44217,Toril y Masegoso,0,0,0
2001,Teruel,44219,Tornos,0,1,-1
2001,Teruel,44220,Torralba de los Sisones,0,2,-2
2001,Teruel,44224,Torre de las Arcas,0,1,-1
2001,Teruel,44225,Torre del Compte,0,1,-1
2001,Teruel,44227,Torre los Negros,0,1,-1
2001,Teruel,44221,Torrecilla de Alcañiz,1,1,0
2001,Teruel,44222,Torrecilla del Rebollar,1,1,0
2001,Teruel,44226,Torrelacárcel,1,4,-3
2001,Teruel,44229,Torres de Albarracín,0,1,-1
2001,Teruel,44230,Torrevelilla,0,4,-4
2001,Teruel,44231,Torrijas,0,1,-1
2001,Teruel,44232,Torrijo del Campo,3,3,0
2001,Teruel,44234,Tramacastiel,0,2,-2
2001,Teruel,44235,Tramacastilla,0,1,-1
2001,Teruel,44236,Tronchón,1,1,0
2001,Teruel,44237,Urrea de Gaén,3,9,-6
2001,Teruel,44238,Utrillas,20,27,-7
2001,Teruel,44240,Valbona,2,3,-1
2001,Teruel,44241,Valdealgorfa,3,11,-8
2001,Teruel,44243,Valdecuenca,0,1,-1
2001,Teruel,44244,Valdelinares,2,1,1
2001,Teruel,44245,Valdeltormo,1,7,-6
2001,Teruel,44246,Valderrobres,15,21,-6
2001,Teruel,44247,Valjunquera,4,9,-5
2001,Teruel,44249,Vallecillo (El),0,1,-1
2001,Teruel,44251,Villafranca del Campo,3,2,1
2001,Teruel,44252,Villahermosa del Campo,0,1,-1
2001,Teruel,44256,Villanueva del Rebollar de la Sierra,2,1,1
2001,Teruel,44257,Villar del Cobo,1,2,-1
2001,Teruel,44258,Villar del Salz,1,2,-1
2001,Teruel,44260,Villarluengo,0,1,-1
2001,Teruel,44261,Villarquemado,6,13,-7
2001,Teruel,44262,Villarroya de los Pinares,3,0,3
2001,Teruel,44263,Villastar,2,6,-4
2001,Teruel,44264,Villel,1,2,-1
2001,Teruel,44265,Vinaceite,1,4,-3
2001,Teruel,44266,Visiedo,1,4,-3
2001,Teruel,44267,Vivel del Río Martín,0,4,-4
2001,Zaragoza,50001,Abanto,0,4,-4
2001,Zaragoza,50002,Acered,1,3,-2
2001,Zaragoza,50004,Aguarón,2,15,-13
2001,Zaragoza,50005,Aguilón,0,4,-4
2001,Zaragoza,50003,Agón,0,1,-1
2001,Zaragoza,50006,Ainzón,7,14,-7
2001,Zaragoza,50007,Aladrén,1,3,-2
2001,Zaragoza,50008,Alagón,55,77,-22
2001,Zaragoza,50009,Alarba,0,2,-2
2001,Zaragoza,50010,Alberite de San Juan,2,2,0
2001,Zaragoza,50011,Albeta,1,3,-2
2001,Zaragoza,50012,Alborge,0,1,-1
2001,Zaragoza,50013,Alcalá de Ebro,0,6,-6
2001,Zaragoza,50014,Alcalá de Moncayo,0,2,-2
2001,Zaragoza,50015,Alconchel de Ariza,0,2,-2
2001,Zaragoza,50017,Alfajarín,13,18,-5
2001,Zaragoza,50018,Alfamén,6,13,-7
2001,Zaragoza,50019,Alforque,0,2,-2
2001,Zaragoza,50020,Alhama de Aragón,5,10,-5
2001,Zaragoza,50021,Almochuel,0,1,-1
2001,Zaragoza,50022,Almolda (La),4,9,-5
2001,Zaragoza,50023,Almonacid de la Cuba,2,5,-3
2001,Zaragoza,50024,Almonacid de la Sierra,1,10,-9
2001,Zaragoza,50025,Almunia de Doña Godina (La),67,58,9
2001,Zaragoza,50026,Alpartir,4,4,0
2001,Zaragoza,50027,Ambel,2,4,-2
2001,Zaragoza,50028,Anento,2,1,1
2001,Zaragoza,50029,Aniñón,1,14,-13
2001,Zaragoza,50031,Aranda de Moncayo,0,2,-2
2001,Zaragoza,50033,Ardisa,1,0,1
2001,Zaragoza,50034,Ariza,8,16,-8
2001,Zaragoza,50035,Artieda,1,0,1
2001,Zaragoza,50032,Arándiga,5,7,-2
2001,Zaragoza,50037,Atea,0,2,-2
2001,Zaragoza,50038,Ateca,9,20,-11
2001,Zaragoza,50039,Azuara,4,19,-15
2001,Zaragoza,50030,Añón de Moncayo,0,1,-1
2001,Zaragoza,50040,Badules,0,2,-2
2001,Zaragoza,50041,Bagüés,0,1,-1
2001,Zaragoza,50044,Bardallur,3,11,-8
2001,Zaragoza,50045,Belchite,13,26,-13
2001,Zaragoza,50046,Belmonte de Gracián,0,6,-6
2001,Zaragoza,50047,Berdejo,1,0,1
2001,Zaragoza,50901,Biel,1,4,-3
2001,Zaragoza,50050,Bijuesca,1,1,0
2001,Zaragoza,50051,Biota,9,14,-5
2001,Zaragoza,50052,Bisimbre,0,1,-1
2001,Zaragoza,50053,Boquiñeni,4,11,-7
2001,Zaragoza,50054,Bordalba,0,1,-1
2001,Zaragoza,50055,Borja,49,63,-14
2001,Zaragoza,50056,Botorrita,1,6,-5
2001,Zaragoza,50057,Brea de Aragón,17,16,1
2001,Zaragoza,50058,Bubierca,0,2,-2
2001,Zaragoza,50059,Bujaraloz,12,12,0
2001,Zaragoza,50060,Bulbuente,2,9,-7
2001,Zaragoza,50061,Bureta,3,6,-3
2001,Zaragoza,50062,Burgo de Ebro (El),21,8,13
2001,Zaragoza,50043,Bárboles,5,10,-5
2001,Zaragoza,50064,Cabañas de Ebro,1,4,-3
2001,Zaragoza,50065,Cabolafuente,1,0,1
2001,Zaragoza,50066,Cadrete,19,7,12
2001,Zaragoza,50067,Calatayud,183,208,-25
2001,Zaragoza,50068,Calatorao,19,38,-19
2001,Zaragoza,50069,Calcena,0,3,-3
2001,Zaragoza,50070,Calmarza,0,1,-1
2001,Zaragoza,50071,Campillo de Aragón,0,3,-3
2001,Zaragoza,50072,Carenas,1,5,-4
2001,Zaragoza,50073,Cariñena,28,20,8
2001,Zaragoza,50074,Caspe,70,110,-40
2001,Zaragoza,50075,Castejón de Alarba,0,2,-2
2001,Zaragoza,50076,Castejón de las Armas,0,1,-1
2001,Zaragoza,50077,Castejón de Valdejasa,3,4,-1
2001,Zaragoza,50078,Castiliscar,0,5,-5
2001,Zaragoza,50079,Cervera de la Cañada,0,5,-5
2001,Zaragoza,50081,Cetina,4,15,-11
2001,Zaragoza,50092,Chiprana,1,6,-5
2001,Zaragoza,50093,Chodes,0,2,-2
2001,Zaragoza,50082,Cimballa,1,1,0
2001,Zaragoza,50083,Cinco Olivas,0,4,-4
2001,Zaragoza,50084,Clarés de Ribota,0,3,-3
2001,Zaragoza,50085,Codo,1,3,-2
2001,Zaragoza,50086,Codos,0,5,-5
2001,Zaragoza,50087,Contamina,0,1,-1
2001,Zaragoza,50088,Cosuenda,2,9,-7
2001,Zaragoza,50089,Cuarte de Huerva,22,27,-5
2001,Zaragoza,50090,Cubel,1,3,-2
2001,Zaragoza,50094,Daroca,12,41,-29
2001,Zaragoza,50095,Ejea de los Caballeros,144,161,-17
2001,Zaragoza,50096,Embid de Ariza,0,4,-4
2001,Zaragoza,50098,Encinacorba,0,2,-2
2001,Zaragoza,50100,Erla,1,7,-6
2001,Zaragoza,50101,Escatrón,5,13,-8
2001,Zaragoza,50102,Fabara,8,13,-5
2001,Zaragoza,50104,Farlete,2,7,-5
2001,Zaragoza,50106,Fayos (Los),0,2,-2
2001,Zaragoza,50105,Fayón,3,6,-3
2001,Zaragoza,50107,Figueruelas,9,10,-1
2001,Zaragoza,50108,Fombuena,0,1,-1
2001,Zaragoza,50109,Frago (El),0,1,-1
2001,Zaragoza,50110,Frasno (El),0,6,-6
2001,Zaragoza,50111,Fréscano,0,8,-8
2001,Zaragoza,50113,Fuendejalón,6,14,-8
2001,Zaragoza,50114,Fuendetodos,0,2,-2
2001,Zaragoza,50115,Fuentes de Ebro,42,32,10
2001,Zaragoza,50116,Fuentes de Jiloca,2,2,0
2001,Zaragoza,50117,Gallocanta,0,1,-1
2001,Zaragoza,50118,Gallur,21,26,-5
2001,Zaragoza,50119,Gelsa,6,11,-5
2001,Zaragoza,50121,Gotor,3,5,-2
2001,Zaragoza,50122,Grisel,0,3,-3
2001,Zaragoza,50123,Grisén,0,6,-6
2001,Zaragoza,50124,Herrera de los Navarros,1,12,-11
2001,Zaragoza,50125,Ibdes,5,6,-1
2001,Zaragoza,50126,Illueca,30,18,12
2001,Zaragoza,50128,Isuerre,1,4,-3
2001,Zaragoza,50129,Jaraba,2,2,0
2001,Zaragoza,50130,Jarque de Moncayo,3,11,-8
2001,Zaragoza,50131,Jaulín,0,6,-6
2001,Zaragoza,50132,Joyosa (La),5,9,-4
2001,Zaragoza,50133,Lagata,0,3,-3
2001,Zaragoza,50134,Langa del Castillo,0,3,-3
2001,Zaragoza,50135,Layana,0,4,-4
2001,Zaragoza,50138,Lechón,1,1,0
2001,Zaragoza,50137,Leciñena,2,10,-8
2001,Zaragoza,50139,Letux,5,4,1
2001,Zaragoza,50140,Litago,0,2,-2
2001,Zaragoza,50141,Lituénigo,0,1,-1
2001,Zaragoza,50142,Lobera de Onsella,0,1,-1
2001,Zaragoza,50143,Longares,7,8,-1
2001,Zaragoza,50146,Lucena de Jalón,0,4,-4
2001,Zaragoza,50147,Luceni,10,13,-3
2001,Zaragoza,50148,Luesia,0,2,-2
2001,Zaragoza,50149,Luesma,1,0,1
2001,Zaragoza,50150,Lumpiaque,5,13,-8
2001,Zaragoza,50151,Luna,6,20,-14
2001,Zaragoza,50136,Lécera,6,17,-11
2001,Zaragoza,50152,Maella,7,25,-18
2001,Zaragoza,50153,Magallón,5,16,-11
2001,Zaragoza,50154,Mainar,2,3,-1
2001,Zaragoza,50155,Malanquilla,0,2,-2
2001,Zaragoza,50156,Maleján,1,7,-6
2001,Zaragoza,50160,Mallén,18,43,-25
2001,Zaragoza,50159,Maluenda,6,10,-4
2001,Zaragoza,50157,Malón,4,11,-7
2001,Zaragoza,50161,Manchones,0,2,-2
2001,Zaragoza,50162,Mara,0,4,-4
2001,Zaragoza,50163,María de Huerva,17,11,6
2001,Zaragoza,50164,Mediana de Aragón,3,7,-4
2001,Zaragoza,50165,Mequinenza,22,40,-18
2001,Zaragoza,50166,Mesones de Isuela,4,2,2
2001,Zaragoza,50167,Mezalocha,1,3,-2
2001,Zaragoza,50168,Mianos,1,1,0
2001,Zaragoza,50169,Miedes de Aragón,2,4,-2
2001,Zaragoza,50170,Monegrillo,2,2,0
2001,Zaragoza,50171,Moneva,0,1,-1
2001,Zaragoza,50172,Monreal de Ariza,1,1,0
2001,Zaragoza,50173,Monterde,1,4,-3
2001,Zaragoza,50174,Montón,0,5,-5
2001,Zaragoza,50175,Morata de Jalón,5,22,-17
2001,Zaragoza,50176,Morata de Jiloca,0,7,-7
2001,Zaragoza,50178,Moros,0,10,-10
2001,Zaragoza,50177,Morés,2,6,-4
2001,Zaragoza,50179,Moyuela,1,6,-5
2001,Zaragoza,50180,Mozota,0,2,-2
2001,Zaragoza,50181,Muel,8,12,-4
2001,Zaragoza,50182,Muela (La),16,12,4
2001,Zaragoza,50183,Munébrega,5,8,-3
2001,Zaragoza,50184,Murero,0,5,-5
2001,Zaragoza,50185,Murillo de Gállego,2,4,-2
2001,Zaragoza,50186,Navardún,0,1,-1
2001,Zaragoza,50187,Nigüella,0,2,-2
2001,Zaragoza,50189,Nonaspe,11,18,-7
2001,Zaragoza,50190,Novallas,4,9,-5
2001,Zaragoza,50191,Novillas,4,14,-10
2001,Zaragoza,50193,Nuez de Ebro,4,5,-1
2001,Zaragoza,50192,Nuévalos,3,3,0
2001,Zaragoza,50194,Olvés,0,2,-2
2001,Zaragoza,50195,Orcajo,0,2,-2
2001,Zaragoza,50196,Orera,1,0,1
2001,Zaragoza,50197,Orés,1,0,1
2001,Zaragoza,50199,Osera de Ebro,1,6,-5
2001,Zaragoza,50200,Paniza,1,7,-6
2001,Zaragoza,50201,Paracuellos de Jiloca,1,12,-11
2001,Zaragoza,50202,Paracuellos de la Ribera,1,5,-4
2001,Zaragoza,50203,Pastriz,8,5,3
2001,Zaragoza,50204,Pedrola,25,23,2
2001,Zaragoza,50206,Perdiguera,4,5,-1
2001,Zaragoza,50207,Piedratajada,0,3,-3
2001,Zaragoza,50208,Pina de Ebro,31,23,8
2001,Zaragoza,50209,Pinseque,17,57,-40
2001,Zaragoza,50211,Plasencia de Jalón,2,8,-6
2001,Zaragoza,50212,Pleitas,0,2,-2
2001,Zaragoza,50213,Plenas,0,1,-1
2001,Zaragoza,50214,Pomer,0,1,-1
2001,Zaragoza,50216,Pozuelo de Aragón,2,3,-1
2001,Zaragoza,50217,Pradilla de Ebro,4,12,-8
2001,Zaragoza,50218,Puebla de Albortón,0,2,-2
2001,Zaragoza,50219,Puebla de Alfindén (La),30,20,10
2001,Zaragoza,50221,Purujosa,0,1,-1
2001,Zaragoza,50222,Quinto,11,31,-20
2001,Zaragoza,50223,Remolinos,9,27,-18
2001,Zaragoza,50224,Retascón,0,1,-1
2001,Zaragoza,50225,Ricla,19,27,-8
2001,Zaragoza,50227,Romanos,0,2,-2
2001,Zaragoza,50228,Rueda de Jalón,0,3,-3
2001,Zaragoza,50229,Ruesca,2,2,0
2001,Zaragoza,50231,Salillas de Jalón,4,5,-1
2001,Zaragoza,50232,Salvatierra de Esca,1,5,-4
2001,Zaragoza,50234,San Martín de la Virgen de Moncayo,0,2,-2
2001,Zaragoza,50235,San Mateo de Gállego,18,21,-3
2001,Zaragoza,50236,Santa Cruz de Grío,1,5,-4
2001,Zaragoza,50237,Santa Cruz de Moncayo,0,0,0
2001,Zaragoza,50238,Santa Eulalia de Gállego,1,1,0
2001,Zaragoza,50239,Santed,0,1,-1
2001,Zaragoza,50241,Saviñán,2,7,-5
2001,Zaragoza,50243,Sestrica,6,9,-3
2001,Zaragoza,50244,Sierra de Luna,0,4,-4
2001,Zaragoza,50245,Sigüés,0,2,-2
2001,Zaragoza,50246,Sisamón,0,2,-2
2001,Zaragoza,50247,Sobradiel,5,8,-3
2001,Zaragoza,50248,Sos del Rey Católico,5,12,-7
2001,Zaragoza,50230,Sádaba,16,17,-1
2001,Zaragoza,50240,Sástago,1,6,-5
2001,Zaragoza,50249,Tabuenca,0,7,-7
2001,Zaragoza,50250,Talamantes,0,1,-1
2001,Zaragoza,50251,Tarazona,82,124,-42
2001,Zaragoza,50252,Tauste,47,83,-36
2001,Zaragoza,50253,Terrer,2,13,-11
2001,Zaragoza,50254,Tierga,1,4,-3
2001,Zaragoza,50255,Tobed,1,2,-1
2001,Zaragoza,50256,Torralba de los Frailes,0,1,-1
2001,Zaragoza,50257,Torralba de Ribota,0,3,-3
2001,Zaragoza,50258,Torralbilla,0,1,-1
2001,Zaragoza,50259,Torrehermosa,0,1,-1
2001,Zaragoza,50260,Torrelapaja,0,1,-1
2001,Zaragoza,50261,Torrellas,1,5,-4
2001,Zaragoza,50262,Torres de Berrellén,8,28,-20
2001,Zaragoza,50263,Torrijo de la Cañada,0,5,-5
2001,Zaragoza,50264,Tosos,0,7,-7
2001,Zaragoza,50265,Trasmoz,0,1,-1
2001,Zaragoza,50266,Trasobares,0,5,-5
2001,Zaragoza,50267,Uncastillo,7,19,-12
2001,Zaragoza,50269,Urrea de Jalón,0,3,-3
2001,Zaragoza,50270,Urriés,0,1,-1
2001,Zaragoza,50271,Used,0,7,-7
2001,Zaragoza,50272,Utebo,131,82,49
2001,Zaragoza,50273,Valdehorna,0,2,-2
2001,Zaragoza,50276,Valpalmas,0,3,-3
2001,Zaragoza,50277,Valtorres,1,3,-2
2001,Zaragoza,50278,Velilla de Ebro,1,2,-1
2001,Zaragoza,50280,Vera de Moncayo,1,10,-9
2001,Zaragoza,50281,Vierlas,1,0,1
2001,Zaragoza,50283,Villadoz,1,2,-1
2001,Zaragoza,50284,Villafeliche,3,4,-1
2001,Zaragoza,50285,Villafranca de Ebro,11,11,0
2001,Zaragoza,50286,Villalba de Perejil,2,0,2
2001,Zaragoza,50287,Villalengua,2,10,-8
2001,Zaragoza,50288,Villanueva de Gállego,47,33,14
2001,Zaragoza,50290,Villanueva de Huerva,5,10,-5
2001,Zaragoza,50291,Villar de los Navarros,0,4,-4
2001,Zaragoza,50292,Villarreal de Huerva,2,3,-1
2001,Zaragoza,50293,Villarroya de la Sierra,1,16,-15
2001,Zaragoza,50294,Villarroya del Campo,0,1,-1
2001,Zaragoza,50282,Vilueña (La),0,2,-2
2001,Zaragoza,50296,Zaida (La),1,9,-8
2001,Zaragoza,50297,Zaragoza,5820,5692,128
2001,Zaragoza,50298,Zuera,30,54,-24
2001,Zaragoza,50099,Épila,38,54,-16
2000,Huesca,22001,Abiego,3,3,0
2000,Huesca,22002,Abizanda,0,1,-1
2000,Huesca,22004,Agüero,0,5,-5
2000,Huesca,22007,Albalate de Cinca,9,9,0
2000,Huesca,22008,Albalatillo,3,5,-2
2000,Huesca,22009,Albelda,4,24,-20
2000,Huesca,22011,Albero Alto,3,4,-1
2000,Huesca,22012,Albero Bajo,0,1,-1
2000,Huesca,22013,Alberuela de Tubo,1,6,-5
2000,Huesca,22014,Alcalá de Gurrea,2,5,-3
2000,Huesca,22015,Alcalá del Obispo,1,5,-4
2000,Huesca,22016,Alcampell,4,11,-7
2000,Huesca,22017,Alcolea de Cinca,10,12,-2
2000,Huesca,22018,Alcubierre,1,7,-6
2000,Huesca,22019,Alerre,1,1,0
2000,Huesca,22021,Almudévar,20,29,-9
2000,Huesca,22022,Almunia de San Juan,7,6,1
2000,Huesca,22023,Almuniente,2,4,-2
2000,Huesca,22024,Alquézar,3,4,-1
2000,Huesca,22025,Altorricón,9,19,-10
2000,Huesca,22027,Angüés,2,9,-7
2000,Huesca,22028,Ansó,0,7,-7
2000,Huesca,22029,Antillón,1,2,-1
2000,Huesca,22032,Aragüés del Puerto,0,2,-2
2000,Huesca,22036,Argavieso,1,2,-1
2000,Huesca,22035,Arén,1,4,-3
2000,Huesca,22039,Ayerbe,6,12,-6
2000,Huesca,22040,Azanuy-Alins,0,7,-7
2000,Huesca,22041,Azara,1,3,-2
2000,Huesca,22042,Azlor,1,2,-1
2000,Huesca,22907,Aínsa-Sobrarbe,15,19,-4
2000,Huesca,22006,Aísa,0,4,-4
2000,Huesca,22043,Baells,0,4,-4
2000,Huesca,22044,Bailo,0,1,-1
2000,Huesca,22045,Baldellou,0,1,-1
2000,Huesca,22046,Ballobar,7,17,-10
2000,Huesca,22047,Banastás,1,3,-2
2000,Huesca,22048,Barbastro,152,168,-16
2000,Huesca,22049,Barbués,1,0,1
2000,Huesca,22050,Barbuñales,0,1,-1
2000,Huesca,22052,Belver de Cinca,10,16,-6
2000,Huesca,22053,Benabarre,3,18,-15
2000,Huesca,22054,Benasque,14,11,3
2000,Huesca,22246,Beranuy,0,4,-4
2000,Huesca,22055,Berbegal,1,11,-10
2000,Huesca,22057,Bielsa,4,7,-3
2000,Huesca,22058,Bierge,0,1,-1
2000,Huesca,22059,Biescas,6,24,-18
2000,Huesca,22060,Binaced,6,21,-15
2000,Huesca,22061,Binéfar,73,80,-7
2000,Huesca,22062,Bisaurri,2,2,0
2000,Huesca,22063,Biscarrués,1,3,-2
2000,Huesca,22064,Blecua y Torres,1,3,-2
2000,Huesca,22066,Boltaña,8,8,0
2000,Huesca,22067,Bonansa,2,0,2
2000,Huesca,22068,Borau,0,1,-1
2000,Huesca,22069,Broto,5,6,-1
2000,Huesca,22074,Campo,0,2,-2
2000,Huesca,22075,Camporrells,1,3,-2
2000,Huesca,22076,Canal de Berdún,2,8,-6
2000,Huesca,22077,Candasnos,2,5,-3
2000,Huesca,22078,Canfranc,5,4,1
2000,Huesca,22079,Capdesaso,0,2,-2
2000,Huesca,22080,Capella,1,4,-3
2000,Huesca,22081,Casbas de Huesca,1,3,-2
2000,Huesca,22083,Castejón de Monegros,3,7,-4
2000,Huesca,22084,Castejón de Sos,10,11,-1
2000,Huesca,22082,Castejón del Puente,3,7,-4
2000,Huesca,22085,Castelflorite,0,1,-1
2000,Huesca,22086,Castiello de Jaca,1,2,-1
2000,Huesca,22088,Castillazuelo,1,4,-3
2000,Huesca,22089,Castillonroy,5,7,-2
2000,Huesca,22094,Chalamera,0,3,-3
2000,Huesca,22096,Chimillas,0,2,-2
2000,Huesca,22095,Chía,1,1,0
2000,Huesca,22090,Colungo,0,1,-1
2000,Huesca,22099,Esplús,7,5,2
2000,Huesca,22102,Estada,1,2,-1
2000,Huesca,22103,Estadilla,8,19,-11
2000,Huesca,22105,Estopiñán del Castillo,0,5,-5
2000,Huesca,22106,Fago,1,1,0
2000,Huesca,22107,Fanlo,0,0,0
2000,Huesca,22109,Fiscal,0,2,-2
2000,Huesca,22110,Fonz,8,20,-12
2000,Huesca,22111,Foradada del Toscar,0,1,-1
2000,Huesca,22112,Fraga,104,119,-15
2000,Huesca,22113,Fueva (La),3,12,-9
2000,Huesca,22114,Gistaín,0,4,-4
2000,Huesca,22115,Grado (El),2,5,-3
2000,Huesca,22117,Graus,23,50,-27
2000,Huesca,22116,Grañén,9,18,-9
2000,Huesca,22119,Gurrea de Gállego,5,19,-14
2000,Huesca,22122,Hoz de Jaca,0,1,-1
2000,Huesca,22908,Hoz y Costeán,1,2,-1
2000,Huesca,22124,Huerto,2,4,-2
2000,Huesca,22125,Huesca,473,481,-8
2000,Huesca,22127,Igriés,1,9,-8
2000,Huesca,22128,Ilche,0,3,-3
2000,Huesca,22129,Isábena,1,5,-4
2000,Huesca,22130,Jaca,109,140,-31
2000,Huesca,22131,Jasa,2,2,0
2000,Huesca,22133,Labuerda,2,2,0
2000,Huesca,22135,Laluenga,0,2,-2
2000,Huesca,22136,Lalueza,2,24,-22
2000,Huesca,22137,Lanaja,6,22,-16
2000,Huesca,22141,Lascellas-Ponzano,0,2,-2
2000,Huesca,22142,Lascuarre,0,5,-5
2000,Huesca,22143,Laspaúles,0,2,-2
2000,Huesca,22144,Laspuña,0,0,0
2000,Huesca,22149,Loarre,0,2,-2
2000,Huesca,22150,Loporzano,0,4,-4
2000,Huesca,22151,Loscorrales,1,4,-3
2000,Huesca,22905,Lupiñén-Ortilla,3,4,-1
2000,Huesca,22155,Monesma y Cajigar,0,1,-1
2000,Huesca,22156,Monflorite-Lascasas,0,1,-1
2000,Huesca,22157,Montanuy,0,2,-2
2000,Huesca,22158,Monzón,129,145,-16
2000,Huesca,22160,Naval,0,2,-2
2000,Huesca,22162,Novales,0,1,-1
2000,Huesca,22163,Nueno,1,5,-4
2000,Huesca,22165,Ontiñena,5,11,-6
2000,Huesca,22167,Osso de Cinca,0,6,-6
2000,Huesca,22170,Panticosa,8,4,4
2000,Huesca,22174,Peralta de Alcofea,2,7,-5
2000,Huesca,22175,Peralta de Calasanz,1,2,-1
2000,Huesca,22176,Peraltilla,2,3,-1
2000,Huesca,22177,Perarrúa,1,3,-2
2000,Huesca,22178,Pertusa,0,2,-2
2000,Huesca,22172,Peñalba,3,4,-1
2000,Huesca,22173,Peñas de Riglos (Las),0,4,-4
2000,Huesca,22181,Piracés,1,5,-4
2000,Huesca,22182,Plan,0,2,-2
2000,Huesca,22184,Poleñino,0,2,-2
2000,Huesca,22186,Pozán de Vero,1,3,-2
2000,Huesca,22187,Puebla de Castro (La),2,7,-5
2000,Huesca,22188,Puente de Montañana,0,1,-1
2000,Huesca,22902,Puente la Reina de Jaca,0,2,-2
2000,Huesca,22190,Pueyo de Araguás (El),1,6,-5
2000,Huesca,22193,Pueyo de Santa Cruz,0,4,-4
2000,Huesca,22189,Puértolas,1,2,-1
2000,Huesca,22195,Quicena,1,12,-11
2000,Huesca,22197,Robres,3,9,-6
2000,Huesca,22199,Sabiñánigo,55,80,-25
2000,Huesca,22200,Sahún,0,1,-1
2000,Huesca,22201,Salas Altas,1,6,-5
2000,Huesca,22202,Salas Bajas,1,2,-1
2000,Huesca,22203,Salillas,1,1,0
2000,Huesca,22204,Sallent de Gállego,7,8,-1
2000,Huesca,22205,San Esteban de Litera,1,6,-5
2000,Huesca,22207,San Juan de Plan,0,1,-1
2000,Huesca,22903,San Miguel del Cinca,9,14,-5
2000,Huesca,22206,Sangarrén,3,2,1
2000,Huesca,22208,Santa Cilia,0,2,-2
2000,Huesca,22906,Santa María de Dulcis,2,5,-3
2000,Huesca,22213,Sariñena,27,45,-18
2000,Huesca,22214,Secastilla,0,4,-4
2000,Huesca,22215,Seira,0,1,-1
2000,Huesca,22217,Sena,4,7,-3
2000,Huesca,22218,Senés de Alcubierre,0,2,-2
2000,Huesca,22220,Sesa,0,5,-5
2000,Huesca,22221,Sesué,2,0,2
2000,Huesca,22222,Siétamo,1,5,-4
2000,Huesca,22223,Sopeira,1,3,-2
2000,Huesca,22904,Sotonera (La),3,16,-13
2000,Huesca,22225,Tamarite de Litera,22,45,-23
2000,Huesca,22226,Tardienta,5,12,-7
2000,Huesca,22227,Tella-Sin,1,1,0
2000,Huesca,22228,Tierz,2,1,1
2000,Huesca,22229,Tolva,0,4,-4
2000,Huesca,22230,Torla-Ordesa,2,3,-1
2000,Huesca,22232,Torralba de Aragón,0,2,-2
2000,Huesca,22233,Torre la Ribera,0,2,-2
2000,Huesca,22234,Torrente de Cinca,8,12,-4
2000,Huesca,22235,Torres de Alcanadre,0,4,-4
2000,Huesca,22236,Torres de Barbués,0,4,-4
2000,Huesca,22242,Valfarta,0,2,-2
2000,Huesca,22901,Valle de Hecho,7,12,-5
2000,Huesca,22244,Valle de Lierp,1,0,1
2000,Huesca,22245,Velilla de Cinca,5,8,-3
2000,Huesca,22909,Vencillón,2,3,-1
2000,Huesca,22247,Viacamp y Litera,0,0,0
2000,Huesca,22248,Vicién,0,1,-1
2000,Huesca,22249,Villanova,2,2,0
2000,Huesca,22251,Villanueva de Sigena,6,5,1
2000,Huesca,22250,Villanúa,2,4,-2
2000,Huesca,22252,Yebra de Basa,0,1,-1
2000,Huesca,22253,Yésero,1,1,0
2000,Huesca,22254,Zaidín,13,22,-9
2000,Teruel,44002,Abejuela,0,2,-2
2000,Teruel,44004,Aguaviva,5,7,-2
2000,Teruel,44005,Aguilar del Alfambra,1,0,1
2000,Teruel,44006,Alacón,1,4,-3
2000,Teruel,44007,Alba,0,4,-4
2000,Teruel,44008,Albalate del Arzobispo,11,38,-27
2000,Teruel,44009,Albarracín,14,18,-4
2000,Teruel,44010,Albentosa,4,1,3
2000,Teruel,44011,Alcaine,0,2,-2
2000,Teruel,44012,Alcalá de la Selva,1,4,-3
2000,Teruel,44013,Alcañiz,137,140,-3
2000,Teruel,44014,Alcorisa,27,37,-10
2000,Teruel,44016,Alfambra,2,11,-9
2000,Teruel,44017,Aliaga,2,9,-7
2000,Teruel,44021,Allepuz,0,2,-2
2000,Teruel,44022,Alloza,4,15,-11
2000,Teruel,44025,Andorra,68,67,1
2000,Teruel,44026,Arcos de las Salinas,0,2,-2
2000,Teruel,44027,Arens de Lledó,0,0,0
2000,Teruel,44028,Argente,2,0,2
2000,Teruel,44029,Ariño,7,18,-11
2000,Teruel,44031,Azaila,0,3,-3
2000,Teruel,44035,Barrachina,1,4,-3
2000,Teruel,44034,Bañón,1,2,-1
2000,Teruel,44036,Bea,0,1,-1
2000,Teruel,44037,Beceite,2,6,-4
2000,Teruel,44039,Bello,0,10,-10
2000,Teruel,44038,Belmonte de San José,1,2,-1
2000,Teruel,44040,Berge,1,1,0
2000,Teruel,44041,Bezas,0,4,-4
2000,Teruel,44042,Blancas,0,4,-4
2000,Teruel,44043,Blesa,0,3,-3
2000,Teruel,44044,Bordón,3,1,2
2000,Teruel,44045,Bronchales,0,7,-7
2000,Teruel,44046,Bueña,0,1,-1
2000,Teruel,44047,Burbáguena,1,11,-10
2000,Teruel,44033,Báguena,2,11,-9
2000,Teruel,44049,Calaceite,3,16,-13
2000,Teruel,44050,Calamocha,30,32,-2
2000,Teruel,44051,Calanda,24,43,-19
2000,Teruel,44054,Camarena de la Sierra,3,1,2
2000,Teruel,44055,Camarillas,1,2,-1
2000,Teruel,44053,Camañas,1,2,-1
2000,Teruel,44056,Caminreal,3,9,-6
2000,Teruel,44059,Cantavieja,7,9,-2
2000,Teruel,44064,Cascante del Río,0,5,-5
2000,Teruel,44065,Castejón de Tornos,0,1,-1
2000,Teruel,44066,Castel de Cabra,0,3,-3
2000,Teruel,44070,Castellar (El),1,2,-1
2000,Teruel,44071,Castellote,1,8,-7
2000,Teruel,44067,Castelnou,0,0,0
2000,Teruel,44068,Castelserás,9,12,-3
2000,Teruel,44060,Cañada de Benatanduz,0,1,-1
2000,Teruel,44061,Cañada de Verich (La),2,1,1
2000,Teruel,44062,Cañada Vellida,0,2,-2
2000,Teruel,44063,Cañizar del Olivar,0,5,-5
2000,Teruel,44074,Cedrillas,6,9,-3
2000,Teruel,44075,Celadas,1,11,-10
2000,Teruel,44076,Cella,21,29,-8
2000,Teruel,44077,Cerollera (La),0,1,-1
2000,Teruel,44080,Codoñera (La),4,5,-1
2000,Teruel,44082,Corbalán,0,4,-4
2000,Teruel,44085,Cosa,0,3,-3
2000,Teruel,44086,Cretas,2,12,-10
2000,Teruel,44087,Crivillén,0,1,-1
2000,Teruel,44088,Cuba (La),1,2,-1
2000,Teruel,44089,Cubla,0,2,-2
2000,Teruel,44090,Cucalón,0,1,-1
2000,Teruel,44092,Cuervo (El),0,2,-2
2000,Teruel,44093,Cuevas de Almudén,1,0,1
2000,Teruel,44094,Cuevas Labradas,0,4,-4
2000,Teruel,44096,Ejulve,2,8,-6
2000,Teruel,44097,Escorihuela,0,5,-5
2000,Teruel,44099,Escucha,9,5,4
2000,Teruel,44100,Estercuel,0,5,-5
2000,Teruel,44101,Ferreruela de Huerva,0,1,-1
2000,Teruel,44103,Formiche Alto,4,4,0
2000,Teruel,44106,Fortanete,1,1,0
2000,Teruel,44107,Foz-Calanda,3,1,2
2000,Teruel,44108,Fresneda (La),4,9,-5
2000,Teruel,44109,Frías de Albarracín,0,1,-1
2000,Teruel,44111,Fuentes Calientes,0,1,-1
2000,Teruel,44112,Fuentes Claras,2,5,-3
2000,Teruel,44113,Fuentes de Rubielos,1,2,-1
2000,Teruel,44114,Fuentespalda,0,7,-7
2000,Teruel,44105,Fórnoles,0,3,-3
2000,Teruel,44115,Galve,0,3,-3
2000,Teruel,44116,Gargallo,0,1,-1
2000,Teruel,44117,Gea de Albarracín,2,8,-6
2000,Teruel,44118,Ginebrosa (La),4,5,-1
2000,Teruel,44120,Guadalaviar,3,4,-1
2000,Teruel,44121,Gúdar,1,0,1
2000,Teruel,44124,Hoz de la Vieja (La),0,1,-1
2000,Teruel,44125,Huesa del Común,0,3,-3
2000,Teruel,44122,Híjar,15,32,-17
2000,Teruel,44126,Iglesuela del Cid (La),2,5,-3
2000,Teruel,44127,Jabaloyas,0,4,-4
2000,Teruel,44129,Jatiel,0,3,-3
2000,Teruel,44130,Jorcas,0,2,-2
2000,Teruel,44132,Lagueruela,0,4,-4
2000,Teruel,44135,Libros,0,4,-4
2000,Teruel,44136,Lidón,0,1,-1
2000,Teruel,44137,Linares de Mora,0,3,-3
2000,Teruel,44141,Lledó,0,3,-3
2000,Teruel,44138,Loscos,0,5,-5
2000,Teruel,44143,Manzanera,4,5,-1
2000,Teruel,44144,Martín del Río,3,9,-6
2000,Teruel,44145,Mas de las Matas,8,29,-21
2000,Teruel,44146,Mata de los Olmos (La),0,2,-2
2000,Teruel,44147,Mazaleón,2,5,-3
2000,Teruel,44149,Mirambel,0,1,-1
2000,Teruel,44150,Miravete de la Sierra,0,0,0
2000,Teruel,44151,Molinos,3,4,-1
2000,Teruel,44152,Monforte de Moyuela,0,4,-4
2000,Teruel,44153,Monreal del Campo,28,19,9
2000,Teruel,44154,Monroyo,3,2,1
2000,Teruel,44155,Montalbán,9,18,-9
2000,Teruel,44156,Monteagudo del Castillo,1,2,-1
2000,Teruel,44157,Monterde de Albarracín,0,1,-1
2000,Teruel,44158,Mora de Rubielos,10,18,-8
2000,Teruel,44159,Moscardón,0,2,-2
2000,Teruel,44160,Mosqueruela,5,6,-1
2000,Teruel,44161,Muniesa,7,11,-4
2000,Teruel,44163,Noguera de Albarracín,0,1,-1
2000,Teruel,44164,Nogueras,0,1,-1
2000,Teruel,44165,Nogueruelas,2,5,-3
2000,Teruel,44168,Odón,5,1,4
2000,Teruel,44169,Ojos Negros,2,8,-6
2000,Teruel,44171,Olba,1,2,-1
2000,Teruel,44172,Oliete,5,19,-14
2000,Teruel,44173,Olmos (Los),3,1,2
2000,Teruel,44174,Orihuela del Tremedal,2,2,0
2000,Teruel,44175,Orrios,0,1,-1
2000,Teruel,44176,Palomar de Arroyos,2,3,-1
2000,Teruel,44177,Pancrudo,1,2,-1
2000,Teruel,44178,Parras de Castellote (Las),0,1,-1
2000,Teruel,44180,Peracense,0,1,-1
2000,Teruel,44181,Peralejos,0,1,-1
2000,Teruel,44182,Perales del Alfambra,3,3,0
2000,Teruel,44179,Peñarroya de Tastavins,3,6,-3
2000,Teruel,44183,Pitarque,0,1,-1
2000,Teruel,44184,Plou,0,2,-2
2000,Teruel,44185,Pobo (El),0,5,-5
2000,Teruel,44187,Portellada (La),0,5,-5
2000,Teruel,44189,Pozondón,0,1,-1
2000,Teruel,44190,Pozuel del Campo,0,3,-3
2000,Teruel,44191,Puebla de Híjar (La),6,18,-12
2000,Teruel,44192,Puebla de Valverde (La),2,7,-5
2000,Teruel,44193,Puertomingalvo,0,1,-1
2000,Teruel,44196,Riodeva,2,2,0
2000,Teruel,44198,Royuela,0,1,-1
2000,Teruel,44200,Rubielos de la Cérida,0,3,-3
2000,Teruel,44201,Rubielos de Mora,9,7,2
2000,Teruel,44194,Ráfales,0,7,-7
2000,Teruel,44197,Ródenas,0,1,-1
2000,Teruel,44204,Saldón,0,3,-3
2000,Teruel,44205,Samper de Calanda,3,11,-8
2000,Teruel,44206,San Agustín,1,4,-3
2000,Teruel,44207,San Martín del Río,0,8,-8
2000,Teruel,44209,Santa Eulalia,2,21,-19
2000,Teruel,44210,Sarrión,7,15,-8
2000,Teruel,44211,Segura de los Baños,0,1,-1
2000,Teruel,44213,Singra,1,2,-1
2000,Teruel,44215,Terriente,0,3,-3
2000,Teruel,44216,Teruel,353,321,32
2000,Teruel,44217,Toril y Masegoso,0,1,-1
2000,Teruel,44218,Tormón,0,1,-1
2000,Teruel,44219,Tornos,0,5,-5
2000,Teruel,44220,Torralba de los Sisones,2,0,2
2000,Teruel,44223,Torre de Arcas,0,1,-1
2000,Teruel,44227,Torre los Negros,0,1,-1
2000,Teruel,44221,Torrecilla de Alcañiz,5,1,4
2000,Teruel,44222,Torrecilla del Rebollar,0,4,-4
2000,Teruel,44226,Torrelacárcel,0,2,-2
2000,Teruel,44228,Torremocha de Jiloca,0,1,-1
2000,Teruel,44229,Torres de Albarracín,1,3,-2
2000,Teruel,44230,Torrevelilla,1,1,0
2000,Teruel,44231,Torrijas,0,1,-1
2000,Teruel,44232,Torrijo del Campo,2,10,-8
2000,Teruel,44234,Tramacastiel,0,5,-5
2000,Teruel,44235,Tramacastilla,2,1,1
2000,Teruel,44236,Tronchón,1,1,0
2000,Teruel,44237,Urrea de Gaén,0,11,-11
2000,Teruel,44238,Utrillas,27,22,5
2000,Teruel,44239,Valacloche,0,1,-1
2000,Teruel,44240,Valbona,0,2,-2
2000,Teruel,44241,Valdealgorfa,5,13,-8
2000,Teruel,44244,Valdelinares,2,5,-3
2000,Teruel,44245,Valdeltormo,5,9,-4
2000,Teruel,44246,Valderrobres,24,24,0
2000,Teruel,44247,Valjunquera,1,8,-7
2000,Teruel,44249,Vallecillo (El),0,1,-1
2000,Teruel,44251,Villafranca del Campo,1,11,-10
2000,Teruel,44256,Villanueva del Rebollar de la Sierra,1,1,0
2000,Teruel,44257,Villar del Cobo,2,1,1
2000,Teruel,44258,Villar del Salz,1,2,-1
2000,Teruel,44260,Villarluengo,1,1,0
2000,Teruel,44261,Villarquemado,9,13,-4
2000,Teruel,44262,Villarroya de los Pinares,1,2,-1
2000,Teruel,44263,Villastar,4,6,-2
2000,Teruel,44264,Villel,2,3,-1
2000,Teruel,44265,Vinaceite,0,8,-8
2000,Teruel,44266,Visiedo,0,4,-4
2000,Teruel,44267,Vivel del Río Martín,0,2,-2
2000,Zaragoza,50001,Abanto,0,3,-3
2000,Zaragoza,50002,Acered,0,4,-4
2000,Zaragoza,50004,Aguarón,2,11,-9
2000,Zaragoza,50005,Aguilón,0,5,-5
2000,Zaragoza,50003,Agón,4,1,3
2000,Zaragoza,50006,Ainzón,15,15,0
2000,Zaragoza,50008,Alagón,41,76,-35
2000,Zaragoza,50009,Alarba,1,1,0
2000,Zaragoza,50010,Alberite de San Juan,0,2,-2
2000,Zaragoza,50011,Albeta,2,4,-2
2000,Zaragoza,50012,Alborge,1,3,-2
2000,Zaragoza,50013,Alcalá de Ebro,2,8,-6
2000,Zaragoza,50014,Alcalá de Moncayo,0,1,-1
2000,Zaragoza,50015,Alconchel de Ariza,1,2,-1
2000,Zaragoza,50017,Alfajarín,18,11,7
2000,Zaragoza,50018,Alfamén,11,16,-5
2000,Zaragoza,50019,Alforque,0,1,-1
2000,Zaragoza,50020,Alhama de Aragón,14,10,4
2000,Zaragoza,50021,Almochuel,0,1,-1
2000,Zaragoza,50022,Almolda (La),3,9,-6
2000,Zaragoza,50023,Almonacid de la Cuba,2,3,-1
2000,Zaragoza,50024,Almonacid de la Sierra,2,11,-9
2000,Zaragoza,50025,Almunia de Doña Godina (La),44,59,-15
2000,Zaragoza,50026,Alpartir,6,9,-3
2000,Zaragoza,50027,Ambel,3,7,-4
2000,Zaragoza,50029,Aniñón,7,17,-10
2000,Zaragoza,50031,Aranda de Moncayo,1,0,1
2000,Zaragoza,50034,Ariza,4,23,-19
2000,Zaragoza,50035,Artieda,1,1,0
2000,Zaragoza,50032,Arándiga,1,11,-10
2000,Zaragoza,50037,Atea,0,1,-1
2000,Zaragoza,50038,Ateca,11,29,-18
2000,Zaragoza,50039,Azuara,2,14,-12
2000,Zaragoza,50030,Añón de Moncayo,0,1,-1
2000,Zaragoza,50040,Badules,0,1,-1
2000,Zaragoza,50042,Balconchán,0,1,-1
2000,Zaragoza,50044,Bardallur,2,5,-3
2000,Zaragoza,50045,Belchite,15,21,-6
2000,Zaragoza,50046,Belmonte de Gracián,0,1,-1
2000,Zaragoza,50047,Berdejo,0,1,-1
2000,Zaragoza,50048,Berrueco,1,0,1
2000,Zaragoza,50901,Biel,1,5,-4
2000,Zaragoza,50050,Bijuesca,0,1,-1
2000,Zaragoza,50051,Biota,13,17,-4
2000,Zaragoza,50052,Bisimbre,0,2,-2
2000,Zaragoza,50053,Boquiñeni,3,13,-10
2000,Zaragoza,50054,Bordalba,1,1,0
2000,Zaragoza,50055,Borja,35,60,-25
2000,Zaragoza,50056,Botorrita,1,6,-5
2000,Zaragoza,50057,Brea de Aragón,19,23,-4
2000,Zaragoza,50058,Bubierca,0,2,-2
2000,Zaragoza,50059,Bujaraloz,13,10,3
2000,Zaragoza,50060,Bulbuente,1,4,-3
2000,Zaragoza,50061,Bureta,1,3,-2
2000,Zaragoza,50062,Burgo de Ebro (El),12,12,0
2000,Zaragoza,50043,Bárboles,3,7,-4
2000,Zaragoza,50064,Cabañas de Ebro,1,6,-5
2000,Zaragoza,50065,Cabolafuente,0,1,-1
2000,Zaragoza,50066,Cadrete,14,14,0
2000,Zaragoza,50067,Calatayud,164,227,-63
2000,Zaragoza,50068,Calatorao,31,31,0
2000,Zaragoza,50070,Calmarza,0,1,-1
2000,Zaragoza,50071,Campillo de Aragón,1,2,-1
2000,Zaragoza,50072,Carenas,1,3,-2
2000,Zaragoza,50073,Cariñena,32,21,11
2000,Zaragoza,50074,Caspe,56,103,-47
2000,Zaragoza,50075,Castejón de Alarba,0,2,-2
2000,Zaragoza,50076,Castejón de las Armas,1,3,-2
2000,Zaragoza,50077,Castejón de Valdejasa,0,10,-10
2000,Zaragoza,50078,Castiliscar,0,6,-6
2000,Zaragoza,50079,Cervera de la Cañada,0,3,-3
2000,Zaragoza,50081,Cetina,5,19,-14
2000,Zaragoza,50092,Chiprana,1,4,-3
2000,Zaragoza,50093,Chodes,0,3,-3
2000,Zaragoza,50082,Cimballa,0,6,-6
2000,Zaragoza,50083,Cinco Olivas,0,3,-3
2000,Zaragoza,50084,Clarés de Ribota,0,1,-1
2000,Zaragoza,50085,Codo,1,4,-3
2000,Zaragoza,50086,Codos,0,7,-7
2000,Zaragoza,50087,Contamina,0,1,-1
2000,Zaragoza,50088,Cosuenda,0,6,-6
2000,Zaragoza,50089,Cuarte de Huerva,25,21,4
2000,Zaragoza,50090,Cubel,1,2,-1
2000,Zaragoza,50091,Cuerlas (Las),0,2,-2
2000,Zaragoza,50094,Daroca,17,31,-14
2000,Zaragoza,50095,Ejea de los Caballeros,124,139,-15
2000,Zaragoza,50096,Embid de Ariza,0,3,-3
2000,Zaragoza,50098,Encinacorba,2,4,-2
2000,Zaragoza,50100,Erla,3,8,-5
2000,Zaragoza,50101,Escatrón,4,11,-7
2000,Zaragoza,50102,Fabara,7,18,-11
2000,Zaragoza,50104,Farlete,2,4,-2
2000,Zaragoza,50106,Fayos (Los),0,4,-4
2000,Zaragoza,50105,Fayón,1,4,-3
2000,Zaragoza,50107,Figueruelas,7,19,-12
2000,Zaragoza,50109,Frago (El),0,1,-1
2000,Zaragoza,50110,Frasno (El),1,6,-5
2000,Zaragoza,50111,Fréscano,2,3,-1
2000,Zaragoza,50113,Fuendejalón,2,10,-8
2000,Zaragoza,50114,Fuendetodos,1,2,-1
2000,Zaragoza,50115,Fuentes de Ebro,38,41,-3
2000,Zaragoza,50116,Fuentes de Jiloca,0,2,-2
2000,Zaragoza,50117,Gallocanta,1,5,-4
2000,Zaragoza,50118,Gallur,27,32,-5
2000,Zaragoza,50119,Gelsa,7,20,-13
2000,Zaragoza,50121,Gotor,7,3,4
2000,Zaragoza,50123,Grisén,3,4,-1
2000,Zaragoza,50124,Herrera de los Navarros,6,8,-2
2000,Zaragoza,50125,Ibdes,4,5,-1
2000,Zaragoza,50126,Illueca,32,25,7
2000,Zaragoza,50128,Isuerre,0,0,0
2000,Zaragoza,50129,Jaraba,0,2,-2
2000,Zaragoza,50130,Jarque de Moncayo,6,5,1
2000,Zaragoza,50131,Jaulín,1,5,-4
2000,Zaragoza,50132,Joyosa (La),3,10,-7
2000,Zaragoza,50133,Lagata,0,6,-6
2000,Zaragoza,50134,Langa del Castillo,0,2,-2
2000,Zaragoza,50135,Layana,1,3,-2
2000,Zaragoza,50138,Lechón,1,0,1
2000,Zaragoza,50137,Leciñena,7,12,-5
2000,Zaragoza,50139,Letux,0,5,-5
2000,Zaragoza,50141,Lituénigo,0,3,-3
2000,Zaragoza,50142,Lobera de Onsella,0,3,-3
2000,Zaragoza,50143,Longares,6,13,-7
2000,Zaragoza,50144,Longás,0,1,-1
2000,Zaragoza,50146,Lucena de Jalón,0,3,-3
2000,Zaragoza,50147,Luceni,5,9,-4
2000,Zaragoza,50148,Luesia,2,15,-13
2000,Zaragoza,50149,Luesma,0,1,-1
2000,Zaragoza,50150,Lumpiaque,9,11,-2
2000,Zaragoza,50151,Luna,1,12,-11
2000,Zaragoza,50136,Lécera,0,11,-11
2000,Zaragoza,50152,Maella,16,22,-6
2000,Zaragoza,50153,Magallón,11,24,-13
2000,Zaragoza,50154,Mainar,0,2,-2
2000,Zaragoza,50155,Malanquilla,0,1,-1
2000,Zaragoza,50156,Maleján,1,1,0
2000,Zaragoza,50160,Mallén,17,17,0
2000,Zaragoza,50159,Maluenda,4,18,-14
2000,Zaragoza,50157,Malón,3,3,0
2000,Zaragoza,50161,Manchones,2,3,-1
2000,Zaragoza,50162,Mara,1,4,-3
2000,Zaragoza,50902,Marracos,1,4,-3
2000,Zaragoza,50163,María de Huerva,11,17,-6
2000,Zaragoza,50164,Mediana de Aragón,1,10,-9
2000,Zaragoza,50165,Mequinenza,26,39,-13
2000,Zaragoza,50166,Mesones de Isuela,1,7,-6
2000,Zaragoza,50167,Mezalocha,0,3,-3
2000,Zaragoza,50169,Miedes de Aragón,4,7,-3
2000,Zaragoza,50170,Monegrillo,1,7,-6
2000,Zaragoza,50172,Monreal de Ariza,0,6,-6
2000,Zaragoza,50173,Monterde,2,5,-3
2000,Zaragoza,50175,Morata de Jalón,6,17,-11
2000,Zaragoza,50176,Morata de Jiloca,0,6,-6
2000,Zaragoza,50178,Moros,9,11,-2
2000,Zaragoza,50177,Morés,4,6,-2
2000,Zaragoza,50179,Moyuela,0,5,-5
2000,Zaragoza,50180,Mozota,1,1,0
2000,Zaragoza,50181,Muel,10,14,-4
2000,Zaragoza,50182,Muela (La),9,11,-2
2000,Zaragoza,50183,Munébrega,3,6,-3
2000,Zaragoza,50184,Murero,0,1,-1
2000,Zaragoza,50185,Murillo de Gállego,0,2,-2
2000,Zaragoza,50186,Navardún,0,1,-1
2000,Zaragoza,50187,Nigüella,0,1,-1
2000,Zaragoza,50189,Nonaspe,7,20,-13
2000,Zaragoza,50190,Novallas,6,8,-2
2000,Zaragoza,50191,Novillas,3,12,-9
2000,Zaragoza,50193,Nuez de Ebro,6,4,2
2000,Zaragoza,50192,Nuévalos,2,3,-1
2000,Zaragoza,50194,Olvés,1,2,-1
2000,Zaragoza,50195,Orcajo,0,1,-1
2000,Zaragoza,50196,Orera,0,3,-3
2000,Zaragoza,50197,Orés,0,2,-2
2000,Zaragoza,50199,Osera de Ebro,2,8,-6
2000,Zaragoza,50200,Paniza,4,11,-7
2000,Zaragoza,50201,Paracuellos de Jiloca,3,10,-7
2000,Zaragoza,50202,Paracuellos de la Ribera,0,8,-8
2000,Zaragoza,50203,Pastriz,14,13,1
2000,Zaragoza,50204,Pedrola,22,23,-1
2000,Zaragoza,50205,Pedrosas (Las),0,1,-1
2000,Zaragoza,50206,Perdiguera,7,8,-1
2000,Zaragoza,50207,Piedratajada,2,1,1
2000,Zaragoza,50208,Pina de Ebro,23,17,6
2000,Zaragoza,50209,Pinseque,14,54,-40
2000,Zaragoza,50210,Pintanos (Los),0,1,-1
2000,Zaragoza,50211,Plasencia de Jalón,4,8,-4
2000,Zaragoza,50212,Pleitas,0,1,-1
2000,Zaragoza,50213,Plenas,0,1,-1
2000,Zaragoza,50216,Pozuelo de Aragón,1,5,-4
2000,Zaragoza,50217,Pradilla de Ebro,3,8,-5
2000,Zaragoza,50218,Puebla de Albortón,1,0,1
2000,Zaragoza,50219,Puebla de Alfindén (La),18,15,3
2000,Zaragoza,50222,Quinto,13,19,-6
2000,Zaragoza,50223,Remolinos,15,12,3
2000,Zaragoza,50224,Retascón,0,1,-1
2000,Zaragoza,50225,Ricla,15,18,-3
2000,Zaragoza,50227,Romanos,0,3,-3
2000,Zaragoza,50228,Rueda de Jalón,1,3,-2
2000,Zaragoza,50229,Ruesca,0,1,-1
2000,Zaragoza,50231,Salillas de Jalón,0,3,-3
2000,Zaragoza,50232,Salvatierra de Esca,4,5,-1
2000,Zaragoza,50234,San Martín de la Virgen de Moncayo,0,2,-2
2000,Zaragoza,50235,San Mateo de Gállego,19,32,-13
2000,Zaragoza,50236,Santa Cruz de Grío,0,4,-4
2000,Zaragoza,50237,Santa Cruz de Moncayo,2,3,-1
2000,Zaragoza,50238,Santa Eulalia de Gállego,0,3,-3
2000,Zaragoza,50239,Santed,1,0,1
2000,Zaragoza,50241,Saviñán,0,5,-5
2000,Zaragoza,50242,Sediles,0,2,-2
2000,Zaragoza,50243,Sestrica,5,12,-7
2000,Zaragoza,50244,Sierra de Luna,2,1,1
2000,Zaragoza,50245,Sigüés,1,1,0
2000,Zaragoza,50247,Sobradiel,8,6,2
2000,Zaragoza,50248,Sos del Rey Católico,5,7,-2
2000,Zaragoza,50230,Sádaba,12,14,-2
2000,Zaragoza,50240,Sástago,0,12,-12
2000,Zaragoza,50249,Tabuenca,2,9,-7
2000,Zaragoza,50250,Talamantes,1,1,0
2000,Zaragoza,50251,Tarazona,86,120,-34
2000,Zaragoza,50252,Tauste,44,91,-47
2000,Zaragoza,50253,Terrer,2,7,-5
2000,Zaragoza,50254,Tierga,1,5,-4
2000,Zaragoza,50255,Tobed,2,2,0
2000,Zaragoza,50257,Torralba de Ribota,0,3,-3
2000,Zaragoza,50258,Torralbilla,0,1,-1
2000,Zaragoza,50259,Torrehermosa,0,2,-2
2000,Zaragoza,50260,Torrelapaja,0,2,-2
2000,Zaragoza,50261,Torrellas,0,3,-3
2000,Zaragoza,50262,Torres de Berrellén,8,15,-7
2000,Zaragoza,50263,Torrijo de la Cañada,1,8,-7
2000,Zaragoza,50264,Tosos,0,1,-1
2000,Zaragoza,50265,Trasmoz,0,1,-1
2000,Zaragoza,50266,Trasobares,2,4,-2
2000,Zaragoza,50267,Uncastillo,5,19,-14
2000,Zaragoza,50269,Urrea de Jalón,3,8,-5
2000,Zaragoza,50270,Urriés,0,1,-1
2000,Zaragoza,50271,Used,4,5,-1
2000,Zaragoza,50272,Utebo,115,59,56
2000,Zaragoza,50274,Val de San Martín,0,0,0
2000,Zaragoza,50273,Valdehorna,0,1,-1
2000,Zaragoza,50275,Valmadrid,1,1,0
2000,Zaragoza,50276,Valpalmas,0,4,-4
2000,Zaragoza,50277,Valtorres,0,2,-2
2000,Zaragoza,50278,Velilla de Ebro,0,6,-6
2000,Zaragoza,50279,Velilla de Jiloca,0,1,-1
2000,Zaragoza,50280,Vera de Moncayo,1,6,-5
2000,Zaragoza,50281,Vierlas,1,4,-3
2000,Zaragoza,50283,Villadoz,0,1,-1
2000,Zaragoza,50284,Villafeliche,1,7,-6
2000,Zaragoza,50285,Villafranca de Ebro,5,8,-3
2000,Zaragoza,50286,Villalba de Perejil,0,2,-2
2000,Zaragoza,50287,Villalengua,3,2,1
2000,Zaragoza,50288,Villanueva de Gállego,40,45,-5
2000,Zaragoza,50290,Villanueva de Huerva,3,5,-2
2000,Zaragoza,50289,Villanueva de Jiloca,0,2,-2
2000,Zaragoza,50291,Villar de los Navarros,0,1,-1
2000,Zaragoza,50292,Villarreal de Huerva,2,0,2
2000,Zaragoza,50293,Villarroya de la Sierra,1,19,-18
2000,Zaragoza,50294,Villarroya del Campo,0,1,-1
2000,Zaragoza,50282,Vilueña (La),0,2,-2
2000,Zaragoza,50295,Vistabella,0,1,-1
2000,Zaragoza,50296,Zaida (La),4,8,-4
2000,Zaragoza,50297,Zaragoza,5464,5619,-155
2000,Zaragoza,50298,Zuera,54,60,-6
2000,Zaragoza,50099,Épila,37,52,-15
1999,Huesca,22001,Abiego,2,6,-4
1999,Huesca,22002,Abizanda,0,4,-4
1999,Huesca,22003,Adahuesca,0,2,-2
1999,Huesca,22004,Agüero,1,5,-4
1999,Huesca,22007,Albalate de Cinca,7,10,-3
1999,Huesca,22008,Albalatillo,0,1,-1
1999,Huesca,22009,Albelda,3,18,-15
1999,Huesca,22011,Albero Alto,0,1,-1
1999,Huesca,22012,Albero Bajo,1,2,-1
1999,Huesca,22013,Alberuela de Tubo,4,4,0
1999,Huesca,22014,Alcalá de Gurrea,0,4,-4
1999,Huesca,22015,Alcalá del Obispo,2,3,-1
1999,Huesca,22016,Alcampell,0,19,-19
1999,Huesca,22017,Alcolea de Cinca,11,15,-4
1999,Huesca,22018,Alcubierre,2,4,-2
1999,Huesca,22019,Alerre,0,1,-1
1999,Huesca,22021,Almudévar,13,28,-15
1999,Huesca,22022,Almunia de San Juan,2,13,-11
1999,Huesca,22023,Almuniente,3,12,-9
1999,Huesca,22024,Alquézar,2,5,-3
1999,Huesca,22025,Altorricón,13,14,-1
1999,Huesca,22027,Angüés,3,18,-15
1999,Huesca,22028,Ansó,4,11,-7
1999,Huesca,22029,Antillón,0,1,-1
1999,Huesca,22032,Aragüés del Puerto,0,1,-1
1999,Huesca,22036,Argavieso,0,1,-1
1999,Huesca,22037,Arguis,0,1,-1
1999,Huesca,22035,Arén,1,6,-5
1999,Huesca,22039,Ayerbe,8,15,-7
1999,Huesca,22040,Azanuy-Alins,0,8,-8
1999,Huesca,22041,Azara,3,6,-3
1999,Huesca,22042,Azlor,0,1,-1
1999,Huesca,22907,Aínsa-Sobrarbe,8,21,-13
1999,Huesca,22006,Aísa,2,3,-1
1999,Huesca,22043,Baells,1,1,0
1999,Huesca,22044,Bailo,0,4,-4
1999,Huesca,22045,Baldellou,0,5,-5
1999,Huesca,22046,Ballobar,9,20,-11
1999,Huesca,22048,Barbastro,146,160,-14
1999,Huesca,22049,Barbués,0,1,-1
1999,Huesca,22050,Barbuñales,1,3,-2
1999,Huesca,22052,Belver de Cinca,7,17,-10
1999,Huesca,22053,Benabarre,7,21,-14
1999,Huesca,22054,Benasque,17,9,8
1999,Huesca,22246,Beranuy,0,2,-2
1999,Huesca,22055,Berbegal,3,9,-6
1999,Huesca,22057,Bielsa,3,2,1
1999,Huesca,22058,Bierge,2,7,-5
1999,Huesca,22059,Biescas,8,19,-11
1999,Huesca,22060,Binaced,11,25,-14
1999,Huesca,22061,Binéfar,89,104,-15
1999,Huesca,22062,Bisaurri,1,3,-2
1999,Huesca,22063,Biscarrués,0,5,-5
1999,Huesca,22064,Blecua y Torres,0,3,-3
1999,Huesca,22066,Boltaña,6,3,3
1999,Huesca,22067,Bonansa,2,1,1
1999,Huesca,22068,Borau,0,1,-1
1999,Huesca,22069,Broto,5,11,-6
1999,Huesca,22051,Bárcabo,2,0,2
1999,Huesca,22072,Caldearenas,0,2,-2
1999,Huesca,22074,Campo,0,3,-3
1999,Huesca,22075,Camporrells,0,1,-1
1999,Huesca,22076,Canal de Berdún,1,5,-4
1999,Huesca,22077,Candasnos,2,10,-8
1999,Huesca,22078,Canfranc,6,4,2
1999,Huesca,22079,Capdesaso,0,4,-4
1999,Huesca,22080,Capella,2,7,-5
1999,Huesca,22081,Casbas de Huesca,0,6,-6
1999,Huesca,22083,Castejón de Monegros,2,12,-10
1999,Huesca,22084,Castejón de Sos,5,16,-11
1999,Huesca,22082,Castejón del Puente,4,1,3
1999,Huesca,22086,Castiello de Jaca,2,3,-1
1999,Huesca,22087,Castigaleu,1,1,0
1999,Huesca,22088,Castillazuelo,1,6,-5
1999,Huesca,22089,Castillonroy,2,7,-5
1999,Huesca,22094,Chalamera,1,5,-4
1999,Huesca,22096,Chimillas,1,4,-3
1999,Huesca,22095,Chía,1,3,-2
1999,Huesca,22090,Colungo,1,1,0
1999,Huesca,22099,Esplús,7,14,-7
1999,Huesca,22103,Estadilla,5,13,-8
1999,Huesca,22105,Estopiñán del Castillo,3,5,-2
1999,Huesca,22106,Fago,0,1,-1
1999,Huesca,22109,Fiscal,1,3,-2
1999,Huesca,22110,Fonz,3,23,-20
1999,Huesca,22112,Fraga,99,117,-18
1999,Huesca,22113,Fueva (La),6,6,0
1999,Huesca,22114,Gistaín,0,1,-1
1999,Huesca,22115,Grado (El),1,8,-7
1999,Huesca,22117,Graus,18,71,-53
1999,Huesca,22116,Grañén,8,23,-15
1999,Huesca,22119,Gurrea de Gállego,5,26,-21
1999,Huesca,22122,Hoz de Jaca,0,1,-1
1999,Huesca,22908,Hoz y Costeán,0,2,-2
1999,Huesca,22124,Huerto,1,4,-3
1999,Huesca,22125,Huesca,440,528,-88
1999,Huesca,22126,Ibieca,0,1,-1
1999,Huesca,22127,Igriés,0,23,-23
1999,Huesca,22128,Ilche,3,6,-3
1999,Huesca,22129,Isábena,2,2,0
1999,Huesca,22130,Jaca,116,128,-12
1999,Huesca,22131,Jasa,0,1,-1
1999,Huesca,22133,Labuerda,1,2,-1
1999,Huesca,22135,Laluenga,1,4,-3
1999,Huesca,22136,Lalueza,4,21,-17
1999,Huesca,22137,Lanaja,8,11,-3
1999,Huesca,22139,Laperdiguera,0,1,-1
1999,Huesca,22141,Lascellas-Ponzano,0,1,-1
1999,Huesca,22142,Lascuarre,1,2,-1
1999,Huesca,22143,Laspaúles,1,3,-2
1999,Huesca,22144,Laspuña,0,2,-2
1999,Huesca,22149,Loarre,2,8,-6
1999,Huesca,22150,Loporzano,1,3,-2
1999,Huesca,22151,Loscorrales,0,2,-2
1999,Huesca,22905,Lupiñén-Ortilla,1,3,-2
1999,Huesca,22155,Monesma y Cajigar,0,1,-1
1999,Huesca,22156,Monflorite-Lascasas,1,2,-1
1999,Huesca,22157,Montanuy,0,2,-2
1999,Huesca,22158,Monzón,136,178,-42
1999,Huesca,22160,Naval,1,3,-2
1999,Huesca,22162,Novales,1,2,-1
1999,Huesca,22163,Nueno,0,3,-3
1999,Huesca,22164,Olvena,0,3,-3
1999,Huesca,22165,Ontiñena,4,13,-9
1999,Huesca,22167,Osso de Cinca,5,7,-2
1999,Huesca,22170,Panticosa,7,5,2
1999,Huesca,22174,Peralta de Alcofea,4,7,-3
1999,Huesca,22175,Peralta de Calasanz,0,6,-6
1999,Huesca,22176,Peraltilla,0,6,-6
1999,Huesca,22177,Perarrúa,1,3,-2
1999,Huesca,22178,Pertusa,0,1,-1
1999,Huesca,22172,Peñalba,2,8,-6
1999,Huesca,22173,Peñas de Riglos (Las),0,2,-2
1999,Huesca,22181,Piracés,1,2,-1
1999,Huesca,22182,Plan,2,3,-1
1999,Huesca,22184,Poleñino,1,3,-2
1999,Huesca,22186,Pozán de Vero,1,9,-8
1999,Huesca,22187,Puebla de Castro (La),3,6,-3
1999,Huesca,22188,Puente de Montañana,0,2,-2
1999,Huesca,22902,Puente la Reina de Jaca,0,2,-2
1999,Huesca,22190,Pueyo de Araguás (El),2,5,-3
1999,Huesca,22193,Pueyo de Santa Cruz,1,5,-4
1999,Huesca,22189,Puértolas,0,2,-2
1999,Huesca,22195,Quicena,0,11,-11
1999,Huesca,22197,Robres,0,10,-10
1999,Huesca,22199,Sabiñánigo,71,84,-13
1999,Huesca,22200,Sahún,0,3,-3
1999,Huesca,22201,Salas Altas,3,4,-1
1999,Huesca,22202,Salas Bajas,0,6,-6
1999,Huesca,22203,Salillas,0,2,-2
1999,Huesca,22204,Sallent de Gállego,11,6,5
1999,Huesca,22205,San Esteban de Litera,3,7,-4
1999,Huesca,22207,San Juan de Plan,0,4,-4
1999,Huesca,22903,San Miguel del Cinca,6,8,-2
1999,Huesca,22206,Sangarrén,0,7,-7
1999,Huesca,22906,Santa María de Dulcis,0,1,-1
1999,Huesca,22212,Santaliestra y San Quílez,0,1,-1
1999,Huesca,22213,Sariñena,34,53,-19
1999,Huesca,22214,Secastilla,1,1,0
1999,Huesca,22215,Seira,0,1,-1
1999,Huesca,22217,Sena,2,16,-14
1999,Huesca,22218,Senés de Alcubierre,1,1,0
1999,Huesca,22220,Sesa,0,1,-1
1999,Huesca,22221,Sesué,0,2,-2
1999,Huesca,22222,Siétamo,2,6,-4
1999,Huesca,22223,Sopeira,4,1,3
1999,Huesca,22904,Sotonera (La),7,17,-10
1999,Huesca,22225,Tamarite de Litera,23,53,-30
1999,Huesca,22226,Tardienta,6,10,-4
1999,Huesca,22227,Tella-Sin,4,5,-1
1999,Huesca,22228,Tierz,1,2,-1
1999,Huesca,22229,Tolva,0,4,-4
1999,Huesca,22230,Torla-Ordesa,2,4,-2
1999,Huesca,22232,Torralba de Aragón,2,1,1
1999,Huesca,22233,Torre la Ribera,0,1,-1
1999,Huesca,22234,Torrente de Cinca,7,14,-7
1999,Huesca,22236,Torres de Barbués,1,5,-4
1999,Huesca,22239,Tramaced,0,1,-1
1999,Huesca,22242,Valfarta,0,1,-1
1999,Huesca,22901,Valle de Hecho,8,10,-2
1999,Huesca,22245,Velilla de Cinca,5,12,-7
1999,Huesca,22909,Vencillón,4,5,-1
1999,Huesca,22249,Villanova,2,1,1
1999,Huesca,22251,Villanueva de Sigena,4,4,0
1999,Huesca,22250,Villanúa,1,3,-2
1999,Huesca,22252,Yebra de Basa,0,1,-1
1999,Huesca,22254,Zaidín,16,19,-3
1999,Teruel,44001,Ababuj,0,1,-1
1999,Teruel,44004,Aguaviva,3,9,-6
1999,Teruel,44006,Alacón,2,7,-5
1999,Teruel,44007,Alba,0,6,-6
1999,Teruel,44008,Albalate del Arzobispo,8,31,-23
1999,Teruel,44009,Albarracín,7,11,-4
1999,Teruel,44010,Albentosa,1,1,0
1999,Teruel,44011,Alcaine,1,0,1
1999,Teruel,44012,Alcalá de la Selva,5,9,-4
1999,Teruel,44013,Alcañiz,121,185,-64
1999,Teruel,44014,Alcorisa,28,41,-13
1999,Teruel,44016,Alfambra,3,5,-2
1999,Teruel,44017,Aliaga,3,10,-7
1999,Teruel,44021,Allepuz,2,4,-2
1999,Teruel,44022,Alloza,3,13,-10
1999,Teruel,44018,Almohaja,0,1,-1
1999,Teruel,44024,Anadón,0,1,-1
1999,Teruel,44025,Andorra,64,61,3
1999,Teruel,44026,Arcos de las Salinas,0,6,-6
1999,Teruel,44027,Arens de Lledó,0,4,-4
1999,Teruel,44028,Argente,0,3,-3
1999,Teruel,44029,Ariño,4,9,-5
1999,Teruel,44031,Azaila,0,1,-1
1999,Teruel,44035,Barrachina,0,1,-1
1999,Teruel,44034,Bañón,1,1,0
1999,Teruel,44037,Beceite,6,13,-7
1999,Teruel,44039,Bello,2,5,-3
1999,Teruel,44038,Belmonte de San José,0,4,-4
1999,Teruel,44040,Berge,3,2,1
1999,Teruel,44041,Bezas,0,1,-1
1999,Teruel,44042,Blancas,1,8,-7
1999,Teruel,44043,Blesa,1,3,-2
1999,Teruel,44044,Bordón,1,4,-3
1999,Teruel,44045,Bronchales,1,3,-2
1999,Teruel,44046,Bueña,0,2,-2
1999,Teruel,44047,Burbáguena,1,16,-15
1999,Teruel,44033,Báguena,1,7,-6
1999,Teruel,44048,Cabra de Mora,1,3,-2
1999,Teruel,44049,Calaceite,5,17,-12
1999,Teruel,44050,Calamocha,35,52,-17
1999,Teruel,44051,Calanda,16,44,-28
1999,Teruel,44054,Camarena de la Sierra,0,3,-3
1999,Teruel,44055,Camarillas,1,2,-1
1999,Teruel,44053,Camañas,1,1,0
1999,Teruel,44056,Caminreal,1,11,-10
1999,Teruel,44059,Cantavieja,6,6,0
1999,Teruel,44064,Cascante del Río,0,3,-3
1999,Teruel,44065,Castejón de Tornos,1,2,-1
1999,Teruel,44066,Castel de Cabra,1,0,1
1999,Teruel,44071,Castellote,6,10,-4
1999,Teruel,44067,Castelnou,0,1,-1
1999,Teruel,44068,Castelserás,7,13,-6
1999,Teruel,44060,Cañada de Benatanduz,0,0,0
1999,Teruel,44061,Cañada de Verich (La),1,2,-1
1999,Teruel,44062,Cañada Vellida,0,1,-1
1999,Teruel,44063,Cañizar del Olivar,0,1,-1
1999,Teruel,44074,Cedrillas,3,5,-2
1999,Teruel,44075,Celadas,6,7,-1
1999,Teruel,44076,Cella,13,31,-18
1999,Teruel,44077,Cerollera (La),1,0,1
1999,Teruel,44080,Codoñera (La),3,9,-6
1999,Teruel,44082,Corbalán,1,0,1
1999,Teruel,44084,Cortes de Aragón,0,2,-2
1999,Teruel,44085,Cosa,1,1,0
1999,Teruel,44086,Cretas,1,10,-9
1999,Teruel,44088,Cuba (La),0,1,-1
1999,Teruel,44089,Cubla,0,2,-2
1999,Teruel,44090,Cucalón,0,1,-1
1999,Teruel,44092,Cuervo (El),0,4,-4
1999,Teruel,44093,Cuevas de Almudén,2,1,1
1999,Teruel,44094,Cuevas Labradas,0,2,-2
1999,Teruel,44096,Ejulve,1,1,0
1999,Teruel,44097,Escorihuela,0,1,-1
1999,Teruel,44099,Escucha,10,11,-1
1999,Teruel,44100,Estercuel,1,0,1
1999,Teruel,44103,Formiche Alto,4,2,2
1999,Teruel,44106,Fortanete,1,4,-3
1999,Teruel,44107,Foz-Calanda,3,2,1
1999,Teruel,44108,Fresneda (La),1,10,-9
1999,Teruel,44109,Frías de Albarracín,0,3,-3
1999,Teruel,44112,Fuentes Claras,5,10,-5
1999,Teruel,44113,Fuentes de Rubielos,3,1,2
1999,Teruel,44114,Fuentespalda,1,4,-3
1999,Teruel,44105,Fórnoles,0,2,-2
1999,Teruel,44115,Galve,1,1,0
1999,Teruel,44116,Gargallo,3,4,-1
1999,Teruel,44117,Gea de Albarracín,1,4,-3
1999,Teruel,44118,Ginebrosa (La),1,1,0
1999,Teruel,44119,Griegos,1,1,0
1999,Teruel,44120,Guadalaviar,1,2,-1
1999,Teruel,44123,Hinojosa de Jarque,0,2,-2
1999,Teruel,44124,Hoz de la Vieja (La),0,3,-3
1999,Teruel,44125,Huesa del Común,0,2,-2
1999,Teruel,44122,Híjar,11,28,-17
1999,Teruel,44126,Iglesuela del Cid (La),3,7,-4
1999,Teruel,44127,Jabaloyas,0,2,-2
1999,Teruel,44128,Jarque de la Val,0,1,-1
1999,Teruel,44129,Jatiel,0,1,-1
1999,Teruel,44130,Jorcas,0,1,-1
1999,Teruel,44131,Josa,0,1,-1
1999,Teruel,44135,Libros,0,2,-2
1999,Teruel,44136,Lidón,0,2,-2
1999,Teruel,44137,Linares de Mora,1,4,-3
1999,Teruel,44141,Lledó,1,3,-2
1999,Teruel,44138,Loscos,0,2,-2
1999,Teruel,44143,Manzanera,5,6,-1
1999,Teruel,44144,Martín del Río,8,3,5
1999,Teruel,44145,Mas de las Matas,10,25,-15
1999,Teruel,44146,Mata de los Olmos (La),2,6,-4
1999,Teruel,44147,Mazaleón,6,11,-5
1999,Teruel,44149,Mirambel,0,3,-3
1999,Teruel,44151,Molinos,1,3,-2
1999,Teruel,44152,Monforte de Moyuela,0,5,-5
1999,Teruel,44153,Monreal del Campo,16,24,-8
1999,Teruel,44154,Monroyo,4,9,-5
1999,Teruel,44155,Montalbán,9,12,-3
1999,Teruel,44156,Monteagudo del Castillo,0,1,-1
1999,Teruel,44157,Monterde de Albarracín,0,2,-2
1999,Teruel,44158,Mora de Rubielos,8,18,-10
1999,Teruel,44159,Moscardón,0,0,0
1999,Teruel,44160,Mosqueruela,5,9,-4
1999,Teruel,44161,Muniesa,6,16,-10
1999,Teruel,44163,Noguera de Albarracín,0,4,-4
1999,Teruel,44164,Nogueras,0,1,-1
1999,Teruel,44165,Nogueruelas,1,7,-6
1999,Teruel,44167,Obón,0,2,-2
1999,Teruel,44168,Odón,0,2,-2
1999,Teruel,44169,Ojos Negros,1,8,-7
1999,Teruel,44171,Olba,1,4,-3
1999,Teruel,44172,Oliete,1,8,-7
1999,Teruel,44173,Olmos (Los),0,2,-2
1999,Teruel,44174,Orihuela del Tremedal,5,13,-8
1999,Teruel,44175,Orrios,1,2,-1
1999,Teruel,44176,Palomar de Arroyos,1,4,-3
1999,Teruel,44177,Pancrudo,0,4,-4
1999,Teruel,44178,Parras de Castellote (Las),0,3,-3
1999,Teruel,44180,Peracense,0,4,-4
1999,Teruel,44181,Peralejos,0,2,-2
1999,Teruel,44182,Perales del Alfambra,1,3,-2
1999,Teruel,44179,Peñarroya de Tastavins,5,12,-7
1999,Teruel,44183,Pitarque,0,3,-3
1999,Teruel,44184,Plou,0,1,-1
1999,Teruel,44185,Pobo (El),0,1,-1
1999,Teruel,44187,Portellada (La),0,4,-4
1999,Teruel,44191,Puebla de Híjar (La),4,20,-16
1999,Teruel,44192,Puebla de Valverde (La),4,13,-9
1999,Teruel,44193,Puertomingalvo,1,5,-4
1999,Teruel,44195,Rillo,1,1,0
1999,Teruel,44196,Riodeva,1,3,-2
1999,Teruel,44198,Royuela,2,4,-2
1999,Teruel,44201,Rubielos de Mora,6,12,-6
1999,Teruel,44194,Ráfales,1,3,-2
1999,Teruel,44205,Samper de Calanda,5,19,-14
1999,Teruel,44206,San Agustín,0,2,-2
1999,Teruel,44207,San Martín del Río,0,3,-3
1999,Teruel,44209,Santa Eulalia,4,22,-18
1999,Teruel,44210,Sarrión,7,12,-5
1999,Teruel,44211,Segura de los Baños,0,4,-4
1999,Teruel,44212,Seno,0,2,-2
1999,Teruel,44213,Singra,0,0,0
1999,Teruel,44215,Terriente,0,2,-2
1999,Teruel,44216,Teruel,295,348,-53
1999,Teruel,44218,Tormón,0,1,-1
1999,Teruel,44219,Tornos,0,1,-1
1999,Teruel,44220,Torralba de los Sisones,3,4,-1
1999,Teruel,44223,Torre de Arcas,0,1,-1
1999,Teruel,44225,Torre del Compte,0,1,-1
1999,Teruel,44221,Torrecilla de Alcañiz,2,9,-7
1999,Teruel,44222,Torrecilla del Rebollar,0,2,-2
1999,Teruel,44226,Torrelacárcel,1,6,-5
1999,Teruel,44228,Torremocha de Jiloca,0,2,-2
1999,Teruel,44229,Torres de Albarracín,1,2,-1
1999,Teruel,44230,Torrevelilla,3,1,2
1999,Teruel,44231,Torrijas,1,2,-1
1999,Teruel,44232,Torrijo del Campo,0,14,-14
1999,Teruel,44234,Tramacastiel,1,0,1
1999,Teruel,44235,Tramacastilla,0,1,-1
1999,Teruel,44237,Urrea de Gaén,2,8,-6
1999,Teruel,44238,Utrillas,18,22,-4
1999,Teruel,44240,Valbona,1,4,-3
1999,Teruel,44241,Valdealgorfa,2,12,-10
1999,Teruel,44244,Valdelinares,0,2,-2
1999,Teruel,44245,Valdeltormo,0,7,-7
1999,Teruel,44246,Valderrobres,12,25,-13
1999,Teruel,44247,Valjunquera,7,6,1
1999,Teruel,44249,Vallecillo (El),0,1,-1
1999,Teruel,44251,Villafranca del Campo,2,11,-9
1999,Teruel,44257,Villar del Cobo,1,2,-1
1999,Teruel,44258,Villar del Salz,1,3,-2
1999,Teruel,44260,Villarluengo,0,4,-4
1999,Teruel,44261,Villarquemado,3,18,-15
1999,Teruel,44262,Villarroya de los Pinares,2,2,0
1999,Teruel,44263,Villastar,1,6,-5
1999,Teruel,44264,Villel,1,6,-5
1999,Teruel,44265,Vinaceite,1,8,-7
1999,Teruel,44266,Visiedo,0,4,-4
1999,Teruel,44267,Vivel del Río Martín,0,2,-2
1999,Teruel,44268,Zoma (La),1,1,0
1999,Zaragoza,50001,Abanto,0,3,-3
1999,Zaragoza,50002,Acered,1,3,-2
1999,Zaragoza,50004,Aguarón,3,20,-17
1999,Zaragoza,50005,Aguilón,0,7,-7
1999,Zaragoza,50003,Agón,1,2,-1
1999,Zaragoza,50006,Ainzón,13,18,-5
1999,Zaragoza,50007,Aladrén,0,1,-1
1999,Zaragoza,50008,Alagón,34,93,-59
1999,Zaragoza,50009,Alarba,2,0,2
1999,Zaragoza,50010,Alberite de San Juan,0,1,-1
1999,Zaragoza,50011,Albeta,0,2,-2
1999,Zaragoza,50012,Alborge,1,2,-1
1999,Zaragoza,50013,Alcalá de Ebro,0,8,-8
1999,Zaragoza,50015,Alconchel de Ariza,0,2,-2
1999,Zaragoza,50016,Aldehuela de Liestos,0,2,-2
1999,Zaragoza,50017,Alfajarín,8,17,-9
1999,Zaragoza,50018,Alfamén,8,12,-4
1999,Zaragoza,50019,Alforque,0,3,-3
1999,Zaragoza,50020,Alhama de Aragón,9,24,-15
1999,Zaragoza,50021,Almochuel,0,1,-1
1999,Zaragoza,50022,Almolda (La),3,10,-7
1999,Zaragoza,50023,Almonacid de la Cuba,1,10,-9
1999,Zaragoza,50024,Almonacid de la Sierra,8,18,-10
1999,Zaragoza,50025,Almunia de Doña Godina (La),69,55,14
1999,Zaragoza,50026,Alpartir,3,8,-5
1999,Zaragoza,50027,Ambel,0,4,-4
1999,Zaragoza,50028,Anento,0,1,-1
1999,Zaragoza,50029,Aniñón,6,14,-8
1999,Zaragoza,50031,Aranda de Moncayo,1,5,-4
1999,Zaragoza,50034,Ariza,10,23,-13
1999,Zaragoza,50035,Artieda,0,2,-2
1999,Zaragoza,50032,Arándiga,1,9,-8
1999,Zaragoza,50036,Asín,0,4,-4
1999,Zaragoza,50037,Atea,0,5,-5
1999,Zaragoza,50038,Ateca,13,18,-5
1999,Zaragoza,50039,Azuara,4,9,-5
1999,Zaragoza,50030,Añón de Moncayo,2,2,0
1999,Zaragoza,50040,Badules,0,2,-2
1999,Zaragoza,50042,Balconchán,0,1,-1
1999,Zaragoza,50044,Bardallur,1,9,-8
1999,Zaragoza,50045,Belchite,14,17,-3
1999,Zaragoza,50046,Belmonte de Gracián,0,5,-5
1999,Zaragoza,50047,Berdejo,0,2,-2
1999,Zaragoza,50048,Berrueco,0,3,-3
1999,Zaragoza,50901,Biel,0,2,-2
1999,Zaragoza,50050,Bijuesca,1,4,-3
1999,Zaragoza,50051,Biota,9,26,-17
1999,Zaragoza,50052,Bisimbre,0,1,-1
1999,Zaragoza,50053,Boquiñeni,6,16,-10
1999,Zaragoza,50055,Borja,27,81,-54
1999,Zaragoza,50056,Botorrita,2,5,-3
1999,Zaragoza,50057,Brea de Aragón,13,16,-3
1999,Zaragoza,50058,Bubierca,0,3,-3
1999,Zaragoza,50059,Bujaraloz,6,15,-9
1999,Zaragoza,50060,Bulbuente,3,5,-2
1999,Zaragoza,50061,Bureta,0,8,-8
1999,Zaragoza,50062,Burgo de Ebro (El),7,17,-10
1999,Zaragoza,50063,Buste (El),0,1,-1
1999,Zaragoza,50043,Bárboles,1,8,-7
1999,Zaragoza,50064,Cabañas de Ebro,6,6,0
1999,Zaragoza,50065,Cabolafuente,0,1,-1
1999,Zaragoza,50066,Cadrete,14,16,-2
1999,Zaragoza,50067,Calatayud,142,209,-67
1999,Zaragoza,50068,Calatorao,25,29,-4
1999,Zaragoza,50069,Calcena,1,3,-2
1999,Zaragoza,50070,Calmarza,0,2,-2
1999,Zaragoza,50071,Campillo de Aragón,1,3,-2
1999,Zaragoza,50072,Carenas,0,3,-3
1999,Zaragoza,50073,Cariñena,20,25,-5
1999,Zaragoza,50074,Caspe,70,115,-45
1999,Zaragoza,50075,Castejón de Alarba,0,3,-3
1999,Zaragoza,50076,Castejón de las Armas,0,1,-1
1999,Zaragoza,50077,Castejón de Valdejasa,0,3,-3
1999,Zaragoza,50078,Castiliscar,3,4,-1
1999,Zaragoza,50079,Cervera de la Cañada,1,6,-5
1999,Zaragoza,50081,Cetina,4,8,-4
1999,Zaragoza,50092,Chiprana,4,6,-2
1999,Zaragoza,50093,Chodes,0,4,-4
1999,Zaragoza,50082,Cimballa,0,2,-2
1999,Zaragoza,50083,Cinco Olivas,0,1,-1
1999,Zaragoza,50084,Clarés de Ribota,0,1,-1
1999,Zaragoza,50085,Codo,1,5,-4
1999,Zaragoza,50086,Codos,1,5,-4
1999,Zaragoza,50087,Contamina,0,1,-1
1999,Zaragoza,50088,Cosuenda,0,7,-7
1999,Zaragoza,50089,Cuarte de Huerva,24,28,-4
1999,Zaragoza,50090,Cubel,0,3,-3
1999,Zaragoza,50091,Cuerlas (Las),0,2,-2
1999,Zaragoza,50094,Daroca,15,25,-10
1999,Zaragoza,50095,Ejea de los Caballeros,121,172,-51
1999,Zaragoza,50098,Encinacorba,3,4,-1
1999,Zaragoza,50100,Erla,2,5,-3
1999,Zaragoza,50101,Escatrón,4,21,-17
1999,Zaragoza,50102,Fabara,8,21,-13
1999,Zaragoza,50104,Farlete,3,7,-4
1999,Zaragoza,50106,Fayos (Los),0,2,-2
1999,Zaragoza,50105,Fayón,0,4,-4
1999,Zaragoza,50107,Figueruelas,10,10,0
1999,Zaragoza,50109,Frago (El),1,1,0
1999,Zaragoza,50110,Frasno (El),3,8,-5
1999,Zaragoza,50111,Fréscano,2,1,1
1999,Zaragoza,50113,Fuendejalón,5,14,-9
1999,Zaragoza,50114,Fuendetodos,0,4,-4
1999,Zaragoza,50115,Fuentes de Ebro,38,37,1
1999,Zaragoza,50116,Fuentes de Jiloca,4,3,1
1999,Zaragoza,50117,Gallocanta,0,4,-4
1999,Zaragoza,50118,Gallur,13,36,-23
1999,Zaragoza,50119,Gelsa,8,19,-11
1999,Zaragoza,50121,Gotor,5,5,0
1999,Zaragoza,50122,Grisel,0,1,-1
1999,Zaragoza,50123,Grisén,0,6,-6
1999,Zaragoza,50124,Herrera de los Navarros,6,15,-9
1999,Zaragoza,50125,Ibdes,3,8,-5
1999,Zaragoza,50126,Illueca,25,31,-6
1999,Zaragoza,50128,Isuerre,0,1,-1
1999,Zaragoza,50129,Jaraba,0,7,-7
1999,Zaragoza,50130,Jarque de Moncayo,4,13,-9
1999,Zaragoza,50131,Jaulín,1,4,-3
1999,Zaragoza,50132,Joyosa (La),3,8,-5
1999,Zaragoza,50133,Lagata,0,4,-4
1999,Zaragoza,50134,Langa del Castillo,0,1,-1
1999,Zaragoza,50135,Layana,0,1,-1
1999,Zaragoza,50137,Leciñena,6,18,-12
1999,Zaragoza,50139,Letux,2,5,-3
1999,Zaragoza,50141,Lituénigo,0,3,-3
1999,Zaragoza,50142,Lobera de Onsella,0,1,-1
1999,Zaragoza,50143,Longares,8,12,-4
1999,Zaragoza,50146,Lucena de Jalón,0,5,-5
1999,Zaragoza,50147,Luceni,2,11,-9
1999,Zaragoza,50148,Luesia,2,4,-2
1999,Zaragoza,50149,Luesma,0,0,0
1999,Zaragoza,50150,Lumpiaque,3,9,-6
1999,Zaragoza,50151,Luna,4,21,-17
1999,Zaragoza,50136,Lécera,6,12,-6
1999,Zaragoza,50152,Maella,14,26,-12
1999,Zaragoza,50153,Magallón,7,14,-7
1999,Zaragoza,50154,Mainar,0,3,-3
1999,Zaragoza,50155,Malanquilla,0,1,-1
1999,Zaragoza,50156,Maleján,1,7,-6
1999,Zaragoza,50160,Mallén,22,47,-25
1999,Zaragoza,50159,Maluenda,7,15,-8
1999,Zaragoza,50157,Malón,4,6,-2
1999,Zaragoza,50161,Manchones,1,2,-1
1999,Zaragoza,50162,Mara,2,4,-2
1999,Zaragoza,50902,Marracos,0,1,-1
1999,Zaragoza,50163,María de Huerva,9,25,-16
1999,Zaragoza,50164,Mediana de Aragón,2,8,-6
1999,Zaragoza,50165,Mequinenza,24,36,-12
1999,Zaragoza,50166,Mesones de Isuela,1,4,-3
1999,Zaragoza,50167,Mezalocha,0,5,-5
1999,Zaragoza,50168,Mianos,1,0,1
1999,Zaragoza,50169,Miedes de Aragón,2,6,-4
1999,Zaragoza,50170,Monegrillo,4,10,-6
1999,Zaragoza,50171,Moneva,0,1,-1
1999,Zaragoza,50172,Monreal de Ariza,2,3,-1
1999,Zaragoza,50173,Monterde,0,10,-10
1999,Zaragoza,50175,Morata de Jalón,5,26,-21
1999,Zaragoza,50176,Morata de Jiloca,0,9,-9
1999,Zaragoza,50178,Moros,3,9,-6
1999,Zaragoza,50177,Morés,1,9,-8
1999,Zaragoza,50179,Moyuela,0,6,-6
1999,Zaragoza,50181,Muel,6,13,-7
1999,Zaragoza,50182,Muela (La),11,9,2
1999,Zaragoza,50183,Munébrega,2,8,-6
1999,Zaragoza,50184,Murero,0,3,-3
1999,Zaragoza,50185,Murillo de Gállego,0,2,-2
1999,Zaragoza,50186,Navardún,0,1,-1
1999,Zaragoza,50187,Nigüella,0,2,-2
1999,Zaragoza,50188,Nombrevilla,0,1,-1
1999,Zaragoza,50189,Nonaspe,11,24,-13
1999,Zaragoza,50190,Novallas,3,12,-9
1999,Zaragoza,50191,Novillas,4,8,-4
1999,Zaragoza,50193,Nuez de Ebro,3,2,1
1999,Zaragoza,50192,Nuévalos,7,2,5
1999,Zaragoza,50194,Olvés,0,3,-3
1999,Zaragoza,50196,Orera,1,0,1
1999,Zaragoza,50197,Orés,0,2,-2
1999,Zaragoza,50199,Osera de Ebro,3,14,-11
1999,Zaragoza,50200,Paniza,2,17,-15
1999,Zaragoza,50201,Paracuellos de Jiloca,3,10,-7
1999,Zaragoza,50202,Paracuellos de la Ribera,0,4,-4
1999,Zaragoza,50203,Pastriz,5,13,-8
1999,Zaragoza,50204,Pedrola,26,36,-10
1999,Zaragoza,50205,Pedrosas (Las),0,1,-1
1999,Zaragoza,50206,Perdiguera,3,3,0
1999,Zaragoza,50207,Piedratajada,1,4,-3
1999,Zaragoza,50208,Pina de Ebro,26,27,-1
1999,Zaragoza,50209,Pinseque,23,50,-27
1999,Zaragoza,50210,Pintanos (Los),0,1,-1
1999,Zaragoza,50211,Plasencia de Jalón,2,6,-4
1999,Zaragoza,50212,Pleitas,0,2,-2
1999,Zaragoza,50213,Plenas,0,4,-4
1999,Zaragoza,50216,Pozuelo de Aragón,0,7,-7
1999,Zaragoza,50217,Pradilla de Ebro,0,8,-8
1999,Zaragoza,50218,Puebla de Albortón,0,2,-2
1999,Zaragoza,50219,Puebla de Alfindén (La),13,17,-4
1999,Zaragoza,50220,Puendeluna,0,1,-1
1999,Zaragoza,50222,Quinto,13,28,-15
1999,Zaragoza,50223,Remolinos,8,17,-9
1999,Zaragoza,50225,Ricla,23,24,-1
1999,Zaragoza,50227,Romanos,0,1,-1
1999,Zaragoza,50228,Rueda de Jalón,0,7,-7
1999,Zaragoza,50229,Ruesca,0,2,-2
1999,Zaragoza,50231,Salillas de Jalón,1,4,-3
1999,Zaragoza,50232,Salvatierra de Esca,4,1,3
1999,Zaragoza,50233,Samper del Salz,0,1,-1
1999,Zaragoza,50234,San Martín de la Virgen de Moncayo,2,5,-3
1999,Zaragoza,50235,San Mateo de Gállego,22,24,-2
1999,Zaragoza,50236,Santa Cruz de Grío,0,6,-6
1999,Zaragoza,50237,Santa Cruz de Moncayo,0,1,-1
1999,Zaragoza,50238,Santa Eulalia de Gállego,1,3,-2
1999,Zaragoza,50241,Saviñán,1,12,-11
1999,Zaragoza,50242,Sediles,1,2,-1
1999,Zaragoza,50243,Sestrica,3,10,-7
1999,Zaragoza,50244,Sierra de Luna,1,7,-6
1999,Zaragoza,50245,Sigüés,0,2,-2
1999,Zaragoza,50246,Sisamón,0,2,-2
1999,Zaragoza,50247,Sobradiel,3,11,-8
1999,Zaragoza,50248,Sos del Rey Católico,6,15,-9
1999,Zaragoza,50230,Sádaba,11,25,-14
1999,Zaragoza,50240,Sástago,2,19,-17
1999,Zaragoza,50249,Tabuenca,3,9,-6
1999,Zaragoza,50251,Tarazona,60,140,-80
1999,Zaragoza,50252,Tauste,61,96,-35
1999,Zaragoza,50253,Terrer,1,17,-16
1999,Zaragoza,50254,Tierga,4,5,-1
1999,Zaragoza,50255,Tobed,2,5,-3
1999,Zaragoza,50256,Torralba de los Frailes,0,1,-1
1999,Zaragoza,50257,Torralba de Ribota,0,2,-2
1999,Zaragoza,50259,Torrehermosa,0,1,-1
1999,Zaragoza,50260,Torrelapaja,2,1,1
1999,Zaragoza,50261,Torrellas,4,7,-3
1999,Zaragoza,50262,Torres de Berrellén,4,17,-13
1999,Zaragoza,50263,Torrijo de la Cañada,0,10,-10
1999,Zaragoza,50264,Tosos,1,4,-3
1999,Zaragoza,50265,Trasmoz,0,3,-3
1999,Zaragoza,50266,Trasobares,0,5,-5
1999,Zaragoza,50267,Uncastillo,5,11,-6
1999,Zaragoza,50269,Urrea de Jalón,0,8,-8
1999,Zaragoza,50270,Urriés,0,2,-2
1999,Zaragoza,50271,Used,1,5,-4
1999,Zaragoza,50272,Utebo,131,57,74
1999,Zaragoza,50275,Valmadrid,0,3,-3
1999,Zaragoza,50276,Valpalmas,2,4,-2
1999,Zaragoza,50278,Velilla de Ebro,1,4,-3
1999,Zaragoza,50279,Velilla de Jiloca,1,0,1
1999,Zaragoza,50280,Vera de Moncayo,1,9,-8
1999,Zaragoza,50281,Vierlas,2,1,1
1999,Zaragoza,50283,Villadoz,0,2,-2
1999,Zaragoza,50284,Villafeliche,0,5,-5
1999,Zaragoza,50285,Villafranca de Ebro,5,8,-3
1999,Zaragoza,50286,Villalba de Perejil,0,2,-2
1999,Zaragoza,50287,Villalengua,2,7,-5
1999,Zaragoza,50288,Villanueva de Gállego,35,32,3
1999,Zaragoza,50290,Villanueva de Huerva,2,6,-4
1999,Zaragoza,50289,Villanueva de Jiloca,0,1,-1
1999,Zaragoza,50291,Villar de los Navarros,0,4,-4
1999,Zaragoza,50292,Villarreal de Huerva,0,2,-2
1999,Zaragoza,50293,Villarroya de la Sierra,2,8,-6
1999,Zaragoza,50282,Vilueña (La),0,4,-4
1999,Zaragoza,50295,Vistabella,0,1,-1
1999,Zaragoza,50296,Zaida (La),1,7,-6
1999,Zaragoza,50297,Zaragoza,5296,5892,-596
1999,Zaragoza,50298,Zuera,54,58,-4
1999,Zaragoza,50099,Épila,54,58,-4
1998,Huesca,22001,Abiego,2,1,1
1998,Huesca,22002,Abizanda,0,2,-2
1998,Huesca,22003,Adahuesca,0,2,-2
1998,Huesca,22004,Agüero,1,6,-5
1998,Huesca,22007,Albalate de Cinca,11,12,-1
1998,Huesca,22008,Albalatillo,2,5,-3
1998,Huesca,22009,Albelda,1,18,-17
1998,Huesca,22011,Albero Alto,0,1,-1
1998,Huesca,22012,Albero Bajo,1,4,-3
1998,Huesca,22013,Alberuela de Tubo,0,6,-6
1998,Huesca,22014,Alcalá de Gurrea,3,5,-2
1998,Huesca,22015,Alcalá del Obispo,1,3,-2
1998,Huesca,22016,Alcampell,3,16,-13
1998,Huesca,22017,Alcolea de Cinca,7,14,-7
1998,Huesca,22018,Alcubierre,1,6,-5
1998,Huesca,22019,Alerre,1,2,-1
1998,Huesca,22020,Alfántega,0,6,-6
1998,Huesca,22021,Almudévar,15,25,-10
1998,Huesca,22022,Almunia de San Juan,3,9,-6
1998,Huesca,22023,Almuniente,4,7,-3
1998,Huesca,22024,Alquézar,1,3,-2
1998,Huesca,22025,Altorricón,8,13,-5
1998,Huesca,22027,Angüés,4,9,-5
1998,Huesca,22028,Ansó,4,5,-1
1998,Huesca,22029,Antillón,0,1,-1
1998,Huesca,22032,Aragüés del Puerto,1,4,-3
1998,Huesca,22035,Arén,2,6,-4
1998,Huesca,22039,Ayerbe,2,23,-21
1998,Huesca,22040,Azanuy-Alins,0,6,-6
1998,Huesca,22041,Azara,2,1,1
1998,Huesca,22042,Azlor,0,2,-2
1998,Huesca,22907,Aínsa-Sobrarbe,12,20,-8
1998,Huesca,22006,Aísa,0,3,-3
1998,Huesca,22043,Baells,0,3,-3
1998,Huesca,22044,Bailo,0,4,-4
1998,Huesca,22045,Baldellou,0,1,-1
1998,Huesca,22046,Ballobar,5,14,-9
1998,Huesca,22047,Banastás,1,2,-1
1998,Huesca,22048,Barbastro,128,166,-38
1998,Huesca,22049,Barbués,0,2,-2
1998,Huesca,22052,Belver de Cinca,5,14,-9
1998,Huesca,22053,Benabarre,4,24,-20
1998,Huesca,22054,Benasque,8,12,-4
1998,Huesca,22246,Beranuy,0,3,-3
1998,Huesca,22055,Berbegal,2,6,-4
1998,Huesca,22057,Bielsa,8,5,3
1998,Huesca,22058,Bierge,1,4,-3
1998,Huesca,22059,Biescas,12,18,-6
1998,Huesca,22060,Binaced,15,15,0
1998,Huesca,22061,Binéfar,72,93,-21
1998,Huesca,22062,Bisaurri,0,3,-3
1998,Huesca,22063,Biscarrués,1,1,0
1998,Huesca,22064,Blecua y Torres,1,2,-1
1998,Huesca,22066,Boltaña,6,5,1
1998,Huesca,22068,Borau,0,1,-1
1998,Huesca,22069,Broto,6,4,2
1998,Huesca,22051,Bárcabo,0,1,-1
1998,Huesca,22072,Caldearenas,1,1,0
1998,Huesca,22074,Campo,1,0,1
1998,Huesca,22075,Camporrells,1,2,-1
1998,Huesca,22076,Canal de Berdún,5,8,-3
1998,Huesca,22077,Candasnos,4,5,-1
1998,Huesca,22078,Canfranc,6,2,4
1998,Huesca,22079,Capdesaso,0,3,-3
1998,Huesca,22080,Capella,2,4,-2
1998,Huesca,22081,Casbas de Huesca,0,6,-6
1998,Huesca,22083,Castejón de Monegros,5,8,-3
1998,Huesca,22084,Castejón de Sos,1,8,-7
1998,Huesca,22082,Castejón del Puente,2,4,-2
1998,Huesca,22085,Castelflorite,0,4,-4
1998,Huesca,22086,Castiello de Jaca,2,5,-3
1998,Huesca,22087,Castigaleu,1,2,-1
1998,Huesca,22088,Castillazuelo,0,4,-4
1998,Huesca,22089,Castillonroy,1,5,-4
1998,Huesca,22094,Chalamera,0,5,-5
1998,Huesca,22096,Chimillas,0,3,-3
1998,Huesca,22095,Chía,0,1,-1
1998,Huesca,22090,Colungo,0,2,-2
1998,Huesca,22099,Esplús,2,17,-15
1998,Huesca,22102,Estada,0,3,-3
1998,Huesca,22103,Estadilla,10,17,-7
1998,Huesca,22105,Estopiñán del Castillo,0,3,-3
1998,Huesca,22107,Fanlo,0,0,0
1998,Huesca,22109,Fiscal,3,1,2
1998,Huesca,22110,Fonz,6,24,-18
1998,Huesca,22111,Foradada del Toscar,2,0,2
1998,Huesca,22112,Fraga,114,105,9
1998,Huesca,22113,Fueva (La),4,9,-5
1998,Huesca,22114,Gistaín,1,6,-5
1998,Huesca,22115,Grado (El),1,10,-9
1998,Huesca,22117,Graus,30,47,-17
1998,Huesca,22116,Grañén,10,25,-15
1998,Huesca,22119,Gurrea de Gállego,9,19,-10
1998,Huesca,22908,Hoz y Costeán,1,2,-1
1998,Huesca,22124,Huerto,1,10,-9
1998,Huesca,22125,Huesca,433,506,-73
1998,Huesca,22126,Ibieca,0,1,-1
1998,Huesca,22127,Igriés,1,13,-12
1998,Huesca,22128,Ilche,0,3,-3
1998,Huesca,22129,Isábena,2,3,-1
1998,Huesca,22130,Jaca,99,133,-34
1998,Huesca,22131,Jasa,0,1,-1
1998,Huesca,22133,Labuerda,1,1,0
1998,Huesca,22135,Laluenga,0,3,-3
1998,Huesca,22136,Lalueza,8,20,-12
1998,Huesca,22137,Lanaja,8,26,-18
1998,Huesca,22139,Laperdiguera,0,1,-1
1998,Huesca,22141,Lascellas-Ponzano,0,2,-2
1998,Huesca,22143,Laspaúles,2,3,-1
1998,Huesca,22144,Laspuña,2,1,1
1998,Huesca,22149,Loarre,3,4,-1
1998,Huesca,22150,Loporzano,3,4,-1
1998,Huesca,22151,Loscorrales,0,2,-2
1998,Huesca,22905,Lupiñén-Ortilla,2,7,-5
1998,Huesca,22155,Monesma y Cajigar,0,3,-3
1998,Huesca,22156,Monflorite-Lascasas,0,2,-2
1998,Huesca,22157,Montanuy,1,3,-2
1998,Huesca,22158,Monzón,125,137,-12
1998,Huesca,22160,Naval,1,2,-1
1998,Huesca,22162,Novales,1,2,-1
1998,Huesca,22163,Nueno,1,0,1
1998,Huesca,22165,Ontiñena,2,8,-6
1998,Huesca,22167,Osso de Cinca,8,8,0
1998,Huesca,22170,Panticosa,9,5,4
1998,Huesca,22174,Peralta de Alcofea,3,13,-10
1998,Huesca,22175,Peralta de Calasanz,0,5,-5
1998,Huesca,22177,Perarrúa,2,3,-1
1998,Huesca,22178,Pertusa,0,1,-1
1998,Huesca,22172,Peñalba,4,6,-2
1998,Huesca,22173,Peñas de Riglos (Las),0,3,-3
1998,Huesca,22181,Piracés,0,1,-1
1998,Huesca,22182,Plan,2,2,0
1998,Huesca,22184,Poleñino,2,3,-1
1998,Huesca,22186,Pozán de Vero,2,3,-1
1998,Huesca,22187,Puebla de Castro (La),2,3,-1
1998,Huesca,22902,Puente la Reina de Jaca,1,1,0
1998,Huesca,22190,Pueyo de Araguás (El),0,1,-1
1998,Huesca,22193,Pueyo de Santa Cruz,1,6,-5
1998,Huesca,22189,Puértolas,1,3,-2
1998,Huesca,22195,Quicena,0,16,-16
1998,Huesca,22197,Robres,2,7,-5
1998,Huesca,22199,Sabiñánigo,79,80,-1
1998,Huesca,22200,Sahún,2,4,-2
1998,Huesca,22201,Salas Altas,1,3,-2
1998,Huesca,22202,Salas Bajas,2,3,-1
1998,Huesca,22203,Salillas,0,4,-4
1998,Huesca,22204,Sallent de Gállego,11,11,0
1998,Huesca,22205,San Esteban de Litera,1,15,-14
1998,Huesca,22207,San Juan de Plan,2,3,-1
1998,Huesca,22903,San Miguel del Cinca,6,11,-5
1998,Huesca,22206,Sangarrén,1,5,-4
1998,Huesca,22208,Santa Cilia,1,0,1
1998,Huesca,22209,Santa Cruz de la Serós,2,1,1
1998,Huesca,22906,Santa María de Dulcis,3,2,1
1998,Huesca,22213,Sariñena,21,50,-29
1998,Huesca,22214,Secastilla,0,3,-3
1998,Huesca,22215,Seira,1,5,-4
1998,Huesca,22217,Sena,6,9,-3
1998,Huesca,22218,Senés de Alcubierre,0,1,-1
1998,Huesca,22220,Sesa,2,1,1
1998,Huesca,22222,Siétamo,3,6,-3
1998,Huesca,22223,Sopeira,1,3,-2
1998,Huesca,22904,Sotonera (La),5,23,-18
1998,Huesca,22225,Tamarite de Litera,28,64,-36
1998,Huesca,22226,Tardienta,4,8,-4
1998,Huesca,22227,Tella-Sin,1,2,-1
1998,Huesca,22228,Tierz,2,3,-1
1998,Huesca,22229,Tolva,0,2,-2
1998,Huesca,22230,Torla-Ordesa,3,7,-4
1998,Huesca,22232,Torralba de Aragón,1,3,-2
1998,Huesca,22233,Torre la Ribera,1,5,-4
1998,Huesca,22234,Torrente de Cinca,5,21,-16
1998,Huesca,22236,Torres de Barbués,2,2,0
1998,Huesca,22242,Valfarta,0,4,-4
1998,Huesca,22901,Valle de Hecho,6,20,-14
1998,Huesca,22244,Valle de Lierp,0,0,0
1998,Huesca,22245,Velilla de Cinca,5,8,-3
1998,Huesca,22909,Vencillón,1,2,-1
1998,Huesca,22247,Viacamp y Litera,0,3,-3
1998,Huesca,22248,Vicién,0,1,-1
1998,Huesca,22251,Villanueva de Sigena,4,6,-2
1998,Huesca,22250,Villanúa,0,4,-4
1998,Huesca,22252,Yebra de Basa,0,2,-2
1998,Huesca,22253,Yésero,0,1,-1
1998,Huesca,22254,Zaidín,10,18,-8
1998,Teruel,44002,Abejuela,0,1,-1
1998,Teruel,44003,Aguatón,0,1,-1
1998,Teruel,44004,Aguaviva,3,13,-10
1998,Teruel,44005,Aguilar del Alfambra,2,1,1
1998,Teruel,44006,Alacón,2,3,-1
1998,Teruel,44007,Alba,0,10,-10
1998,Teruel,44008,Albalate del Arzobispo,13,37,-24
1998,Teruel,44009,Albarracín,4,15,-11
1998,Teruel,44010,Albentosa,2,5,-3
1998,Teruel,44011,Alcaine,0,1,-1
1998,Teruel,44012,Alcalá de la Selva,1,6,-5
1998,Teruel,44013,Alcañiz,128,175,-47
1998,Teruel,44014,Alcorisa,27,30,-3
1998,Teruel,44016,Alfambra,3,8,-5
1998,Teruel,44017,Aliaga,1,9,-8
1998,Teruel,44021,Allepuz,0,1,-1
1998,Teruel,44022,Alloza,2,16,-14
1998,Teruel,44018,Almohaja,1,0,1
1998,Teruel,44020,Alpeñés,0,1,-1
1998,Teruel,44024,Anadón,0,2,-2
1998,Teruel,44025,Andorra,60,56,4
1998,Teruel,44026,Arcos de las Salinas,1,2,-1
1998,Teruel,44027,Arens de Lledó,3,6,-3
1998,Teruel,44028,Argente,0,4,-4
1998,Teruel,44029,Ariño,11,7,4
1998,Teruel,44031,Azaila,0,2,-2
1998,Teruel,44035,Barrachina,0,3,-3
1998,Teruel,44034,Bañón,1,2,-1
1998,Teruel,44036,Bea,0,2,-2
1998,Teruel,44037,Beceite,3,11,-8
1998,Teruel,44039,Bello,3,4,-1
1998,Teruel,44038,Belmonte de San José,1,4,-3
1998,Teruel,44040,Berge,1,3,-2
1998,Teruel,44041,Bezas,0,1,-1
1998,Teruel,44042,Blancas,0,3,-3
1998,Teruel,44043,Blesa,0,1,-1
1998,Teruel,44044,Bordón,2,1,1
1998,Teruel,44045,Bronchales,3,4,-1
1998,Teruel,44046,Bueña,0,1,-1
1998,Teruel,44047,Burbáguena,0,16,-16
1998,Teruel,44032,Bádenas,0,2,-2
1998,Teruel,44033,Báguena,2,9,-7
1998,Teruel,44049,Calaceite,5,24,-19
1998,Teruel,44050,Calamocha,25,48,-23
1998,Teruel,44051,Calanda,24,35,-11
1998,Teruel,44052,Calomarde,1,0,1
1998,Teruel,44054,Camarena de la Sierra,0,3,-3
1998,Teruel,44053,Camañas,0,3,-3
1998,Teruel,44056,Caminreal,3,8,-5
1998,Teruel,44059,Cantavieja,6,10,-4
1998,Teruel,44064,Cascante del Río,0,2,-2
1998,Teruel,44065,Castejón de Tornos,0,2,-2
1998,Teruel,44066,Castel de Cabra,1,1,0
1998,Teruel,44071,Castellote,7,6,1
1998,Teruel,44067,Castelnou,0,2,-2
1998,Teruel,44068,Castelserás,7,8,-1
1998,Teruel,44060,Cañada de Benatanduz,1,2,-1
1998,Teruel,44061,Cañada de Verich (La),0,3,-3
1998,Teruel,44074,Cedrillas,6,9,-3
1998,Teruel,44075,Celadas,4,2,2
1998,Teruel,44076,Cella,14,40,-26
1998,Teruel,44077,Cerollera (La),1,0,1
1998,Teruel,44080,Codoñera (La),2,5,-3
1998,Teruel,44084,Cortes de Aragón,0,1,-1
1998,Teruel,44085,Cosa,1,0,1
1998,Teruel,44086,Cretas,1,8,-7
1998,Teruel,44087,Crivillén,0,0,0
1998,Teruel,44088,Cuba (La),0,1,-1
1998,Teruel,44089,Cubla,0,2,-2
1998,Teruel,44090,Cucalón,0,2,-2
1998,Teruel,44092,Cuervo (El),0,4,-4
1998,Teruel,44093,Cuevas de Almudén,2,2,0
1998,Teruel,44094,Cuevas Labradas,1,7,-6
1998,Teruel,44096,Ejulve,4,1,3
1998,Teruel,44097,Escorihuela,0,5,-5
1998,Teruel,44099,Escucha,8,8,0
1998,Teruel,44100,Estercuel,2,7,-5
1998,Teruel,44101,Ferreruela de Huerva,0,2,-2
1998,Teruel,44103,Formiche Alto,1,4,-3
1998,Teruel,44106,Fortanete,0,4,-4
1998,Teruel,44107,Foz-Calanda,4,3,1
1998,Teruel,44108,Fresneda (La),1,10,-9
1998,Teruel,44109,Frías de Albarracín,0,3,-3
1998,Teruel,44110,Fuenferrada,0,1,-1
1998,Teruel,44111,Fuentes Calientes,0,3,-3
1998,Teruel,44112,Fuentes Claras,5,9,-4
1998,Teruel,44113,Fuentes de Rubielos,1,1,0
1998,Teruel,44114,Fuentespalda,2,8,-6
1998,Teruel,44105,Fórnoles,1,5,-4
1998,Teruel,44115,Galve,1,1,0
1998,Teruel,44116,Gargallo,0,0,0
1998,Teruel,44117,Gea de Albarracín,0,7,-7
1998,Teruel,44118,Ginebrosa (La),2,5,-3
1998,Teruel,44119,Griegos,1,2,-1
1998,Teruel,44120,Guadalaviar,4,2,2
1998,Teruel,44121,Gúdar,0,1,-1
1998,Teruel,44123,Hinojosa de Jarque,0,2,-2
1998,Teruel,44125,Huesa del Común,0,1,-1
1998,Teruel,44122,Híjar,18,31,-13
1998,Teruel,44126,Iglesuela del Cid (La),3,7,-4
1998,Teruel,44128,Jarque de la Val,0,2,-2
1998,Teruel,44130,Jorcas,0,3,-3
1998,Teruel,44131,Josa,0,1,-1
1998,Teruel,44135,Libros,2,6,-4
1998,Teruel,44136,Lidón,0,1,-1
1998,Teruel,44137,Linares de Mora,1,2,-1
1998,Teruel,44141,Lledó,1,6,-5
1998,Teruel,44138,Loscos,0,3,-3
1998,Teruel,44142,Maicas,0,1,-1
1998,Teruel,44143,Manzanera,3,13,-10
1998,Teruel,44144,Martín del Río,3,4,-1
1998,Teruel,44145,Mas de las Matas,5,21,-16
1998,Teruel,44146,Mata de los Olmos (La),2,5,-3
1998,Teruel,44147,Mazaleón,7,10,-3
1998,Teruel,44148,Mezquita de Jarque,0,6,-6
1998,Teruel,44150,Miravete de la Sierra,0,1,-1
1998,Teruel,44151,Molinos,2,5,-3
1998,Teruel,44153,Monreal del Campo,15,26,-11
1998,Teruel,44154,Monroyo,3,5,-2
1998,Teruel,44155,Montalbán,11,14,-3
1998,Teruel,44156,Monteagudo del Castillo,0,1,-1
1998,Teruel,44157,Monterde de Albarracín,0,1,-1
1998,Teruel,44158,Mora de Rubielos,7,25,-18
1998,Teruel,44160,Mosqueruela,5,16,-11
1998,Teruel,44161,Muniesa,3,13,-10
1998,Teruel,44163,Noguera de Albarracín,3,2,1
1998,Teruel,44165,Nogueruelas,0,4,-4
1998,Teruel,44168,Odón,0,2,-2
1998,Teruel,44169,Ojos Negros,1,7,-6
1998,Teruel,44171,Olba,1,2,-1
1998,Teruel,44172,Oliete,2,13,-11
1998,Teruel,44173,Olmos (Los),5,5,0
1998,Teruel,44174,Orihuela del Tremedal,5,9,-4
1998,Teruel,44176,Palomar de Arroyos,2,1,1
1998,Teruel,44177,Pancrudo,1,0,1
1998,Teruel,44178,Parras de Castellote (Las),0,1,-1
1998,Teruel,44180,Peracense,0,1,-1
1998,Teruel,44182,Perales del Alfambra,4,4,0
1998,Teruel,44179,Peñarroya de Tastavins,10,10,0
1998,Teruel,44183,Pitarque,1,1,0
1998,Teruel,44184,Plou,0,2,-2
1998,Teruel,44185,Pobo (El),0,2,-2
1998,Teruel,44187,Portellada (La),0,6,-6
1998,Teruel,44189,Pozondón,1,1,0
1998,Teruel,44190,Pozuel del Campo,0,3,-3
1998,Teruel,44191,Puebla de Híjar (La),3,19,-16
1998,Teruel,44192,Puebla de Valverde (La),4,5,-1
1998,Teruel,44195,Rillo,1,2,-1
1998,Teruel,44196,Riodeva,0,4,-4
1998,Teruel,44198,Royuela,1,3,-2
1998,Teruel,44199,Rubiales,1,0,1
1998,Teruel,44200,Rubielos de la Cérida,1,0,1
1998,Teruel,44201,Rubielos de Mora,2,11,-9
1998,Teruel,44194,Ráfales,0,4,-4
1998,Teruel,44197,Ródenas,0,2,-2
1998,Teruel,44204,Saldón,0,1,-1
1998,Teruel,44205,Samper de Calanda,4,19,-15
1998,Teruel,44206,San Agustín,0,5,-5
1998,Teruel,44207,San Martín del Río,1,6,-5
1998,Teruel,44208,Santa Cruz de Nogueras,0,1,-1
1998,Teruel,44209,Santa Eulalia,3,14,-11
1998,Teruel,44210,Sarrión,7,17,-10
1998,Teruel,44213,Singra,2,2,0
1998,Teruel,44215,Terriente,2,2,0
1998,Teruel,44216,Teruel,314,357,-43
1998,Teruel,44217,Toril y Masegoso,0,1,-1
1998,Teruel,44219,Tornos,2,4,-2
1998,Teruel,44220,Torralba de los Sisones,4,5,-1
1998,Teruel,44223,Torre de Arcas,0,3,-3
1998,Teruel,44225,Torre del Compte,0,3,-3
1998,Teruel,44227,Torre los Negros,0,2,-2
1998,Teruel,44221,Torrecilla de Alcañiz,5,5,0
1998,Teruel,44222,Torrecilla del Rebollar,0,2,-2
1998,Teruel,44226,Torrelacárcel,0,8,-8
1998,Teruel,44228,Torremocha de Jiloca,1,3,-2
1998,Teruel,44229,Torres de Albarracín,0,2,-2
1998,Teruel,44230,Torrevelilla,0,1,-1
1998,Teruel,44232,Torrijo del Campo,5,9,-4
1998,Teruel,44234,Tramacastiel,0,3,-3
1998,Teruel,44235,Tramacastilla,0,1,-1
1998,Teruel,44236,Tronchón,0,1,-1
1998,Teruel,44237,Urrea de Gaén,0,19,-19
1998,Teruel,44238,Utrillas,27,20,7
1998,Teruel,44239,Valacloche,0,3,-3
1998,Teruel,44240,Valbona,0,6,-6
1998,Teruel,44241,Valdealgorfa,4,7,-3
1998,Teruel,44243,Valdecuenca,0,3,-3
1998,Teruel,44244,Valdelinares,2,4,-2
1998,Teruel,44245,Valdeltormo,3,5,-2
1998,Teruel,44246,Valderrobres,19,25,-6
1998,Teruel,44247,Valjunquera,1,5,-4
1998,Teruel,44249,Vallecillo (El),0,1,-1
1998,Teruel,44250,Veguillas de la Sierra,0,1,-1
1998,Teruel,44251,Villafranca del Campo,3,9,-6
1998,Teruel,44252,Villahermosa del Campo,0,1,-1
1998,Teruel,44257,Villar del Cobo,1,4,-3
1998,Teruel,44260,Villarluengo,0,3,-3
1998,Teruel,44261,Villarquemado,6,9,-3
1998,Teruel,44262,Villarroya de los Pinares,2,3,-1
1998,Teruel,44263,Villastar,3,5,-2
1998,Teruel,44264,Villel,0,10,-10
1998,Teruel,44265,Vinaceite,0,3,-3
1998,Teruel,44266,Visiedo,0,5,-5
1998,Teruel,44267,Vivel del Río Martín,0,1,-1
1998,Teruel,44268,Zoma (La),0,1,-1
1998,Zaragoza,50001,Abanto,0,5,-5
1998,Zaragoza,50002,Acered,0,5,-5
1998,Zaragoza,50004,Aguarón,3,6,-3
1998,Zaragoza,50005,Aguilón,1,1,0
1998,Zaragoza,50003,Agón,2,4,-2
1998,Zaragoza,50006,Ainzón,10,15,-5
1998,Zaragoza,50007,Aladrén,0,2,-2
1998,Zaragoza,50008,Alagón,34,60,-26
1998,Zaragoza,50009,Alarba,0,1,-1
1998,Zaragoza,50010,Alberite de San Juan,1,6,-5
1998,Zaragoza,50011,Albeta,0,2,-2
1998,Zaragoza,50012,Alborge,1,1,0
1998,Zaragoza,50013,Alcalá de Ebro,1,4,-3
1998,Zaragoza,50014,Alcalá de Moncayo,1,4,-3
1998,Zaragoza,50015,Alconchel de Ariza,0,6,-6
1998,Zaragoza,50016,Aldehuela de Liestos,0,1,-1
1998,Zaragoza,50017,Alfajarín,11,16,-5
1998,Zaragoza,50018,Alfamén,6,17,-11
1998,Zaragoza,50019,Alforque,0,2,-2
1998,Zaragoza,50020,Alhama de Aragón,6,19,-13
1998,Zaragoza,50022,Almolda (La),6,10,-4
1998,Zaragoza,50023,Almonacid de la Cuba,2,4,-2
1998,Zaragoza,50024,Almonacid de la Sierra,2,16,-14
1998,Zaragoza,50025,Almunia de Doña Godina (La),57,40,17
1998,Zaragoza,50026,Alpartir,3,7,-4
1998,Zaragoza,50027,Ambel,3,5,-2
1998,Zaragoza,50028,Anento,0,0,0
1998,Zaragoza,50029,Aniñón,8,7,1
1998,Zaragoza,50031,Aranda de Moncayo,1,3,-2
1998,Zaragoza,50033,Ardisa,0,3,-3
1998,Zaragoza,50034,Ariza,6,10,-4
1998,Zaragoza,50035,Artieda,0,1,-1
1998,Zaragoza,50032,Arándiga,1,10,-9
1998,Zaragoza,50036,Asín,1,0,1
1998,Zaragoza,50037,Atea,2,3,-1
1998,Zaragoza,50038,Ateca,15,22,-7
1998,Zaragoza,50039,Azuara,1,16,-15
1998,Zaragoza,50030,Añón de Moncayo,1,2,-1
1998,Zaragoza,50040,Badules,1,2,-1
1998,Zaragoza,50044,Bardallur,0,4,-4
1998,Zaragoza,50045,Belchite,15,24,-9
1998,Zaragoza,50046,Belmonte de Gracián,1,7,-6
1998,Zaragoza,50901,Biel,0,7,-7
1998,Zaragoza,50050,Bijuesca,0,2,-2
1998,Zaragoza,50051,Biota,5,18,-13
1998,Zaragoza,50052,Bisimbre,0,2,-2
1998,Zaragoza,50053,Boquiñeni,8,20,-12
1998,Zaragoza,50055,Borja,37,80,-43
1998,Zaragoza,50056,Botorrita,2,3,-1
1998,Zaragoza,50057,Brea de Aragón,25,17,8
1998,Zaragoza,50058,Bubierca,0,1,-1
1998,Zaragoza,50059,Bujaraloz,8,10,-2
1998,Zaragoza,50060,Bulbuente,0,4,-4
1998,Zaragoza,50061,Bureta,1,8,-7
1998,Zaragoza,50062,Burgo de Ebro (El),10,18,-8
1998,Zaragoza,50063,Buste (El),0,1,-1
1998,Zaragoza,50043,Bárboles,1,7,-6
1998,Zaragoza,50064,Cabañas de Ebro,3,5,-2
1998,Zaragoza,50065,Cabolafuente,0,2,-2
1998,Zaragoza,50066,Cadrete,11,7,4
1998,Zaragoza,50067,Calatayud,150,249,-99
1998,Zaragoza,50068,Calatorao,13,25,-12
1998,Zaragoza,50069,Calcena,0,1,-1
1998,Zaragoza,50070,Calmarza,0,3,-3
1998,Zaragoza,50071,Campillo de Aragón,0,1,-1
1998,Zaragoza,50072,Carenas,0,4,-4
1998,Zaragoza,50073,Cariñena,26,26,0
1998,Zaragoza,50074,Caspe,62,129,-67
1998,Zaragoza,50075,Castejón de Alarba,0,4,-4
1998,Zaragoza,50076,Castejón de las Armas,0,5,-5
1998,Zaragoza,50077,Castejón de Valdejasa,0,2,-2
1998,Zaragoza,50078,Castiliscar,2,5,-3
1998,Zaragoza,50079,Cervera de la Cañada,1,5,-4
1998,Zaragoza,50081,Cetina,5,9,-4
1998,Zaragoza,50092,Chiprana,2,5,-3
1998,Zaragoza,50093,Chodes,1,3,-2
1998,Zaragoza,50082,Cimballa,2,3,-1
1998,Zaragoza,50083,Cinco Olivas,0,4,-4
1998,Zaragoza,50085,Codo,2,5,-3
1998,Zaragoza,50086,Codos,0,4,-4
1998,Zaragoza,50087,Contamina,0,2,-2
1998,Zaragoza,50088,Cosuenda,0,7,-7
1998,Zaragoza,50089,Cuarte de Huerva,14,34,-20
1998,Zaragoza,50090,Cubel,0,1,-1
1998,Zaragoza,50091,Cuerlas (Las),0,3,-3
1998,Zaragoza,50094,Daroca,7,29,-22
1998,Zaragoza,50095,Ejea de los Caballeros,133,154,-21
1998,Zaragoza,50098,Encinacorba,0,3,-3
1998,Zaragoza,50100,Erla,0,4,-4
1998,Zaragoza,50101,Escatrón,8,25,-17
1998,Zaragoza,50102,Fabara,7,15,-8
1998,Zaragoza,50104,Farlete,2,3,-1
1998,Zaragoza,50106,Fayos (Los),1,3,-2
1998,Zaragoza,50105,Fayón,1,11,-10
1998,Zaragoza,50107,Figueruelas,9,14,-5
1998,Zaragoza,50108,Fombuena,0,1,-1
1998,Zaragoza,50109,Frago (El),0,2,-2
1998,Zaragoza,50110,Frasno (El),3,8,-5
1998,Zaragoza,50111,Fréscano,0,3,-3
1998,Zaragoza,50113,Fuendejalón,5,19,-14
1998,Zaragoza,50114,Fuendetodos,1,0,1
1998,Zaragoza,50115,Fuentes de Ebro,30,40,-10
1998,Zaragoza,50116,Fuentes de Jiloca,2,6,-4
1998,Zaragoza,50117,Gallocanta,0,2,-2
1998,Zaragoza,50118,Gallur,20,30,-10
1998,Zaragoza,50119,Gelsa,5,20,-15
1998,Zaragoza,50120,Godojos,0,1,-1
1998,Zaragoza,50121,Gotor,2,3,-1
1998,Zaragoza,50123,Grisén,1,6,-5
1998,Zaragoza,50124,Herrera de los Navarros,4,10,-6
1998,Zaragoza,50125,Ibdes,4,14,-10
1998,Zaragoza,50126,Illueca,47,30,17
1998,Zaragoza,50128,Isuerre,0,1,-1
1998,Zaragoza,50129,Jaraba,8,6,2
1998,Zaragoza,50130,Jarque de Moncayo,6,6,0
1998,Zaragoza,50131,Jaulín,2,6,-4
1998,Zaragoza,50132,Joyosa (La),3,9,-6
1998,Zaragoza,50134,Langa del Castillo,0,3,-3
1998,Zaragoza,50135,Layana,0,2,-2
1998,Zaragoza,50137,Leciñena,5,15,-10
1998,Zaragoza,50139,Letux,2,7,-5
1998,Zaragoza,50140,Litago,0,2,-2
1998,Zaragoza,50142,Lobera de Onsella,0,1,-1
1998,Zaragoza,50143,Longares,7,15,-8
1998,Zaragoza,50144,Longás,1,0,1
1998,Zaragoza,50146,Lucena de Jalón,0,6,-6
1998,Zaragoza,50147,Luceni,7,15,-8
1998,Zaragoza,50148,Luesia,3,13,-10
1998,Zaragoza,50150,Lumpiaque,6,12,-6
1998,Zaragoza,50151,Luna,4,18,-14
1998,Zaragoza,50136,Lécera,7,13,-6
1998,Zaragoza,50152,Maella,16,31,-15
1998,Zaragoza,50153,Magallón,8,14,-6
1998,Zaragoza,50154,Mainar,2,4,-2
1998,Zaragoza,50155,Malanquilla,0,2,-2
1998,Zaragoza,50156,Maleján,3,7,-4
1998,Zaragoza,50160,Mallén,27,37,-10
1998,Zaragoza,50159,Maluenda,7,21,-14
1998,Zaragoza,50157,Malón,3,6,-3
1998,Zaragoza,50161,Manchones,1,2,-1
1998,Zaragoza,50162,Mara,0,4,-4
1998,Zaragoza,50163,María de Huerva,9,26,-17
1998,Zaragoza,50164,Mediana de Aragón,2,5,-3
1998,Zaragoza,50165,Mequinenza,24,33,-9
1998,Zaragoza,50166,Mesones de Isuela,2,6,-4
1998,Zaragoza,50167,Mezalocha,1,3,-2
1998,Zaragoza,50168,Mianos,0,0,0
1998,Zaragoza,50169,Miedes de Aragón,1,2,-1
1998,Zaragoza,50170,Monegrillo,2,6,-4
1998,Zaragoza,50172,Monreal de Ariza,0,3,-3
1998,Zaragoza,50173,Monterde,2,4,-2
1998,Zaragoza,50174,Montón,0,1,-1
1998,Zaragoza,50175,Morata de Jalón,6,26,-20
1998,Zaragoza,50176,Morata de Jiloca,2,3,-1
1998,Zaragoza,50178,Moros,6,9,-3
1998,Zaragoza,50177,Morés,0,5,-5
1998,Zaragoza,50179,Moyuela,2,4,-2
1998,Zaragoza,50180,Mozota,2,0,2
1998,Zaragoza,50181,Muel,3,20,-17
1998,Zaragoza,50182,Muela (La),11,19,-8
1998,Zaragoza,50183,Munébrega,1,5,-4
1998,Zaragoza,50184,Murero,1,1,0
1998,Zaragoza,50185,Murillo de Gállego,0,1,-1
1998,Zaragoza,50187,Nigüella,0,4,-4
1998,Zaragoza,50189,Nonaspe,10,15,-5
1998,Zaragoza,50190,Novallas,2,12,-10
1998,Zaragoza,50191,Novillas,4,8,-4
1998,Zaragoza,50193,Nuez de Ebro,6,6,0
1998,Zaragoza,50192,Nuévalos,4,5,-1
1998,Zaragoza,50194,Olvés,0,1,-1
1998,Zaragoza,50196,Orera,0,2,-2
1998,Zaragoza,50197,Orés,0,1,-1
1998,Zaragoza,50198,Oseja,1,1,0
1998,Zaragoza,50199,Osera de Ebro,1,10,-9
1998,Zaragoza,50200,Paniza,4,7,-3
1998,Zaragoza,50201,Paracuellos de Jiloca,3,8,-5
1998,Zaragoza,50202,Paracuellos de la Ribera,0,6,-6
1998,Zaragoza,50203,Pastriz,4,10,-6
1998,Zaragoza,50204,Pedrola,19,38,-19
1998,Zaragoza,50205,Pedrosas (Las),0,1,-1
1998,Zaragoza,50206,Perdiguera,0,4,-4
1998,Zaragoza,50207,Piedratajada,2,2,0
1998,Zaragoza,50208,Pina de Ebro,16,24,-8
1998,Zaragoza,50209,Pinseque,8,44,-36
1998,Zaragoza,50210,Pintanos (Los),0,1,-1
1998,Zaragoza,50211,Plasencia de Jalón,1,3,-2
1998,Zaragoza,50212,Pleitas,0,4,-4
1998,Zaragoza,50213,Plenas,0,1,-1
1998,Zaragoza,50216,Pozuelo de Aragón,3,5,-2
1998,Zaragoza,50217,Pradilla de Ebro,1,12,-11
1998,Zaragoza,50218,Puebla de Albortón,0,3,-3
1998,Zaragoza,50219,Puebla de Alfindén (La),16,5,11
1998,Zaragoza,50222,Quinto,9,30,-21
1998,Zaragoza,50223,Remolinos,13,22,-9
1998,Zaragoza,50224,Retascón,0,1,-1
1998,Zaragoza,50225,Ricla,15,24,-9
1998,Zaragoza,50227,Romanos,0,1,-1
1998,Zaragoza,50228,Rueda de Jalón,6,6,0
1998,Zaragoza,50229,Ruesca,1,1,0
1998,Zaragoza,50231,Salillas de Jalón,1,4,-3
1998,Zaragoza,50232,Salvatierra de Esca,2,5,-3
1998,Zaragoza,50233,Samper del Salz,0,1,-1
1998,Zaragoza,50234,San Martín de la Virgen de Moncayo,2,5,-3
1998,Zaragoza,50235,San Mateo de Gállego,18,16,2
1998,Zaragoza,50236,Santa Cruz de Grío,5,3,2
1998,Zaragoza,50237,Santa Cruz de Moncayo,1,1,0
1998,Zaragoza,50238,Santa Eulalia de Gállego,0,1,-1
1998,Zaragoza,50239,Santed,0,1,-1
1998,Zaragoza,50241,Saviñán,2,16,-14
1998,Zaragoza,50242,Sediles,0,4,-4
1998,Zaragoza,50243,Sestrica,2,13,-11
1998,Zaragoza,50244,Sierra de Luna,1,5,-4
1998,Zaragoza,50245,Sigüés,0,3,-3
1998,Zaragoza,50246,Sisamón,0,1,-1
1998,Zaragoza,50247,Sobradiel,2,7,-5
1998,Zaragoza,50248,Sos del Rey Católico,2,11,-9
1998,Zaragoza,50230,Sádaba,15,23,-8
1998,Zaragoza,50240,Sástago,5,19,-14
1998,Zaragoza,50249,Tabuenca,1,7,-6
1998,Zaragoza,50250,Talamantes,0,2,-2
1998,Zaragoza,50251,Tarazona,67,123,-56
1998,Zaragoza,50252,Tauste,45,63,-18
1998,Zaragoza,50253,Terrer,3,9,-6
1998,Zaragoza,50254,Tierga,0,1,-1
1998,Zaragoza,50255,Tobed,1,5,-4
1998,Zaragoza,50256,Torralba de los Frailes,0,1,-1
1998,Zaragoza,50257,Torralba de Ribota,0,5,-5
1998,Zaragoza,50258,Torralbilla,0,2,-2
1998,Zaragoza,50259,Torrehermosa,0,2,-2
1998,Zaragoza,50260,Torrelapaja,0,1,-1
1998,Zaragoza,50261,Torrellas,0,3,-3
1998,Zaragoza,50262,Torres de Berrellén,8,16,-8
1998,Zaragoza,50263,Torrijo de la Cañada,0,8,-8
1998,Zaragoza,50264,Tosos,1,4,-3
1998,Zaragoza,50265,Trasmoz,0,2,-2
1998,Zaragoza,50266,Trasobares,0,4,-4
1998,Zaragoza,50267,Uncastillo,4,10,-6
1998,Zaragoza,50269,Urrea de Jalón,0,4,-4
1998,Zaragoza,50270,Urriés,0,0,0
1998,Zaragoza,50271,Used,2,5,-3
1998,Zaragoza,50272,Utebo,89,68,21
1998,Zaragoza,50274,Val de San Martín,0,1,-1
1998,Zaragoza,50275,Valmadrid,0,2,-2
1998,Zaragoza,50276,Valpalmas,1,1,0
1998,Zaragoza,50278,Velilla de Ebro,1,8,-7
1998,Zaragoza,50279,Velilla de Jiloca,1,1,0
1998,Zaragoza,50280,Vera de Moncayo,1,13,-12
1998,Zaragoza,50283,Villadoz,1,1,0
1998,Zaragoza,50284,Villafeliche,1,1,0
1998,Zaragoza,50285,Villafranca de Ebro,4,6,-2
1998,Zaragoza,50286,Villalba de Perejil,0,2,-2
1998,Zaragoza,50287,Villalengua,2,5,-3
1998,Zaragoza,50288,Villanueva de Gállego,20,30,-10
1998,Zaragoza,50290,Villanueva de Huerva,1,8,-7
1998,Zaragoza,50289,Villanueva de Jiloca,0,3,-3
1998,Zaragoza,50292,Villarreal de Huerva,2,3,-1
1998,Zaragoza,50293,Villarroya de la Sierra,1,18,-17
1998,Zaragoza,50294,Villarroya del Campo,0,2,-2
1998,Zaragoza,50282,Vilueña (La),0,2,-2
1998,Zaragoza,50296,Zaida (La),4,7,-3
1998,Zaragoza,50297,Zaragoza,4965,5653,-688
1998,Zaragoza,50298,Zuera,45,62,-17
1998,Zaragoza,50099,Épila,30,71,-41
1997,Huesca,22001,Abiego,0,7,-7
1997,Huesca,22002,Abizanda,1,1,0
1997,Huesca,22003,Adahuesca,0,4,-4
1997,Huesca,22004,Agüero,1,3,-2
1997,Huesca,22007,Albalate de Cinca,7,11,-4
1997,Huesca,22008,Albalatillo,0,4,-4
1997,Huesca,22009,Albelda,4,15,-11
1997,Huesca,22011,Albero Alto,0,2,-2
1997,Huesca,22012,Albero Bajo,0,1,-1
1997,Huesca,22013,Alberuela de Tubo,2,5,-3
1997,Huesca,22014,Alcalá de Gurrea,0,7,-7
1997,Huesca,22015,Alcalá del Obispo,1,4,-3
1997,Huesca,22016,Alcampell,3,15,-12
1997,Huesca,22017,Alcolea de Cinca,12,17,-5
1997,Huesca,22018,Alcubierre,1,8,-7
1997,Huesca,22020,Alfántega,1,2,-1
1997,Huesca,22021,Almudévar,6,29,-23
1997,Huesca,22022,Almunia de San Juan,4,8,-4
1997,Huesca,22023,Almuniente,3,8,-5
1997,Huesca,22024,Alquézar,3,3,0
1997,Huesca,22025,Altorricón,9,24,-15
1997,Huesca,22027,Angüés,2,6,-4
1997,Huesca,22028,Ansó,4,15,-11
1997,Huesca,22029,Antillón,0,3,-3
1997,Huesca,22032,Aragüés del Puerto,1,3,-2
1997,Huesca,22035,Arén,5,10,-5
1997,Huesca,22039,Ayerbe,3,30,-27
1997,Huesca,22040,Azanuy-Alins,1,7,-6
1997,Huesca,22041,Azara,1,3,-2
1997,Huesca,22042,Azlor,0,4,-4
1997,Huesca,22907,Aínsa-Sobrarbe,14,12,2
1997,Huesca,22006,Aísa,3,2,1
1997,Huesca,22043,Baells,0,5,-5
1997,Huesca,22044,Bailo,1,3,-2
1997,Huesca,22045,Baldellou,1,4,-3
1997,Huesca,22046,Ballobar,11,13,-2
1997,Huesca,22047,Banastás,0,1,-1
1997,Huesca,22048,Barbastro,124,183,-59
1997,Huesca,22049,Barbués,0,1,-1
1997,Huesca,22050,Barbuñales,0,2,-2
1997,Huesca,22052,Belver de Cinca,14,11,3
1997,Huesca,22053,Benabarre,7,19,-12
1997,Huesca,22054,Benasque,7,3,4
1997,Huesca,22246,Beranuy,0,1,-1
1997,Huesca,22055,Berbegal,4,7,-3
1997,Huesca,22057,Bielsa,1,6,-5
1997,Huesca,22058,Bierge,1,2,-1
1997,Huesca,22059,Biescas,16,17,-1
1997,Huesca,22060,Binaced,12,23,-11
1997,Huesca,22061,Binéfar,78,81,-3
1997,Huesca,22062,Bisaurri,0,2,-2
1997,Huesca,22063,Biscarrués,1,5,-4
1997,Huesca,22064,Blecua y Torres,1,3,-2
1997,Huesca,22066,Boltaña,9,7,2
1997,Huesca,22068,Borau,0,1,-1
1997,Huesca,22069,Broto,4,4,0
1997,Huesca,22051,Bárcabo,1,0,1
1997,Huesca,22072,Caldearenas,1,3,-2
1997,Huesca,22074,Campo,0,6,-6
1997,Huesca,22075,Camporrells,1,6,-5
1997,Huesca,22076,Canal de Berdún,3,9,-6
1997,Huesca,22077,Candasnos,5,6,-1
1997,Huesca,22078,Canfranc,0,2,-2
1997,Huesca,22079,Capdesaso,0,2,-2
1997,Huesca,22080,Capella,2,1,1
1997,Huesca,22081,Casbas de Huesca,1,2,-1
1997,Huesca,22083,Castejón de Monegros,2,11,-9
1997,Huesca,22084,Castejón de Sos,2,13,-11
1997,Huesca,22082,Castejón del Puente,4,7,-3
1997,Huesca,22085,Castelflorite,0,3,-3
1997,Huesca,22086,Castiello de Jaca,0,2,-2
1997,Huesca,22087,Castigaleu,0,1,-1
1997,Huesca,22088,Castillazuelo,0,7,-7
1997,Huesca,22089,Castillonroy,2,6,-4
1997,Huesca,22094,Chalamera,3,3,0
1997,Huesca,22096,Chimillas,2,2,0
1997,Huesca,22090,Colungo,1,2,-1
1997,Huesca,22099,Esplús,8,6,2
1997,Huesca,22102,Estada,1,4,-3
1997,Huesca,22103,Estadilla,8,13,-5
1997,Huesca,22105,Estopiñán del Castillo,1,3,-2
1997,Huesca,22106,Fago,0,2,-2
1997,Huesca,22109,Fiscal,3,3,0
1997,Huesca,22110,Fonz,6,16,-10
1997,Huesca,22111,Foradada del Toscar,1,4,-3
1997,Huesca,22112,Fraga,113,109,4
1997,Huesca,22113,Fueva (La),10,11,-1
1997,Huesca,22115,Grado (El),3,6,-3
1997,Huesca,22117,Graus,24,49,-25
1997,Huesca,22116,Grañén,14,20,-6
1997,Huesca,22119,Gurrea de Gállego,2,28,-26
1997,Huesca,22908,Hoz y Costeán,1,4,-3
1997,Huesca,22124,Huerto,4,2,2
1997,Huesca,22125,Huesca,414,483,-69
1997,Huesca,22127,Igriés,0,20,-20
1997,Huesca,22128,Ilche,1,5,-4
1997,Huesca,22129,Isábena,1,3,-2
1997,Huesca,22130,Jaca,120,124,-4
1997,Huesca,22131,Jasa,0,1,-1
1997,Huesca,22133,Labuerda,0,1,-1
1997,Huesca,22135,Laluenga,2,3,-1
1997,Huesca,22136,Lalueza,4,12,-8
1997,Huesca,22137,Lanaja,11,19,-8
1997,Huesca,22139,Laperdiguera,1,3,-2
1997,Huesca,22141,Lascellas-Ponzano,0,7,-7
1997,Huesca,22142,Lascuarre,0,2,-2
1997,Huesca,22143,Laspaúles,0,3,-3
1997,Huesca,22144,Laspuña,1,1,0
1997,Huesca,22149,Loarre,2,9,-7
1997,Huesca,22150,Loporzano,0,7,-7
1997,Huesca,22151,Loscorrales,1,0,1
1997,Huesca,22905,Lupiñén-Ortilla,1,4,-3
1997,Huesca,22155,Monesma y Cajigar,1,0,1
1997,Huesca,22156,Monflorite-Lascasas,1,1,0
1997,Huesca,22157,Montanuy,2,4,-2
1997,Huesca,22158,Monzón,129,151,-22
1997,Huesca,22160,Naval,0,1,-1
1997,Huesca,22162,Novales,1,2,-1
1997,Huesca,22163,Nueno,1,1,0
1997,Huesca,22164,Olvena,0,1,-1
1997,Huesca,22165,Ontiñena,1,9,-8
1997,Huesca,22167,Osso de Cinca,3,11,-8
1997,Huesca,22168,Palo,0,2,-2
1997,Huesca,22170,Panticosa,9,5,4
1997,Huesca,22174,Peralta de Alcofea,3,14,-11
1997,Huesca,22175,Peralta de Calasanz,1,9,-8
1997,Huesca,22176,Peraltilla,0,4,-4
1997,Huesca,22177,Perarrúa,0,2,-2
1997,Huesca,22178,Pertusa,1,1,0
1997,Huesca,22172,Peñalba,5,7,-2
1997,Huesca,22173,Peñas de Riglos (Las),1,7,-6
1997,Huesca,22181,Piracés,1,1,0
1997,Huesca,22182,Plan,0,4,-4
1997,Huesca,22184,Poleñino,0,1,-1
1997,Huesca,22186,Pozán de Vero,1,0,1
1997,Huesca,22187,Puebla de Castro (La),1,5,-4
1997,Huesca,22188,Puente de Montañana,1,1,0
1997,Huesca,22902,Puente la Reina de Jaca,0,5,-5
1997,Huesca,22190,Pueyo de Araguás (El),1,2,-1
1997,Huesca,22193,Pueyo de Santa Cruz,2,7,-5
1997,Huesca,22189,Puértolas,0,3,-3
1997,Huesca,22195,Quicena,0,14,-14
1997,Huesca,22197,Robres,5,4,1
1997,Huesca,22199,Sabiñánigo,57,51,6
1997,Huesca,22200,Sahún,3,0,3
1997,Huesca,22201,Salas Altas,1,6,-5
1997,Huesca,22202,Salas Bajas,1,4,-3
1997,Huesca,22203,Salillas,0,0,0
1997,Huesca,22204,Sallent de Gállego,10,5,5
1997,Huesca,22205,San Esteban de Litera,5,16,-11
1997,Huesca,22207,San Juan de Plan,1,1,0
1997,Huesca,22903,San Miguel del Cinca,3,12,-9
1997,Huesca,22206,Sangarrén,0,5,-5
1997,Huesca,22208,Santa Cilia,1,3,-2
1997,Huesca,22209,Santa Cruz de la Serós,0,1,-1
1997,Huesca,22906,Santa María de Dulcis,0,2,-2
1997,Huesca,22212,Santaliestra y San Quílez,0,2,-2
1997,Huesca,22213,Sariñena,32,47,-15
1997,Huesca,22214,Secastilla,2,2,0
1997,Huesca,22215,Seira,2,1,1
1997,Huesca,22217,Sena,3,14,-11
1997,Huesca,22220,Sesa,1,4,-3
1997,Huesca,22221,Sesué,2,0,2
1997,Huesca,22222,Siétamo,0,6,-6
1997,Huesca,22223,Sopeira,0,5,-5
1997,Huesca,22904,Sotonera (La),4,13,-9
1997,Huesca,22225,Tamarite de Litera,31,52,-21
1997,Huesca,22226,Tardienta,4,11,-7
1997,Huesca,22227,Tella-Sin,1,3,-2
1997,Huesca,22228,Tierz,0,2,-2
1997,Huesca,22229,Tolva,0,5,-5
1997,Huesca,22230,Torla-Ordesa,2,6,-4
1997,Huesca,22232,Torralba de Aragón,0,3,-3
1997,Huesca,22233,Torre la Ribera,1,1,0
1997,Huesca,22234,Torrente de Cinca,7,16,-9
1997,Huesca,22235,Torres de Alcanadre,0,1,-1
1997,Huesca,22236,Torres de Barbués,3,2,1
1997,Huesca,22242,Valfarta,0,1,-1
1997,Huesca,22901,Valle de Hecho,1,7,-6
1997,Huesca,22245,Velilla de Cinca,4,5,-1
1997,Huesca,22909,Vencillón,8,2,6
1997,Huesca,22248,Vicién,0,2,-2
1997,Huesca,22249,Villanova,0,1,-1
1997,Huesca,22251,Villanueva de Sigena,4,6,-2
1997,Huesca,22250,Villanúa,2,4,-2
1997,Huesca,22253,Yésero,1,2,-1
1997,Huesca,22254,Zaidín,17,24,-7
1997,Teruel,44001,Ababuj,1,2,-1
1997,Teruel,44002,Abejuela,0,2,-2
1997,Teruel,44004,Aguaviva,10,14,-4
1997,Teruel,44005,Aguilar del Alfambra,0,2,-2
1997,Teruel,44006,Alacón,1,9,-8
1997,Teruel,44007,Alba,0,5,-5
1997,Teruel,44008,Albalate del Arzobispo,18,36,-18
1997,Teruel,44009,Albarracín,6,18,-12
1997,Teruel,44010,Albentosa,2,5,-3
1997,Teruel,44012,Alcalá de la Selva,1,5,-4
1997,Teruel,44013,Alcañiz,138,184,-46
1997,Teruel,44014,Alcorisa,27,30,-3
1997,Teruel,44016,Alfambra,5,10,-5
1997,Teruel,44017,Aliaga,0,3,-3
1997,Teruel,44022,Alloza,0,11,-11
1997,Teruel,44018,Almohaja,0,1,-1
1997,Teruel,44019,Alobras,1,1,0
1997,Teruel,44020,Alpeñés,0,1,-1
1997,Teruel,44025,Andorra,73,53,20
1997,Teruel,44026,Arcos de las Salinas,0,3,-3
1997,Teruel,44027,Arens de Lledó,2,3,-1
1997,Teruel,44028,Argente,2,2,0
1997,Teruel,44029,Ariño,9,12,-3
1997,Teruel,44031,Azaila,0,1,-1
1997,Teruel,44035,Barrachina,0,3,-3
1997,Teruel,44034,Bañón,0,2,-2
1997,Teruel,44037,Beceite,3,13,-10
1997,Teruel,44039,Bello,4,5,-1
1997,Teruel,44038,Belmonte de San José,2,0,2
1997,Teruel,44040,Berge,1,4,-3
1997,Teruel,44041,Bezas,0,1,-1
1997,Teruel,44042,Blancas,1,3,-2
1997,Teruel,44043,Blesa,0,1,-1
1997,Teruel,44044,Bordón,1,3,-2
1997,Teruel,44045,Bronchales,2,7,-5
1997,Teruel,44046,Bueña,0,1,-1
1997,Teruel,44047,Burbáguena,0,20,-20
1997,Teruel,44033,Báguena,1,19,-18
1997,Teruel,44048,Cabra de Mora,0,2,-2
1997,Teruel,44049,Calaceite,9,9,0
1997,Teruel,44050,Calamocha,36,59,-23
1997,Teruel,44051,Calanda,31,42,-11
1997,Teruel,44052,Calomarde,0,1,-1
1997,Teruel,44054,Camarena de la Sierra,2,4,-2
1997,Teruel,44053,Camañas,0,2,-2
1997,Teruel,44056,Caminreal,7,13,-6
1997,Teruel,44059,Cantavieja,4,11,-7
1997,Teruel,44064,Cascante del Río,0,1,-1
1997,Teruel,44065,Castejón de Tornos,1,1,0
1997,Teruel,44066,Castel de Cabra,2,2,0
1997,Teruel,44070,Castellar (El),1,1,0
1997,Teruel,44071,Castellote,7,5,2
1997,Teruel,44067,Castelnou,0,1,-1
1997,Teruel,44068,Castelserás,6,15,-9
1997,Teruel,44060,Cañada de Benatanduz,0,2,-2
1997,Teruel,44061,Cañada de Verich (La),1,3,-2
1997,Teruel,44063,Cañizar del Olivar,1,0,1
1997,Teruel,44074,Cedrillas,6,6,0
1997,Teruel,44075,Celadas,3,8,-5
1997,Teruel,44076,Cella,21,37,-16
1997,Teruel,44077,Cerollera (La),0,2,-2
1997,Teruel,44080,Codoñera (La),0,3,-3
1997,Teruel,44084,Cortes de Aragón,0,2,-2
1997,Teruel,44086,Cretas,1,14,-13
1997,Teruel,44087,Crivillén,0,0,0
1997,Teruel,44088,Cuba (La),0,2,-2
1997,Teruel,44089,Cubla,0,4,-4
1997,Teruel,44090,Cucalón,0,1,-1
1997,Teruel,44092,Cuervo (El),0,5,-5
1997,Teruel,44093,Cuevas de Almudén,2,1,1
1997,Teruel,44094,Cuevas Labradas,0,2,-2
1997,Teruel,44096,Ejulve,1,4,-3
1997,Teruel,44097,Escorihuela,1,3,-2
1997,Teruel,44099,Escucha,13,7,6
1997,Teruel,44100,Estercuel,3,3,0
1997,Teruel,44101,Ferreruela de Huerva,1,2,-1
1997,Teruel,44103,Formiche Alto,4,3,1
1997,Teruel,44106,Fortanete,1,1,0
1997,Teruel,44107,Foz-Calanda,0,3,-3
1997,Teruel,44108,Fresneda (La),4,3,1
1997,Teruel,44109,Frías de Albarracín,1,0,1
1997,Teruel,44111,Fuentes Calientes,2,2,0
1997,Teruel,44112,Fuentes Claras,7,13,-6
1997,Teruel,44113,Fuentes de Rubielos,0,4,-4
1997,Teruel,44114,Fuentespalda,4,5,-1
1997,Teruel,44105,Fórnoles,0,1,-1
1997,Teruel,44115,Galve,1,1,0
1997,Teruel,44116,Gargallo,1,1,0
1997,Teruel,44117,Gea de Albarracín,6,9,-3
1997,Teruel,44118,Ginebrosa (La),0,3,-3
1997,Teruel,44119,Griegos,0,5,-5
1997,Teruel,44120,Guadalaviar,3,2,1
1997,Teruel,44121,Gúdar,0,1,-1
1997,Teruel,44123,Hinojosa de Jarque,1,4,-3
1997,Teruel,44124,Hoz de la Vieja (La),0,2,-2
1997,Teruel,44125,Huesa del Común,0,2,-2
1997,Teruel,44122,Híjar,10,36,-26
1997,Teruel,44126,Iglesuela del Cid (La),2,5,-3
1997,Teruel,44127,Jabaloyas,1,2,-1
1997,Teruel,44128,Jarque de la Val,0,2,-2
1997,Teruel,44129,Jatiel,0,1,-1
1997,Teruel,44131,Josa,0,0,0
1997,Teruel,44135,Libros,0,3,-3
1997,Teruel,44137,Linares de Mora,1,6,-5
1997,Teruel,44141,Lledó,1,5,-4
1997,Teruel,44138,Loscos,0,3,-3
1997,Teruel,44142,Maicas,0,2,-2
1997,Teruel,44143,Manzanera,6,8,-2
1997,Teruel,44144,Martín del Río,4,6,-2
1997,Teruel,44145,Mas de las Matas,11,18,-7
1997,Teruel,44146,Mata de los Olmos (La),1,4,-3
1997,Teruel,44147,Mazaleón,4,12,-8
1997,Teruel,44148,Mezquita de Jarque,1,1,0
1997,Teruel,44150,Miravete de la Sierra,0,1,-1
1997,Teruel,44151,Molinos,2,5,-3
1997,Teruel,44152,Monforte de Moyuela,0,2,-2
1997,Teruel,44153,Monreal del Campo,21,23,-2
1997,Teruel,44154,Monroyo,2,2,0
1997,Teruel,44155,Montalbán,11,24,-13
1997,Teruel,44156,Monteagudo del Castillo,0,1,-1
1997,Teruel,44157,Monterde de Albarracín,0,1,-1
1997,Teruel,44158,Mora de Rubielos,23,18,5
1997,Teruel,44159,Moscardón,0,1,-1
1997,Teruel,44160,Mosqueruela,4,9,-5
1997,Teruel,44161,Muniesa,4,15,-11
1997,Teruel,44163,Noguera de Albarracín,0,0,0
1997,Teruel,44165,Nogueruelas,1,3,-2
1997,Teruel,44167,Obón,0,1,-1
1997,Teruel,44168,Odón,1,6,-5
1997,Teruel,44169,Ojos Negros,5,10,-5
1997,Teruel,44171,Olba,0,3,-3
1997,Teruel,44172,Oliete,1,8,-7
1997,Teruel,44173,Olmos (Los),1,1,0
1997,Teruel,44174,Orihuela del Tremedal,8,5,3
1997,Teruel,44175,Orrios,0,3,-3
1997,Teruel,44176,Palomar de Arroyos,2,2,0
1997,Teruel,44177,Pancrudo,0,4,-4
1997,Teruel,44178,Parras de Castellote (Las),0,4,-4
1997,Teruel,44181,Peralejos,1,1,0
1997,Teruel,44182,Perales del Alfambra,4,4,0
1997,Teruel,44179,Peñarroya de Tastavins,4,16,-12
1997,Teruel,44183,Pitarque,1,4,-3
1997,Teruel,44185,Pobo (El),0,4,-4
1997,Teruel,44187,Portellada (La),1,8,-7
1997,Teruel,44189,Pozondón,0,1,-1
1997,Teruel,44190,Pozuel del Campo,0,2,-2
1997,Teruel,44191,Puebla de Híjar (La),11,20,-9
1997,Teruel,44192,Puebla de Valverde (La),5,4,1
1997,Teruel,44193,Puertomingalvo,0,1,-1
1997,Teruel,44195,Rillo,0,2,-2
1997,Teruel,44196,Riodeva,1,7,-6
1997,Teruel,44198,Royuela,3,3,0
1997,Teruel,44199,Rubiales,0,1,-1
1997,Teruel,44200,Rubielos de la Cérida,1,0,1
1997,Teruel,44201,Rubielos de Mora,5,13,-8
1997,Teruel,44194,Ráfales,0,4,-4
1997,Teruel,44197,Ródenas,2,3,-1
1997,Teruel,44205,Samper de Calanda,7,17,-10
1997,Teruel,44206,San Agustín,1,4,-3
1997,Teruel,44207,San Martín del Río,0,2,-2
1997,Teruel,44208,Santa Cruz de Nogueras,0,1,-1
1997,Teruel,44209,Santa Eulalia,5,23,-18
1997,Teruel,44210,Sarrión,10,24,-14
1997,Teruel,44211,Segura de los Baños,0,1,-1
1997,Teruel,44212,Seno,0,2,-2
1997,Teruel,44213,Singra,1,2,-1
1997,Teruel,44215,Terriente,1,3,-2
1997,Teruel,44216,Teruel,287,332,-45
1997,Teruel,44217,Toril y Masegoso,0,1,-1
1997,Teruel,44218,Tormón,0,1,-1
1997,Teruel,44219,Tornos,1,4,-3
1997,Teruel,44220,Torralba de los Sisones,7,2,5
1997,Teruel,44223,Torre de Arcas,0,2,-2
1997,Teruel,44225,Torre del Compte,0,6,-6
1997,Teruel,44227,Torre los Negros,1,2,-1
1997,Teruel,44221,Torrecilla de Alcañiz,1,8,-7
1997,Teruel,44222,Torrecilla del Rebollar,0,2,-2
1997,Teruel,44226,Torrelacárcel,0,3,-3
1997,Teruel,44228,Torremocha de Jiloca,0,5,-5
1997,Teruel,44229,Torres de Albarracín,1,3,-2
1997,Teruel,44230,Torrevelilla,2,4,-2
1997,Teruel,44231,Torrijas,0,1,-1
1997,Teruel,44232,Torrijo del Campo,2,8,-6
1997,Teruel,44234,Tramacastiel,0,1,-1
1997,Teruel,44235,Tramacastilla,0,2,-2
1997,Teruel,44236,Tronchón,1,2,-1
1997,Teruel,44237,Urrea de Gaén,1,10,-9
1997,Teruel,44238,Utrillas,20,32,-12
1997,Teruel,44240,Valbona,0,3,-3
1997,Teruel,44241,Valdealgorfa,4,13,-9
1997,Teruel,44244,Valdelinares,3,0,3
1997,Teruel,44245,Valdeltormo,1,6,-5
1997,Teruel,44246,Valderrobres,14,28,-14
1997,Teruel,44247,Valjunquera,3,12,-9
1997,Teruel,44249,Vallecillo (El),0,2,-2
1997,Teruel,44250,Veguillas de la Sierra,0,1,-1
1997,Teruel,44251,Villafranca del Campo,3,9,-6
1997,Teruel,44252,Villahermosa del Campo,0,0,0
1997,Teruel,44256,Villanueva del Rebollar de la Sierra,1,1,0
1997,Teruel,44257,Villar del Cobo,1,3,-2
1997,Teruel,44260,Villarluengo,1,1,0
1997,Teruel,44261,Villarquemado,8,8,0
1997,Teruel,44262,Villarroya de los Pinares,1,3,-2
1997,Teruel,44263,Villastar,4,5,-1
1997,Teruel,44264,Villel,0,7,-7
1997,Teruel,44265,Vinaceite,1,2,-1
1997,Teruel,44266,Visiedo,0,5,-5
1997,Teruel,44267,Vivel del Río Martín,0,3,-3
1997,Zaragoza,50001,Abanto,0,3,-3
1997,Zaragoza,50002,Acered,1,6,-5
1997,Zaragoza,50004,Aguarón,3,8,-5
1997,Zaragoza,50005,Aguilón,0,4,-4
1997,Zaragoza,50003,Agón,0,1,-1
1997,Zaragoza,50006,Ainzón,14,6,8
1997,Zaragoza,50007,Aladrén,0,2,-2
1997,Zaragoza,50008,Alagón,35,67,-32
1997,Zaragoza,50009,Alarba,1,0,1
1997,Zaragoza,50010,Alberite de San Juan,0,2,-2
1997,Zaragoza,50011,Albeta,0,5,-5
1997,Zaragoza,50012,Alborge,2,0,2
1997,Zaragoza,50013,Alcalá de Ebro,2,5,-3
1997,Zaragoza,50014,Alcalá de Moncayo,0,1,-1
1997,Zaragoza,50015,Alconchel de Ariza,0,1,-1
1997,Zaragoza,50016,Aldehuela de Liestos,0,3,-3
1997,Zaragoza,50017,Alfajarín,18,19,-1
1997,Zaragoza,50018,Alfamén,8,11,-3
1997,Zaragoza,50019,Alforque,0,2,-2
1997,Zaragoza,50020,Alhama de Aragón,10,14,-4
1997,Zaragoza,50021,Almochuel,0,2,-2
1997,Zaragoza,50022,Almolda (La),4,9,-5
1997,Zaragoza,50023,Almonacid de la Cuba,1,2,-1
1997,Zaragoza,50024,Almonacid de la Sierra,5,17,-12
1997,Zaragoza,50025,Almunia de Doña Godina (La),46,52,-6
1997,Zaragoza,50026,Alpartir,5,8,-3
1997,Zaragoza,50027,Ambel,0,6,-6
1997,Zaragoza,50029,Aniñón,5,13,-8
1997,Zaragoza,50031,Aranda de Moncayo,1,2,-1
1997,Zaragoza,50034,Ariza,6,16,-10
1997,Zaragoza,50035,Artieda,0,1,-1
1997,Zaragoza,50032,Arándiga,1,8,-7
1997,Zaragoza,50036,Asín,0,3,-3
1997,Zaragoza,50037,Atea,1,5,-4
1997,Zaragoza,50038,Ateca,6,23,-17
1997,Zaragoza,50039,Azuara,3,7,-4
1997,Zaragoza,50040,Badules,0,2,-2
1997,Zaragoza,50042,Balconchán,0,1,-1
1997,Zaragoza,50044,Bardallur,2,4,-2
1997,Zaragoza,50045,Belchite,16,25,-9
1997,Zaragoza,50046,Belmonte de Gracián,0,7,-7
1997,Zaragoza,50050,Bijuesca,1,2,-1
1997,Zaragoza,50051,Biota,16,12,4
1997,Zaragoza,50052,Bisimbre,0,2,-2
1997,Zaragoza,50053,Boquiñeni,3,17,-14
1997,Zaragoza,50055,Borja,39,63,-24
1997,Zaragoza,50056,Botorrita,1,1,0
1997,Zaragoza,50057,Brea de Aragón,13,18,-5
1997,Zaragoza,50058,Bubierca,0,4,-4
1997,Zaragoza,50059,Bujaraloz,13,14,-1
1997,Zaragoza,50060,Bulbuente,2,7,-5
1997,Zaragoza,50061,Bureta,3,6,-3
1997,Zaragoza,50062,Burgo de Ebro (El),16,14,2
1997,Zaragoza,50063,Buste (El),0,2,-2
1997,Zaragoza,50043,Bárboles,2,9,-7
1997,Zaragoza,50064,Cabañas de Ebro,4,5,-1
1997,Zaragoza,50065,Cabolafuente,0,0,0
1997,Zaragoza,50066,Cadrete,11,11,0
1997,Zaragoza,50067,Calatayud,142,207,-65
1997,Zaragoza,50068,Calatorao,17,28,-11
1997,Zaragoza,50069,Calcena,0,1,-1
1997,Zaragoza,50070,Calmarza,0,1,-1
1997,Zaragoza,50071,Campillo de Aragón,3,4,-1
1997,Zaragoza,50072,Carenas,0,5,-5
1997,Zaragoza,50073,Cariñena,20,26,-6
1997,Zaragoza,50074,Caspe,74,115,-41
1997,Zaragoza,50075,Castejón de Alarba,0,1,-1
1997,Zaragoza,50076,Castejón de las Armas,0,4,-4
1997,Zaragoza,50077,Castejón de Valdejasa,0,2,-2
1997,Zaragoza,50078,Castiliscar,0,7,-7
1997,Zaragoza,50079,Cervera de la Cañada,1,4,-3
1997,Zaragoza,50081,Cetina,3,15,-12
1997,Zaragoza,50092,Chiprana,1,7,-6
1997,Zaragoza,50093,Chodes,0,7,-7
1997,Zaragoza,50082,Cimballa,0,2,-2
1997,Zaragoza,50083,Cinco Olivas,0,3,-3
1997,Zaragoza,50084,Clarés de Ribota,1,1,0
1997,Zaragoza,50085,Codo,1,5,-4
1997,Zaragoza,50086,Codos,4,8,-4
1997,Zaragoza,50087,Contamina,0,1,-1
1997,Zaragoza,50088,Cosuenda,0,8,-8
1997,Zaragoza,50089,Cuarte de Huerva,12,27,-15
1997,Zaragoza,50090,Cubel,3,2,1
1997,Zaragoza,50091,Cuerlas (Las),0,1,-1
1997,Zaragoza,50094,Daroca,21,24,-3
1997,Zaragoza,50095,Ejea de los Caballeros,117,147,-30
1997,Zaragoza,50096,Embid de Ariza,0,1,-1
1997,Zaragoza,50098,Encinacorba,2,6,-4
1997,Zaragoza,50100,Erla,5,5,0
1997,Zaragoza,50101,Escatrón,8,16,-8
1997,Zaragoza,50102,Fabara,4,10,-6
1997,Zaragoza,50104,Farlete,3,1,2
1997,Zaragoza,50106,Fayos (Los),1,7,-6
1997,Zaragoza,50105,Fayón,2,4,-2
1997,Zaragoza,50107,Figueruelas,9,6,3
1997,Zaragoza,50109,Frago (El),0,1,-1
1997,Zaragoza,50110,Frasno (El),3,9,-6
1997,Zaragoza,50111,Fréscano,2,5,-3
1997,Zaragoza,50113,Fuendejalón,14,10,4
1997,Zaragoza,50114,Fuendetodos,1,2,-1
1997,Zaragoza,50115,Fuentes de Ebro,26,34,-8
1997,Zaragoza,50116,Fuentes de Jiloca,1,8,-7
1997,Zaragoza,50117,Gallocanta,0,4,-4
1997,Zaragoza,50118,Gallur,16,25,-9
1997,Zaragoza,50119,Gelsa,2,19,-17
1997,Zaragoza,50120,Godojos,0,3,-3
1997,Zaragoza,50121,Gotor,2,4,-2
1997,Zaragoza,50122,Grisel,0,1,-1
1997,Zaragoza,50123,Grisén,1,4,-3
1997,Zaragoza,50124,Herrera de los Navarros,3,4,-1
1997,Zaragoza,50125,Ibdes,4,8,-4
1997,Zaragoza,50126,Illueca,31,24,7
1997,Zaragoza,50128,Isuerre,1,1,0
1997,Zaragoza,50129,Jaraba,0,7,-7
1997,Zaragoza,50130,Jarque de Moncayo,4,7,-3
1997,Zaragoza,50131,Jaulín,1,4,-3
1997,Zaragoza,50132,Joyosa (La),1,7,-6
1997,Zaragoza,50133,Lagata,0,1,-1
1997,Zaragoza,50134,Langa del Castillo,1,0,1
1997,Zaragoza,50135,Layana,2,3,-1
1997,Zaragoza,50137,Leciñena,5,11,-6
1997,Zaragoza,50139,Letux,2,3,-1
1997,Zaragoza,50140,Litago,0,3,-3
1997,Zaragoza,50141,Lituénigo,0,1,-1
1997,Zaragoza,50143,Longares,4,17,-13
1997,Zaragoza,50144,Longás,0,1,-1
1997,Zaragoza,50146,Lucena de Jalón,0,1,-1
1997,Zaragoza,50147,Luceni,3,14,-11
1997,Zaragoza,50148,Luesia,2,6,-4
1997,Zaragoza,50150,Lumpiaque,8,21,-13
1997,Zaragoza,50151,Luna,9,13,-4
1997,Zaragoza,50136,Lécera,7,10,-3
1997,Zaragoza,50152,Maella,10,28,-18
1997,Zaragoza,50153,Magallón,3,18,-15
1997,Zaragoza,50154,Mainar,3,2,1
1997,Zaragoza,50155,Malanquilla,0,3,-3
1997,Zaragoza,50156,Maleján,2,6,-4
1997,Zaragoza,50160,Mallén,25,43,-18
1997,Zaragoza,50159,Maluenda,8,25,-17
1997,Zaragoza,50157,Malón,2,8,-6
1997,Zaragoza,50161,Manchones,2,2,0
1997,Zaragoza,50162,Mara,1,0,1
1997,Zaragoza,50163,María de Huerva,4,26,-22
1997,Zaragoza,50164,Mediana de Aragón,4,9,-5
1997,Zaragoza,50165,Mequinenza,19,31,-12
1997,Zaragoza,50166,Mesones de Isuela,3,3,0
1997,Zaragoza,50167,Mezalocha,1,5,-4
1997,Zaragoza,50169,Miedes de Aragón,1,3,-2
1997,Zaragoza,50170,Monegrillo,2,4,-2
1997,Zaragoza,50171,Moneva,0,4,-4
1997,Zaragoza,50172,Monreal de Ariza,0,6,-6
1997,Zaragoza,50173,Monterde,1,3,-2
1997,Zaragoza,50175,Morata de Jalón,7,17,-10
1997,Zaragoza,50176,Morata de Jiloca,1,5,-4
1997,Zaragoza,50178,Moros,8,12,-4
1997,Zaragoza,50177,Morés,5,1,4
1997,Zaragoza,50179,Moyuela,0,6,-6
1997,Zaragoza,50180,Mozota,0,2,-2
1997,Zaragoza,50181,Muel,6,13,-7
1997,Zaragoza,50182,Muela (La),4,11,-7
1997,Zaragoza,50183,Munébrega,1,7,-6
1997,Zaragoza,50184,Murero,0,4,-4
1997,Zaragoza,50185,Murillo de Gállego,0,1,-1
1997,Zaragoza,50186,Navardún,1,1,0
1997,Zaragoza,50187,Nigüella,0,2,-2
1997,Zaragoza,50188,Nombrevilla,0,1,-1
1997,Zaragoza,50189,Nonaspe,6,23,-17
1997,Zaragoza,50190,Novallas,5,10,-5
1997,Zaragoza,50191,Novillas,4,9,-5
1997,Zaragoza,50193,Nuez de Ebro,6,7,-1
1997,Zaragoza,50192,Nuévalos,3,3,0
1997,Zaragoza,50194,Olvés,0,1,-1
1997,Zaragoza,50196,Orera,1,2,-1
1997,Zaragoza,50197,Orés,0,2,-2
1997,Zaragoza,50199,Osera de Ebro,0,5,-5
1997,Zaragoza,50200,Paniza,2,8,-6
1997,Zaragoza,50201,Paracuellos de Jiloca,1,7,-6
1997,Zaragoza,50202,Paracuellos de la Ribera,1,3,-2
1997,Zaragoza,50203,Pastriz,8,10,-2
1997,Zaragoza,50204,Pedrola,13,33,-20
1997,Zaragoza,50205,Pedrosas (Las),1,0,1
1997,Zaragoza,50206,Perdiguera,5,5,0
1997,Zaragoza,50207,Piedratajada,1,3,-2
1997,Zaragoza,50208,Pina de Ebro,19,24,-5
1997,Zaragoza,50209,Pinseque,9,44,-35
1997,Zaragoza,50210,Pintanos (Los),0,1,-1
1997,Zaragoza,50211,Plasencia de Jalón,2,3,-1
1997,Zaragoza,50213,Plenas,0,1,-1
1997,Zaragoza,50215,Pozuel de Ariza,0,1,-1
1997,Zaragoza,50216,Pozuelo de Aragón,1,2,-1
1997,Zaragoza,50217,Pradilla de Ebro,5,6,-1
1997,Zaragoza,50218,Puebla de Albortón,1,4,-3
1997,Zaragoza,50219,Puebla de Alfindén (La),11,15,-4
1997,Zaragoza,50222,Quinto,11,22,-11
1997,Zaragoza,50223,Remolinos,5,11,-6
1997,Zaragoza,50225,Ricla,8,27,-19
1997,Zaragoza,50227,Romanos,0,4,-4
1997,Zaragoza,50228,Rueda de Jalón,2,4,-2
1997,Zaragoza,50229,Ruesca,1,0,1
1997,Zaragoza,50231,Salillas de Jalón,1,5,-4
1997,Zaragoza,50232,Salvatierra de Esca,1,4,-3
1997,Zaragoza,50233,Samper del Salz,0,1,-1
1997,Zaragoza,50234,San Martín de la Virgen de Moncayo,0,4,-4
1997,Zaragoza,50235,San Mateo de Gállego,13,28,-15
1997,Zaragoza,50236,Santa Cruz de Grío,0,2,-2
1997,Zaragoza,50237,Santa Cruz de Moncayo,3,0,3
1997,Zaragoza,50238,Santa Eulalia de Gállego,0,2,-2
1997,Zaragoza,50239,Santed,0,1,-1
1997,Zaragoza,50241,Saviñán,0,6,-6
1997,Zaragoza,50242,Sediles,0,1,-1
1997,Zaragoza,50243,Sestrica,3,6,-3
1997,Zaragoza,50244,Sierra de Luna,1,7,-6
1997,Zaragoza,50245,Sigüés,0,3,-3
1997,Zaragoza,50246,Sisamón,0,4,-4
1997,Zaragoza,50247,Sobradiel,1,7,-6
1997,Zaragoza,50248,Sos del Rey Católico,8,10,-2
1997,Zaragoza,50230,Sádaba,13,30,-17
1997,Zaragoza,50240,Sástago,8,27,-19
1997,Zaragoza,50249,Tabuenca,1,9,-8
1997,Zaragoza,50250,Talamantes,1,1,0
1997,Zaragoza,50251,Tarazona,85,112,-27
1997,Zaragoza,50252,Tauste,59,74,-15
1997,Zaragoza,50253,Terrer,1,9,-8
1997,Zaragoza,50254,Tierga,1,2,-1
1997,Zaragoza,50255,Tobed,0,5,-5
1997,Zaragoza,50256,Torralba de los Frailes,0,1,-1
1997,Zaragoza,50257,Torralba de Ribota,0,7,-7
1997,Zaragoza,50258,Torralbilla,0,1,-1
1997,Zaragoza,50259,Torrehermosa,1,4,-3
1997,Zaragoza,50260,Torrelapaja,0,1,-1
1997,Zaragoza,50261,Torrellas,1,5,-4
1997,Zaragoza,50262,Torres de Berrellén,11,16,-5
1997,Zaragoza,50263,Torrijo de la Cañada,0,8,-8
1997,Zaragoza,50264,Tosos,1,6,-5
1997,Zaragoza,50266,Trasobares,2,6,-4
1997,Zaragoza,50267,Uncastillo,3,22,-19
1997,Zaragoza,50269,Urrea de Jalón,1,2,-1
1997,Zaragoza,50270,Urriés,0,1,-1
1997,Zaragoza,50271,Used,4,5,-1
1997,Zaragoza,50272,Utebo,101,64,37
1997,Zaragoza,50274,Val de San Martín,0,1,-1
1997,Zaragoza,50273,Valdehorna,0,1,-1
1997,Zaragoza,50275,Valmadrid,0,1,-1
1997,Zaragoza,50276,Valpalmas,0,3,-3
1997,Zaragoza,50277,Valtorres,0,4,-4
1997,Zaragoza,50278,Velilla de Ebro,2,6,-4
1997,Zaragoza,50279,Velilla de Jiloca,0,1,-1
1997,Zaragoza,50280,Vera de Moncayo,3,7,-4
1997,Zaragoza,50281,Vierlas,0,1,-1
1997,Zaragoza,50284,Villafeliche,0,2,-2
1997,Zaragoza,50285,Villafranca de Ebro,5,7,-2
1997,Zaragoza,50286,Villalba de Perejil,0,1,-1
1997,Zaragoza,50287,Villalengua,2,11,-9
1997,Zaragoza,50288,Villanueva de Gállego,28,34,-6
1997,Zaragoza,50290,Villanueva de Huerva,6,10,-4
1997,Zaragoza,50289,Villanueva de Jiloca,0,3,-3
1997,Zaragoza,50291,Villar de los Navarros,0,2,-2
1997,Zaragoza,50292,Villarreal de Huerva,2,1,1
1997,Zaragoza,50293,Villarroya de la Sierra,5,13,-8
1997,Zaragoza,50282,Vilueña (La),0,4,-4
1997,Zaragoza,50296,Zaida (La),5,10,-5
1997,Zaragoza,50297,Zaragoza,5114,5557,-443
1997,Zaragoza,50298,Zuera,42,60,-18
1997,Zaragoza,50099,Épila,39,54,-15
1996,Huesca,22001,Abiego,0,6,-6
1996,Huesca,22002,Abizanda,2,0,2
1996,Huesca,22003,Adahuesca,2,5,-3
1996,Huesca,22004,Agüero,0,1,-1
1996,Huesca,22007,Albalate de Cinca,5,15,-10
1996,Huesca,22008,Albalatillo,0,5,-5
1996,Huesca,22009,Albelda,4,11,-7
1996,Huesca,22011,Albero Alto,0,0,0
1996,Huesca,22013,Alberuela de Tubo,3,8,-5
1996,Huesca,22014,Alcalá de Gurrea,0,3,-3
1996,Huesca,22015,Alcalá del Obispo,2,4,-2
1996,Huesca,22016,Alcampell,8,13,-5
1996,Huesca,22017,Alcolea de Cinca,9,12,-3
1996,Huesca,22018,Alcubierre,2,8,-6
1996,Huesca,22019,Alerre,0,1,-1
1996,Huesca,22020,Alfántega,1,2,-1
1996,Huesca,22021,Almudévar,15,34,-19
1996,Huesca,22022,Almunia de San Juan,1,19,-18
1996,Huesca,22023,Almuniente,3,4,-1
1996,Huesca,22024,Alquézar,1,2,-1
1996,Huesca,22025,Altorricón,14,18,-4
1996,Huesca,22027,Angüés,2,8,-6
1996,Huesca,22028,Ansó,5,14,-9
1996,Huesca,22029,Antillón,0,3,-3
1996,Huesca,22032,Aragüés del Puerto,0,2,-2
1996,Huesca,22036,Argavieso,0,3,-3
1996,Huesca,22037,Arguis,1,1,0
1996,Huesca,22035,Arén,4,6,-2
1996,Huesca,22039,Ayerbe,9,19,-10
1996,Huesca,22040,Azanuy-Alins,0,6,-6
1996,Huesca,22041,Azara,1,2,-1
1996,Huesca,22042,Azlor,3,1,2
1996,Huesca,22907,Aínsa-Sobrarbe,13,24,-11
1996,Huesca,22006,Aísa,0,1,-1
1996,Huesca,22043,Baells,1,2,-1
1996,Huesca,22044,Bailo,1,2,-1
1996,Huesca,22045,Baldellou,2,1,1
1996,Huesca,22046,Ballobar,3,18,-15
1996,Huesca,22048,Barbastro,157,189,-32
1996,Huesca,22049,Barbués,0,2,-2
1996,Huesca,22050,Barbuñales,1,1,0
1996,Huesca,22052,Belver de Cinca,6,18,-12
1996,Huesca,22053,Benabarre,6,24,-18
1996,Huesca,22054,Benasque,9,7,2
1996,Huesca,22055,Berbegal,4,10,-6
1996,Huesca,22057,Bielsa,7,6,1
1996,Huesca,22058,Bierge,0,2,-2
1996,Huesca,22059,Biescas,9,17,-8
1996,Huesca,22060,Binaced,12,26,-14
1996,Huesca,22061,Binéfar,76,82,-6
1996,Huesca,22062,Bisaurri,0,3,-3
1996,Huesca,22063,Biscarrués,2,4,-2
1996,Huesca,22064,Blecua y Torres,0,1,-1
1996,Huesca,22066,Boltaña,6,8,-2
1996,Huesca,22067,Bonansa,0,1,-1
1996,Huesca,22068,Borau,1,0,1
1996,Huesca,22069,Broto,3,8,-5
1996,Huesca,22051,Bárcabo,0,0,0
1996,Huesca,22072,Caldearenas,0,2,-2
1996,Huesca,22074,Campo,0,4,-4
1996,Huesca,22075,Camporrells,0,3,-3
1996,Huesca,22076,Canal de Berdún,3,4,-1
1996,Huesca,22077,Candasnos,1,6,-5
1996,Huesca,22078,Canfranc,7,7,0
1996,Huesca,22079,Capdesaso,2,3,-1
1996,Huesca,22080,Capella,4,10,-6
1996,Huesca,22081,Casbas de Huesca,0,8,-8
1996,Huesca,22083,Castejón de Monegros,4,10,-6
1996,Huesca,22084,Castejón de Sos,4,7,-3
1996,Huesca,22082,Castejón del Puente,5,3,2
1996,Huesca,22085,Castelflorite,0,5,-5
1996,Huesca,22086,Castiello de Jaca,0,2,-2
1996,Huesca,22087,Castigaleu,0,3,-3
1996,Huesca,22088,Castillazuelo,0,3,-3
1996,Huesca,22089,Castillonroy,0,8,-8
1996,Huesca,22094,Chalamera,2,2,0
1996,Huesca,22096,Chimillas,1,1,0
1996,Huesca,22095,Chía,0,2,-2
1996,Huesca,22099,Esplús,3,5,-2
1996,Huesca,22102,Estada,1,4,-3
1996,Huesca,22103,Estadilla,4,12,-8
1996,Huesca,22105,Estopiñán del Castillo,1,3,-2
1996,Huesca,22107,Fanlo,0,1,-1
1996,Huesca,22109,Fiscal,0,1,-1
1996,Huesca,22110,Fonz,7,23,-16
1996,Huesca,22111,Foradada del Toscar,0,2,-2
1996,Huesca,22112,Fraga,123,104,19
1996,Huesca,22113,Fueva (La),5,5,0
1996,Huesca,22114,Gistaín,0,6,-6
1996,Huesca,22115,Grado (El),1,13,-12
1996,Huesca,22117,Graus,29,52,-23
1996,Huesca,22116,Grañén,10,23,-13
1996,Huesca,22119,Gurrea de Gállego,8,16,-8
1996,Huesca,22122,Hoz de Jaca,1,3,-2
1996,Huesca,22908,Hoz y Costeán,0,2,-2
1996,Huesca,22124,Huerto,0,3,-3
1996,Huesca,22125,Huesca,433,461,-28
1996,Huesca,22127,Igriés,0,10,-10
1996,Huesca,22128,Ilche,1,4,-3
1996,Huesca,22129,Isábena,3,3,0
1996,Huesca,22130,Jaca,105,166,-61
1996,Huesca,22131,Jasa,0,0,0
1996,Huesca,22133,Labuerda,1,3,-2
1996,Huesca,22135,Laluenga,0,6,-6
1996,Huesca,22136,Lalueza,3,16,-13
1996,Huesca,22137,Lanaja,10,19,-9
1996,Huesca,22141,Lascellas-Ponzano,0,3,-3
1996,Huesca,22142,Lascuarre,0,4,-4
1996,Huesca,22143,Laspaúles,0,3,-3
1996,Huesca,22144,Laspuña,2,1,1
1996,Huesca,22149,Loarre,0,5,-5
1996,Huesca,22150,Loporzano,1,4,-3
1996,Huesca,22151,Loscorrales,1,1,0
1996,Huesca,22905,Lupiñén-Ortilla,3,2,1
1996,Huesca,22156,Monflorite-Lascasas,0,2,-2
1996,Huesca,22157,Montanuy,1,5,-4
1996,Huesca,22158,Monzón,133,165,-32
1996,Huesca,22160,Naval,1,4,-3
1996,Huesca,22162,Novales,0,4,-4
1996,Huesca,22163,Nueno,0,2,-2
1996,Huesca,22165,Ontiñena,5,13,-8
1996,Huesca,22167,Osso de Cinca,14,9,5
1996,Huesca,22168,Palo,0,3,-3
1996,Huesca,22170,Panticosa,6,4,2
1996,Huesca,22174,Peralta de Alcofea,2,13,-11
1996,Huesca,22175,Peralta de Calasanz,1,7,-6
1996,Huesca,22176,Peraltilla,0,3,-3
1996,Huesca,22177,Perarrúa,0,5,-5
1996,Huesca,22178,Pertusa,1,4,-3
1996,Huesca,22172,Peñalba,6,4,2
1996,Huesca,22173,Peñas de Riglos (Las),0,4,-4
1996,Huesca,22182,Plan,2,0,2
1996,Huesca,22184,Poleñino,0,3,-3
1996,Huesca,22186,Pozán de Vero,2,4,-2
1996,Huesca,22187,Puebla de Castro (La),1,2,-1
1996,Huesca,22188,Puente de Montañana,3,2,1
1996,Huesca,22902,Puente la Reina de Jaca,1,2,-1
1996,Huesca,22190,Pueyo de Araguás (El),0,0,0
1996,Huesca,22193,Pueyo de Santa Cruz,1,5,-4
1996,Huesca,22189,Puértolas,3,2,1
1996,Huesca,22195,Quicena,1,14,-13
1996,Huesca,22197,Robres,3,9,-6
1996,Huesca,22199,Sabiñánigo,68,69,-1
1996,Huesca,22200,Sahún,3,2,1
1996,Huesca,22201,Salas Altas,5,9,-4
1996,Huesca,22202,Salas Bajas,0,2,-2
1996,Huesca,22203,Salillas,0,1,-1
1996,Huesca,22204,Sallent de Gállego,10,11,-1
1996,Huesca,22205,San Esteban de Litera,2,12,-10
1996,Huesca,22207,San Juan de Plan,0,3,-3
1996,Huesca,22903,San Miguel del Cinca,10,20,-10
1996,Huesca,22206,Sangarrén,1,2,-1
1996,Huesca,22208,Santa Cilia,1,2,-1
1996,Huesca,22209,Santa Cruz de la Serós,2,4,-2
1996,Huesca,22906,Santa María de Dulcis,0,4,-4
1996,Huesca,22212,Santaliestra y San Quílez,0,1,-1
1996,Huesca,22213,Sariñena,14,62,-48
1996,Huesca,22214,Secastilla,0,2,-2
1996,Huesca,22215,Seira,2,5,-3
1996,Huesca,22217,Sena,5,13,-8
1996,Huesca,22218,Senés de Alcubierre,0,1,-1
1996,Huesca,22220,Sesa,1,3,-2
1996,Huesca,22221,Sesué,2,2,0
1996,Huesca,22222,Siétamo,3,4,-1
1996,Huesca,22223,Sopeira,1,7,-6
1996,Huesca,22904,Sotonera (La),2,12,-10
1996,Huesca,22225,Tamarite de Litera,38,66,-28
1996,Huesca,22226,Tardienta,6,16,-10
1996,Huesca,22227,Tella-Sin,2,5,-3
1996,Huesca,22228,Tierz,1,3,-2
1996,Huesca,22229,Tolva,1,5,-4
1996,Huesca,22230,Torla-Ordesa,1,3,-2
1996,Huesca,22232,Torralba de Aragón,0,1,-1
1996,Huesca,22234,Torrente de Cinca,7,12,-5
1996,Huesca,22235,Torres de Alcanadre,0,2,-2
1996,Huesca,22236,Torres de Barbués,2,4,-2
1996,Huesca,22239,Tramaced,0,4,-4
1996,Huesca,22242,Valfarta,0,3,-3
1996,Huesca,22243,Valle de Bardají,1,0,1
1996,Huesca,22901,Valle de Hecho,2,4,-2
1996,Huesca,22244,Valle de Lierp,0,1,-1
1996,Huesca,22245,Velilla de Cinca,3,12,-9
1996,Huesca,22909,Vencillón,4,4,0
1996,Huesca,22247,Viacamp y Litera,0,1,-1
1996,Huesca,22248,Vicién,1,4,-3
1996,Huesca,22249,Villanova,0,1,-1
1996,Huesca,22251,Villanueva de Sigena,1,6,-5
1996,Huesca,22250,Villanúa,2,4,-2
1996,Huesca,22252,Yebra de Basa,1,2,-1
1996,Huesca,22254,Zaidín,7,17,-10
1996,Teruel,44001,Ababuj,1,2,-1
1996,Teruel,44002,Abejuela,0,1,-1
1996,Teruel,44003,Aguatón,0,1,-1
1996,Teruel,44004,Aguaviva,4,11,-7
1996,Teruel,44005,Aguilar del Alfambra,1,0,1
1996,Teruel,44006,Alacón,1,10,-9
1996,Teruel,44007,Alba,0,2,-2
1996,Teruel,44008,Albalate del Arzobispo,15,42,-27
1996,Teruel,44009,Albarracín,10,16,-6
1996,Teruel,44010,Albentosa,6,4,2
1996,Teruel,44011,Alcaine,1,1,0
1996,Teruel,44012,Alcalá de la Selva,3,2,1
1996,Teruel,44013,Alcañiz,109,135,-26
1996,Teruel,44014,Alcorisa,33,37,-4
1996,Teruel,44016,Alfambra,4,14,-10
1996,Teruel,44017,Aliaga,3,8,-5
1996,Teruel,44021,Allepuz,1,1,0
1996,Teruel,44022,Alloza,5,17,-12
1996,Teruel,44019,Alobras,1,2,-1
1996,Teruel,44025,Andorra,75,52,23
1996,Teruel,44027,Arens de Lledó,2,3,-1
1996,Teruel,44028,Argente,0,6,-6
1996,Teruel,44029,Ariño,5,14,-9
1996,Teruel,44031,Azaila,0,4,-4
1996,Teruel,44035,Barrachina,2,1,1
1996,Teruel,44034,Bañón,1,5,-4
1996,Teruel,44037,Beceite,8,8,0
1996,Teruel,44039,Bello,1,5,-4
1996,Teruel,44038,Belmonte de San José,1,1,0
1996,Teruel,44040,Berge,2,5,-3
1996,Teruel,44041,Bezas,0,1,-1
1996,Teruel,44042,Blancas,0,4,-4
1996,Teruel,44043,Blesa,1,1,0
1996,Teruel,44044,Bordón,0,1,-1
1996,Teruel,44045,Bronchales,3,2,1
1996,Teruel,44046,Bueña,0,1,-1
1996,Teruel,44047,Burbáguena,0,12,-12
1996,Teruel,44033,Báguena,2,6,-4
1996,Teruel,44048,Cabra de Mora,1,4,-3
1996,Teruel,44049,Calaceite,6,26,-20
1996,Teruel,44050,Calamocha,26,52,-26
1996,Teruel,44051,Calanda,33,42,-9
1996,Teruel,44052,Calomarde,0,3,-3
1996,Teruel,44054,Camarena de la Sierra,0,2,-2
1996,Teruel,44055,Camarillas,2,2,0
1996,Teruel,44053,Camañas,1,3,-2
1996,Teruel,44056,Caminreal,4,9,-5
1996,Teruel,44059,Cantavieja,4,4,0
1996,Teruel,44064,Cascante del Río,0,3,-3
1996,Teruel,44065,Castejón de Tornos,0,4,-4
1996,Teruel,44066,Castel de Cabra,2,2,0
1996,Teruel,44070,Castellar (El),0,1,-1
1996,Teruel,44071,Castellote,6,17,-11
1996,Teruel,44067,Castelnou,0,6,-6
1996,Teruel,44068,Castelserás,7,5,2
1996,Teruel,44060,Cañada de Benatanduz,0,2,-2
1996,Teruel,44061,Cañada de Verich (La),1,0,1
1996,Teruel,44062,Cañada Vellida,0,1,-1
1996,Teruel,44063,Cañizar del Olivar,1,1,0
1996,Teruel,44074,Cedrillas,3,5,-2
1996,Teruel,44075,Celadas,4,9,-5
1996,Teruel,44076,Cella,13,32,-19
1996,Teruel,44077,Cerollera (La),1,1,0
1996,Teruel,44080,Codoñera (La),1,5,-4
1996,Teruel,44082,Corbalán,0,3,-3
1996,Teruel,44084,Cortes de Aragón,0,3,-3
1996,Teruel,44085,Cosa,1,0,1
1996,Teruel,44086,Cretas,0,5,-5
1996,Teruel,44087,Crivillén,0,1,-1
1996,Teruel,44088,Cuba (La),0,2,-2
1996,Teruel,44089,Cubla,0,1,-1
1996,Teruel,44092,Cuervo (El),0,3,-3
1996,Teruel,44093,Cuevas de Almudén,0,1,-1
1996,Teruel,44094,Cuevas Labradas,0,2,-2
1996,Teruel,44096,Ejulve,2,4,-2
1996,Teruel,44097,Escorihuela,1,4,-3
1996,Teruel,44099,Escucha,9,6,3
1996,Teruel,44100,Estercuel,1,3,-2
1996,Teruel,44103,Formiche Alto,4,3,1
1996,Teruel,44106,Fortanete,0,3,-3
1996,Teruel,44107,Foz-Calanda,1,5,-4
1996,Teruel,44108,Fresneda (La),3,5,-2
1996,Teruel,44109,Frías de Albarracín,0,1,-1
1996,Teruel,44111,Fuentes Calientes,0,2,-2
1996,Teruel,44112,Fuentes Claras,1,19,-18
1996,Teruel,44113,Fuentes de Rubielos,2,2,0
1996,Teruel,44114,Fuentespalda,6,0,6
1996,Teruel,44105,Fórnoles,0,2,-2
1996,Teruel,44115,Galve,0,1,-1
1996,Teruel,44116,Gargallo,1,0,1
1996,Teruel,44117,Gea de Albarracín,2,7,-5
1996,Teruel,44118,Ginebrosa (La),1,9,-8
1996,Teruel,44119,Griegos,0,2,-2
1996,Teruel,44120,Guadalaviar,2,6,-4
1996,Teruel,44121,Gúdar,1,0,1
1996,Teruel,44123,Hinojosa de Jarque,0,5,-5
1996,Teruel,44124,Hoz de la Vieja (La),0,3,-3
1996,Teruel,44125,Huesa del Común,0,2,-2
1996,Teruel,44122,Híjar,18,32,-14
1996,Teruel,44126,Iglesuela del Cid (La),3,5,-2
1996,Teruel,44127,Jabaloyas,0,1,-1
1996,Teruel,44128,Jarque de la Val,0,2,-2
1996,Teruel,44130,Jorcas,0,2,-2
1996,Teruel,44131,Josa,0,1,-1
1996,Teruel,44132,Lagueruela,0,1,-1
1996,Teruel,44133,Lanzuela,0,1,-1
1996,Teruel,44135,Libros,1,2,-1
1996,Teruel,44137,Linares de Mora,3,4,-1
1996,Teruel,44141,Lledó,0,5,-5
1996,Teruel,44138,Loscos,1,4,-3
1996,Teruel,44142,Maicas,1,1,0
1996,Teruel,44143,Manzanera,2,5,-3
1996,Teruel,44144,Martín del Río,3,8,-5
1996,Teruel,44145,Mas de las Matas,9,16,-7
1996,Teruel,44146,Mata de los Olmos (La),1,3,-2
1996,Teruel,44147,Mazaleón,6,9,-3
1996,Teruel,44148,Mezquita de Jarque,2,0,2
1996,Teruel,44151,Molinos,1,6,-5
1996,Teruel,44152,Monforte de Moyuela,0,1,-1
1996,Teruel,44153,Monreal del Campo,18,22,-4
1996,Teruel,44154,Monroyo,2,4,-2
1996,Teruel,44155,Montalbán,6,15,-9
1996,Teruel,44157,Monterde de Albarracín,0,2,-2
1996,Teruel,44158,Mora de Rubielos,14,11,3
1996,Teruel,44159,Moscardón,0,1,-1
1996,Teruel,44160,Mosqueruela,5,10,-5
1996,Teruel,44161,Muniesa,5,13,-8
1996,Teruel,44163,Noguera de Albarracín,1,0,1
1996,Teruel,44164,Nogueras,0,1,-1
1996,Teruel,44165,Nogueruelas,1,6,-5
1996,Teruel,44167,Obón,0,1,-1
1996,Teruel,44168,Odón,1,1,0
1996,Teruel,44169,Ojos Negros,3,6,-3
1996,Teruel,44171,Olba,0,4,-4
1996,Teruel,44172,Oliete,5,10,-5
1996,Teruel,44173,Olmos (Los),1,1,0
1996,Teruel,44174,Orihuela del Tremedal,4,9,-5
1996,Teruel,44175,Orrios,3,5,-2
1996,Teruel,44176,Palomar de Arroyos,1,4,-3
1996,Teruel,44177,Pancrudo,0,5,-5
1996,Teruel,44178,Parras de Castellote (Las),1,8,-7
1996,Teruel,44180,Peracense,1,0,1
1996,Teruel,44181,Peralejos,0,1,-1
1996,Teruel,44182,Perales del Alfambra,2,1,1
1996,Teruel,44179,Peñarroya de Tastavins,4,7,-3
1996,Teruel,44183,Pitarque,1,3,-2
1996,Teruel,44185,Pobo (El),1,1,0
1996,Teruel,44187,Portellada (La),0,5,-5
1996,Teruel,44189,Pozondón,0,3,-3
1996,Teruel,44190,Pozuel del Campo,1,1,0
1996,Teruel,44191,Puebla de Híjar (La),9,17,-8
1996,Teruel,44192,Puebla de Valverde (La),1,3,-2
1996,Teruel,44195,Rillo,2,1,1
1996,Teruel,44196,Riodeva,0,4,-4
1996,Teruel,44198,Royuela,1,2,-1
1996,Teruel,44199,Rubiales,0,2,-2
1996,Teruel,44201,Rubielos de Mora,7,3,4
1996,Teruel,44194,Ráfales,2,4,-2
1996,Teruel,44204,Saldón,0,1,-1
1996,Teruel,44205,Samper de Calanda,5,19,-14
1996,Teruel,44206,San Agustín,0,2,-2
1996,Teruel,44207,San Martín del Río,2,1,1
1996,Teruel,44209,Santa Eulalia,5,22,-17
1996,Teruel,44210,Sarrión,7,17,-10
1996,Teruel,44212,Seno,0,1,-1
1996,Teruel,44213,Singra,0,1,-1
1996,Teruel,44215,Terriente,0,1,-1
1996,Teruel,44216,Teruel,306,315,-9
1996,Teruel,44218,Tormón,0,2,-2
1996,Teruel,44219,Tornos,0,3,-3
1996,Teruel,44220,Torralba de los Sisones,1,6,-5
1996,Teruel,44223,Torre de Arcas,1,2,-1
1996,Teruel,44224,Torre de las Arcas,0,1,-1
1996,Teruel,44225,Torre del Compte,0,4,-4
1996,Teruel,44227,Torre los Negros,0,3,-3
1996,Teruel,44221,Torrecilla de Alcañiz,2,6,-4
1996,Teruel,44222,Torrecilla del Rebollar,1,3,-2
1996,Teruel,44226,Torrelacárcel,0,3,-3
1996,Teruel,44228,Torremocha de Jiloca,0,2,-2
1996,Teruel,44229,Torres de Albarracín,0,3,-3
1996,Teruel,44230,Torrevelilla,1,3,-2
1996,Teruel,44231,Torrijas,0,2,-2
1996,Teruel,44232,Torrijo del Campo,2,5,-3
1996,Teruel,44234,Tramacastiel,0,5,-5
1996,Teruel,44235,Tramacastilla,0,3,-3
1996,Teruel,44237,Urrea de Gaén,4,3,1
1996,Teruel,44238,Utrillas,19,28,-9
1996,Teruel,44239,Valacloche,1,0,1
1996,Teruel,44240,Valbona,0,4,-4
1996,Teruel,44241,Valdealgorfa,5,11,-6
1996,Teruel,44243,Valdecuenca,0,2,-2
1996,Teruel,44245,Valdeltormo,2,9,-7
1996,Teruel,44246,Valderrobres,16,23,-7
1996,Teruel,44247,Valjunquera,1,3,-2
1996,Teruel,44251,Villafranca del Campo,2,2,0
1996,Teruel,44252,Villahermosa del Campo,0,1,-1
1996,Teruel,44257,Villar del Cobo,3,0,3
1996,Teruel,44258,Villar del Salz,0,2,-2
1996,Teruel,44260,Villarluengo,0,3,-3
1996,Teruel,44261,Villarquemado,3,17,-14
1996,Teruel,44262,Villarroya de los Pinares,1,4,-3
1996,Teruel,44263,Villastar,2,8,-6
1996,Teruel,44264,Villel,1,6,-5
1996,Teruel,44265,Vinaceite,2,1,1
1996,Teruel,44266,Visiedo,1,4,-3
1996,Teruel,44267,Vivel del Río Martín,0,1,-1
1996,Zaragoza,50001,Abanto,0,1,-1
1996,Zaragoza,50002,Acered,0,5,-5
1996,Zaragoza,50004,Aguarón,2,11,-9
1996,Zaragoza,50005,Aguilón,0,4,-4
1996,Zaragoza,50003,Agón,1,4,-3
1996,Zaragoza,50006,Ainzón,8,13,-5
1996,Zaragoza,50007,Aladrén,0,3,-3
1996,Zaragoza,50008,Alagón,45,64,-19
1996,Zaragoza,50009,Alarba,0,1,-1
1996,Zaragoza,50010,Alberite de San Juan,0,2,-2
1996,Zaragoza,50012,Alborge,2,1,1
1996,Zaragoza,50013,Alcalá de Ebro,1,5,-4
1996,Zaragoza,50015,Alconchel de Ariza,0,1,-1
1996,Zaragoza,50016,Aldehuela de Liestos,0,1,-1
1996,Zaragoza,50017,Alfajarín,10,17,-7
1996,Zaragoza,50018,Alfamén,7,12,-5
1996,Zaragoza,50019,Alforque,1,0,1
1996,Zaragoza,50020,Alhama de Aragón,14,21,-7
1996,Zaragoza,50021,Almochuel,0,1,-1
1996,Zaragoza,50022,Almolda (La),5,12,-7
1996,Zaragoza,50023,Almonacid de la Cuba,0,5,-5
1996,Zaragoza,50024,Almonacid de la Sierra,6,9,-3
1996,Zaragoza,50025,Almunia de Doña Godina (La),44,46,-2
1996,Zaragoza,50026,Alpartir,3,9,-6
1996,Zaragoza,50027,Ambel,2,5,-3
1996,Zaragoza,50029,Aniñón,8,13,-5
1996,Zaragoza,50031,Aranda de Moncayo,1,4,-3
1996,Zaragoza,50033,Ardisa,0,3,-3
1996,Zaragoza,50034,Ariza,8,9,-1
1996,Zaragoza,50035,Artieda,0,1,-1
1996,Zaragoza,50032,Arándiga,7,12,-5
1996,Zaragoza,50036,Asín,1,0,1
1996,Zaragoza,50037,Atea,1,4,-3
1996,Zaragoza,50038,Ateca,18,28,-10
1996,Zaragoza,50039,Azuara,5,15,-10
1996,Zaragoza,50030,Añón de Moncayo,0,6,-6
1996,Zaragoza,50040,Badules,0,1,-1
1996,Zaragoza,50042,Balconchán,0,2,-2
1996,Zaragoza,50044,Bardallur,0,5,-5
1996,Zaragoza,50045,Belchite,13,22,-9
1996,Zaragoza,50046,Belmonte de Gracián,1,10,-9
1996,Zaragoza,50047,Berdejo,0,2,-2
1996,Zaragoza,50048,Berrueco,0,2,-2
1996,Zaragoza,50901,Biel,0,1,-1
1996,Zaragoza,50050,Bijuesca,2,0,2
1996,Zaragoza,50051,Biota,6,16,-10
1996,Zaragoza,50052,Bisimbre,0,2,-2
1996,Zaragoza,50053,Boquiñeni,6,12,-6
1996,Zaragoza,50055,Borja,43,65,-22
1996,Zaragoza,50056,Botorrita,2,5,-3
1996,Zaragoza,50057,Brea de Aragón,16,19,-3
1996,Zaragoza,50058,Bubierca,0,3,-3
1996,Zaragoza,50059,Bujaraloz,8,7,1
1996,Zaragoza,50060,Bulbuente,1,3,-2
1996,Zaragoza,50061,Bureta,0,5,-5
1996,Zaragoza,50062,Burgo de Ebro (El),5,12,-7
1996,Zaragoza,50063,Buste (El),0,5,-5
1996,Zaragoza,50043,Bárboles,1,4,-3
1996,Zaragoza,50064,Cabañas de Ebro,3,4,-1
1996,Zaragoza,50065,Cabolafuente,0,2,-2
1996,Zaragoza,50066,Cadrete,11,6,5
1996,Zaragoza,50067,Calatayud,130,210,-80
1996,Zaragoza,50068,Calatorao,9,31,-22
1996,Zaragoza,50070,Calmarza,0,4,-4
1996,Zaragoza,50071,Campillo de Aragón,0,4,-4
1996,Zaragoza,50072,Carenas,0,7,-7
1996,Zaragoza,50073,Cariñena,26,30,-4
1996,Zaragoza,50074,Caspe,51,134,-83
1996,Zaragoza,50075,Castejón de Alarba,0,1,-1
1996,Zaragoza,50076,Castejón de las Armas,0,1,-1
1996,Zaragoza,50077,Castejón de Valdejasa,1,4,-3
1996,Zaragoza,50078,Castiliscar,3,4,-1
1996,Zaragoza,50079,Cervera de la Cañada,1,7,-6
1996,Zaragoza,50081,Cetina,5,7,-2
1996,Zaragoza,50092,Chiprana,4,7,-3
1996,Zaragoza,50093,Chodes,1,2,-1
1996,Zaragoza,50082,Cimballa,0,1,-1
1996,Zaragoza,50083,Cinco Olivas,1,8,-7
1996,Zaragoza,50085,Codo,0,6,-6
1996,Zaragoza,50086,Codos,0,6,-6
1996,Zaragoza,50087,Contamina,0,3,-3
1996,Zaragoza,50088,Cosuenda,2,6,-4
1996,Zaragoza,50089,Cuarte de Huerva,36,22,14
1996,Zaragoza,50090,Cubel,0,5,-5
1996,Zaragoza,50091,Cuerlas (Las),0,1,-1
1996,Zaragoza,50094,Daroca,13,39,-26
1996,Zaragoza,50095,Ejea de los Caballeros,137,152,-15
1996,Zaragoza,50096,Embid de Ariza,0,1,-1
1996,Zaragoza,50098,Encinacorba,4,5,-1
1996,Zaragoza,50100,Erla,2,6,-4
1996,Zaragoza,50101,Escatrón,7,24,-17
1996,Zaragoza,50102,Fabara,9,16,-7
1996,Zaragoza,50104,Farlete,3,9,-6
1996,Zaragoza,50106,Fayos (Los),2,0,2
1996,Zaragoza,50105,Fayón,2,10,-8
1996,Zaragoza,50107,Figueruelas,10,6,4
1996,Zaragoza,50109,Frago (El),0,3,-3
1996,Zaragoza,50110,Frasno (El),0,18,-18
1996,Zaragoza,50111,Fréscano,2,3,-1
1996,Zaragoza,50113,Fuendejalón,2,12,-10
1996,Zaragoza,50114,Fuendetodos,0,3,-3
1996,Zaragoza,50115,Fuentes de Ebro,31,44,-13
1996,Zaragoza,50116,Fuentes de Jiloca,1,2,-1
1996,Zaragoza,50117,Gallocanta,2,0,2
1996,Zaragoza,50118,Gallur,20,35,-15
1996,Zaragoza,50119,Gelsa,6,16,-10
1996,Zaragoza,50120,Godojos,1,2,-1
1996,Zaragoza,50121,Gotor,6,9,-3
1996,Zaragoza,50122,Grisel,0,2,-2
1996,Zaragoza,50123,Grisén,4,5,-1
1996,Zaragoza,50124,Herrera de los Navarros,2,10,-8
1996,Zaragoza,50125,Ibdes,2,9,-7
1996,Zaragoza,50126,Illueca,33,20,13
1996,Zaragoza,50129,Jaraba,1,8,-7
1996,Zaragoza,50130,Jarque de Moncayo,2,9,-7
1996,Zaragoza,50131,Jaulín,1,3,-2
1996,Zaragoza,50132,Joyosa (La),3,4,-1
1996,Zaragoza,50133,Lagata,1,3,-2
1996,Zaragoza,50134,Langa del Castillo,0,4,-4
1996,Zaragoza,50135,Layana,0,1,-1
1996,Zaragoza,50138,Lechón,0,1,-1
1996,Zaragoza,50137,Leciñena,6,15,-9
1996,Zaragoza,50139,Letux,0,6,-6
1996,Zaragoza,50140,Litago,0,2,-2
1996,Zaragoza,50141,Lituénigo,0,4,-4
1996,Zaragoza,50142,Lobera de Onsella,0,2,-2
1996,Zaragoza,50143,Longares,5,9,-4
1996,Zaragoza,50144,Longás,0,1,-1
1996,Zaragoza,50146,Lucena de Jalón,1,3,-2
1996,Zaragoza,50147,Luceni,8,12,-4
1996,Zaragoza,50148,Luesia,1,8,-7
1996,Zaragoza,50150,Lumpiaque,3,16,-13
1996,Zaragoza,50151,Luna,4,11,-7
1996,Zaragoza,50136,Lécera,4,8,-4
1996,Zaragoza,50152,Maella,14,24,-10
1996,Zaragoza,50153,Magallón,13,15,-2
1996,Zaragoza,50154,Mainar,0,6,-6
1996,Zaragoza,50155,Malanquilla,0,2,-2
1996,Zaragoza,50156,Maleján,2,6,-4
1996,Zaragoza,50160,Mallén,26,42,-16
1996,Zaragoza,50159,Maluenda,4,10,-6
1996,Zaragoza,50157,Malón,3,4,-1
1996,Zaragoza,50161,Manchones,1,1,0
1996,Zaragoza,50162,Mara,1,6,-5
1996,Zaragoza,50163,María de Huerva,7,16,-9
1996,Zaragoza,50164,Mediana de Aragón,1,7,-6
1996,Zaragoza,50165,Mequinenza,18,25,-7
1996,Zaragoza,50166,Mesones de Isuela,1,9,-8
1996,Zaragoza,50167,Mezalocha,3,10,-7
1996,Zaragoza,50169,Miedes de Aragón,0,5,-5
1996,Zaragoza,50170,Monegrillo,6,5,1
1996,Zaragoza,50171,Moneva,0,1,-1
1996,Zaragoza,50172,Monreal de Ariza,1,4,-3
1996,Zaragoza,50173,Monterde,1,5,-4
1996,Zaragoza,50174,Montón,0,1,-1
1996,Zaragoza,50175,Morata de Jalón,8,18,-10
1996,Zaragoza,50176,Morata de Jiloca,2,4,-2
1996,Zaragoza,50178,Moros,2,12,-10
1996,Zaragoza,50177,Morés,1,7,-6
1996,Zaragoza,50179,Moyuela,1,10,-9
1996,Zaragoza,50181,Muel,5,14,-9
1996,Zaragoza,50182,Muela (La),17,10,7
1996,Zaragoza,50183,Munébrega,6,4,2
1996,Zaragoza,50184,Murero,1,1,0
1996,Zaragoza,50185,Murillo de Gállego,1,0,1
1996,Zaragoza,50186,Navardún,0,1,-1
1996,Zaragoza,50187,Nigüella,1,7,-6
1996,Zaragoza,50189,Nonaspe,4,14,-10
1996,Zaragoza,50190,Novallas,3,11,-8
1996,Zaragoza,50191,Novillas,6,4,2
1996,Zaragoza,50193,Nuez de Ebro,2,8,-6
1996,Zaragoza,50192,Nuévalos,5,3,2
1996,Zaragoza,50194,Olvés,1,2,-1
1996,Zaragoza,50197,Orés,0,2,-2
1996,Zaragoza,50198,Oseja,0,1,-1
1996,Zaragoza,50199,Osera de Ebro,1,5,-4
1996,Zaragoza,50200,Paniza,4,6,-2
1996,Zaragoza,50201,Paracuellos de Jiloca,2,6,-4
1996,Zaragoza,50202,Paracuellos de la Ribera,1,6,-5
1996,Zaragoza,50203,Pastriz,5,11,-6
1996,Zaragoza,50204,Pedrola,18,19,-1
1996,Zaragoza,50205,Pedrosas (Las),0,5,-5
1996,Zaragoza,50206,Perdiguera,4,9,-5
1996,Zaragoza,50207,Piedratajada,1,2,-1
1996,Zaragoza,50208,Pina de Ebro,36,17,19
1996,Zaragoza,50209,Pinseque,11,52,-41
1996,Zaragoza,50210,Pintanos (Los),0,2,-2
1996,Zaragoza,50211,Plasencia de Jalón,2,5,-3
1996,Zaragoza,50212,Pleitas,0,1,-1
1996,Zaragoza,50213,Plenas,0,3,-3
1996,Zaragoza,50214,Pomer,0,1,-1
1996,Zaragoza,50216,Pozuelo de Aragón,1,11,-10
1996,Zaragoza,50217,Pradilla de Ebro,2,11,-9
1996,Zaragoza,50218,Puebla de Albortón,0,2,-2
1996,Zaragoza,50219,Puebla de Alfindén (La),12,10,2
1996,Zaragoza,50220,Puendeluna,1,0,1
1996,Zaragoza,50222,Quinto,25,24,1
1996,Zaragoza,50223,Remolinos,7,18,-11
1996,Zaragoza,50224,Retascón,0,3,-3
1996,Zaragoza,50225,Ricla,22,22,0
1996,Zaragoza,50227,Romanos,0,2,-2
1996,Zaragoza,50228,Rueda de Jalón,1,2,-1
1996,Zaragoza,50231,Salillas de Jalón,1,5,-4
1996,Zaragoza,50232,Salvatierra de Esca,5,3,2
1996,Zaragoza,50233,Samper del Salz,0,1,-1
1996,Zaragoza,50234,San Martín de la Virgen de Moncayo,3,2,1
1996,Zaragoza,50235,San Mateo de Gállego,20,22,-2
1996,Zaragoza,50236,Santa Cruz de Grío,1,1,0
1996,Zaragoza,50237,Santa Cruz de Moncayo,1,0,1
1996,Zaragoza,50238,Santa Eulalia de Gállego,0,4,-4
1996,Zaragoza,50239,Santed,1,0,1
1996,Zaragoza,50241,Saviñán,3,12,-9
1996,Zaragoza,50242,Sediles,0,1,-1
1996,Zaragoza,50243,Sestrica,0,7,-7
1996,Zaragoza,50244,Sierra de Luna,1,6,-5
1996,Zaragoza,50245,Sigüés,0,1,-1
1996,Zaragoza,50247,Sobradiel,1,12,-11
1996,Zaragoza,50248,Sos del Rey Católico,5,11,-6
1996,Zaragoza,50230,Sádaba,11,25,-14
1996,Zaragoza,50240,Sástago,10,23,-13
1996,Zaragoza,50249,Tabuenca,0,7,-7
1996,Zaragoza,50250,Talamantes,1,0,1
1996,Zaragoza,50251,Tarazona,84,116,-32
1996,Zaragoza,50252,Tauste,62,78,-16
1996,Zaragoza,50253,Terrer,2,9,-7
1996,Zaragoza,50254,Tierga,1,2,-1
1996,Zaragoza,50255,Tobed,0,5,-5
1996,Zaragoza,50256,Torralba de los Frailes,0,2,-2
1996,Zaragoza,50257,Torralba de Ribota,2,4,-2
1996,Zaragoza,50258,Torralbilla,0,1,-1
1996,Zaragoza,50259,Torrehermosa,0,1,-1
1996,Zaragoza,50260,Torrelapaja,0,1,-1
1996,Zaragoza,50261,Torrellas,2,4,-2
1996,Zaragoza,50262,Torres de Berrellén,9,16,-7
1996,Zaragoza,50263,Torrijo de la Cañada,2,7,-5
1996,Zaragoza,50264,Tosos,1,2,-1
1996,Zaragoza,50265,Trasmoz,0,1,-1
1996,Zaragoza,50266,Trasobares,1,3,-2
1996,Zaragoza,50267,Uncastillo,5,24,-19
1996,Zaragoza,50268,Undués de Lerda,0,2,-2
1996,Zaragoza,50269,Urrea de Jalón,0,3,-3
1996,Zaragoza,50270,Urriés,0,1,-1
1996,Zaragoza,50271,Used,1,7,-6
1996,Zaragoza,50272,Utebo,90,51,39
1996,Zaragoza,50274,Val de San Martín,1,0,1
1996,Zaragoza,50276,Valpalmas,2,1,1
1996,Zaragoza,50277,Valtorres,0,2,-2
1996,Zaragoza,50278,Velilla de Ebro,2,1,1
1996,Zaragoza,50279,Velilla de Jiloca,0,7,-7
1996,Zaragoza,50280,Vera de Moncayo,2,8,-6
1996,Zaragoza,50283,Villadoz,0,2,-2
1996,Zaragoza,50284,Villafeliche,0,9,-9
1996,Zaragoza,50285,Villafranca de Ebro,7,9,-2
1996,Zaragoza,50287,Villalengua,2,6,-4
1996,Zaragoza,50288,Villanueva de Gállego,16,43,-27
1996,Zaragoza,50290,Villanueva de Huerva,2,5,-3
1996,Zaragoza,50289,Villanueva de Jiloca,0,2,-2
1996,Zaragoza,50291,Villar de los Navarros,0,8,-8
1996,Zaragoza,50292,Villarreal de Huerva,1,7,-6
1996,Zaragoza,50293,Villarroya de la Sierra,3,11,-8
1996,Zaragoza,50294,Villarroya del Campo,0,1,-1
1996,Zaragoza,50282,Vilueña (La),0,0,0
1996,Zaragoza,50295,Vistabella,0,1,-1
1996,Zaragoza,50296,Zaida (La),7,8,-1
1996,Zaragoza,50297,Zaragoza,4950,5307,-357
1996,Zaragoza,50298,Zuera,37,65,-28
1996,Zaragoza,50099,Épila,39,48,-9
